Municipio,Code_IBGE,UF,Regiao,Fabricante,Total_Doses,Dose_1,Dose_2
Abadia De Goiás,520005,GO,Centro-Oeste,BUTANTAN/SINOVAC,2556,1295,1261
Abadia De Goiás,520005,GO,Centro-Oeste,FIOCRUZ/ASTRAZENECA,2076,1970,106
Abadia Dos Dourados,310010,MG,Sudeste,FIOCRUZ/ASTRAZENECA,1833,1721,112
Abadia Dos Dourados,310010,MG,Sudeste,BUTANTAN/SINOVAC,1544,781,763
Abadia Dos Dourados,310010,MG,Sudeste,PFIZER/BIONTECH,107,107,0
Abadiânia,520010,GO,Centro-Oeste,FIOCRUZ/ASTRAZENECA,5314,5072,242
Abadiânia,520010,GO,Centro-Oeste,BUTANTAN/SINOVAC,3345,1795,1550
Abadiânia,520010,GO,Centro-Oeste,PFIZER/BIONTECH,308,308,0
Abaeté,310020,MG,Sudeste,BUTANTAN/SINOVAC,5456,2775,2681
Abaeté,310020,MG,Sudeste,FIOCRUZ/ASTRAZENECA,5330,4794,536
Abaeté,310020,MG,Sudeste,PFIZER/BIONTECH,509,509,0
Abaetetuba,150010,PA,Norte,FIOCRUZ/ASTRAZENECA,44077,35585,8492
Abaetetuba,150010,PA,Norte,BUTANTAN/SINOVAC,16968,9233,7735
Abaiara,230010,CE,Nordeste,BUTANTAN/SINOVAC,986,774,212
Abaiara,230010,CE,Nordeste,FIOCRUZ/ASTRAZENECA,224,223,1
Abaíra,290010,BA,Nordeste,FIOCRUZ/ASTRAZENECA,3948,3436,512
Abaíra,290010,BA,Nordeste,BUTANTAN/SINOVAC,2903,1469,1434
Abaíra,290010,BA,Nordeste,PFIZER/BIONTECH,100,100,0
Abaré,290020,BA,Nordeste,BUTANTAN/SINOVAC,4781,2424,2357
Abaré,290020,BA,Nordeste,FIOCRUZ/ASTRAZENECA,3577,3194,383
Abaré,290020,BA,Nordeste,PFIZER/BIONTECH,337,335,2
Abatiá,410010,PR,Sul,FIOCRUZ/ASTRAZENECA,2565,2451,114
Abatiá,410010,PR,Sul,BUTANTAN/SINOVAC,1936,991,945
Abatiá,410010,PR,Sul,PFIZER/BIONTECH,115,115,0
Abdon Batista,420005,SC,Sul,FIOCRUZ/ASTRAZENECA,993,822,171
Abdon Batista,420005,SC,Sul,BUTANTAN/SINOVAC,799,415,384
Abdon Batista,420005,SC,Sul,PFIZER/BIONTECH,162,162,0
Abel Figueiredo,150013,PA,Norte,FIOCRUZ/ASTRAZENECA,1281,1185,96
Abel Figueiredo,150013,PA,Norte,BUTANTAN/SINOVAC,383,197,186
Abelardo Luz,420010,SC,Sul,FIOCRUZ/ASTRAZENECA,3720,3412,308
Abelardo Luz,420010,SC,Sul,BUTANTAN/SINOVAC,3040,1608,1432
Abelardo Luz,420010,SC,Sul,PFIZER/BIONTECH,246,246,0
Abre Campo,310030,MG,Sudeste,FIOCRUZ/ASTRAZENECA,3155,2792,363
Abre Campo,310030,MG,Sudeste,BUTANTAN/SINOVAC,2875,1450,1425
Abre Campo,310030,MG,Sudeste,PFIZER/BIONTECH,500,500,0
Abreu E Lima,260005,PE,Nordeste,BUTANTAN/SINOVAC,14682,7642,7040
Abreu E Lima,260005,PE,Nordeste,FIOCRUZ/ASTRAZENECA,9356,8490,866
Abreu E Lima,260005,PE,Nordeste,PFIZER/BIONTECH,151,151,0
Abreulândia,170025,TO,Norte,FIOCRUZ/ASTRAZENECA,639,613,26
Abreulândia,170025,TO,Norte,BUTANTAN/SINOVAC,497,261,236
Acaiaca,310040,MG,Sudeste,FIOCRUZ/ASTRAZENECA,1220,1142,78
Acaiaca,310040,MG,Sudeste,BUTANTAN/SINOVAC,1046,533,513
Acaiaca,310040,MG,Sudeste,PFIZER/BIONTECH,35,35,0
Açailândia,210005,MA,Nordeste,FIOCRUZ/ASTRAZENECA,23689,22742,947
Açailândia,210005,MA,Nordeste,BUTANTAN/SINOVAC,11707,6184,5523
Açailândia,210005,MA,Nordeste,PFIZER/BIONTECH,303,303,0
Acajutiba,290030,BA,Nordeste,BUTANTAN/SINOVAC,1177,508,669
Acajutiba,290030,BA,Nordeste,FIOCRUZ/ASTRAZENECA,1024,888,136
Acajutiba,290030,BA,Nordeste,PFIZER/BIONTECH,22,22,0
Acará,150020,PA,Norte,FIOCRUZ/ASTRAZENECA,5253,4962,291
Acará,150020,PA,Norte,BUTANTAN/SINOVAC,4546,3087,1459
Acarape,230015,CE,Nordeste,BUTANTAN/SINOVAC,2239,1213,1026
Acarape,230015,CE,Nordeste,FIOCRUZ/ASTRAZENECA,492,280,212
Acaraú,230020,CE,Nordeste,BUTANTAN/SINOVAC,8220,4259,3961
Acaraú,230020,CE,Nordeste,FIOCRUZ/ASTRAZENECA,1569,1048,521
Acaraú,230020,CE,Nordeste,PFIZER/BIONTECH,2,2,0
Acari,240010,RN,Nordeste,BUTANTAN/SINOVAC,2492,1264,1228
Acari,240010,RN,Nordeste,FIOCRUZ/ASTRAZENECA,1937,1825,112
Acari,240010,RN,Nordeste,PFIZER/BIONTECH,182,182,0
Acauã,220005,PI,Nordeste,FIOCRUZ/ASTRAZENECA,1710,1497,213
Acauã,220005,PI,Nordeste,BUTANTAN/SINOVAC,1029,538,491
Acauã,220005,PI,Nordeste,PFIZER/BIONTECH,166,166,0
Aceguá,430003,RS,Sul,FIOCRUZ/ASTRAZENECA,1728,1582,146
Aceguá,430003,RS,Sul,BUTANTAN/SINOVAC,1372,648,724
Aceguá,430003,RS,Sul,PFIZER/BIONTECH,243,243,0
Acopiara,230030,CE,Nordeste,BUTANTAN/SINOVAC,8553,4418,4135
Acopiara,230030,CE,Nordeste,FIOCRUZ/ASTRAZENECA,3040,2499,541
Acorizal,510010,MT,Centro-Oeste,BUTANTAN/SINOVAC,1308,660,648
Acorizal,510010,MT,Centro-Oeste,FIOCRUZ/ASTRAZENECA,1261,1203,58
Acorizal,510010,MT,Centro-Oeste,PFIZER/BIONTECH,60,60,0
Acrelândia,120001,AC,Norte,FIOCRUZ/ASTRAZENECA,3392,3055,337
Acrelândia,120001,AC,Norte,BUTANTAN/SINOVAC,1234,637,597
Acrelândia,120001,AC,Norte,PFIZER/BIONTECH,187,187,0
Acreúna,520013,GO,Centro-Oeste,FIOCRUZ/ASTRAZENECA,4859,4594,265
Acreúna,520013,GO,Centro-Oeste,BUTANTAN/SINOVAC,3557,1898,1659
Acreúna,520013,GO,Centro-Oeste,PFIZER/BIONTECH,52,52,0
Açu,240020,RN,Nordeste,FIOCRUZ/ASTRAZENECA,11095,10193,902
Açu,240020,RN,Nordeste,BUTANTAN/SINOVAC,8667,4555,4112
Açu,240020,RN,Nordeste,PFIZER/BIONTECH,1657,1651,6
Açucena,310050,MG,Sudeste,FIOCRUZ/ASTRAZENECA,2137,1965,172
Açucena,310050,MG,Sudeste,BUTANTAN/SINOVAC,2095,1131,964
Açucena,310050,MG,Sudeste,PFIZER/BIONTECH,206,206,0
Adamantina,350010,SP,Sudeste,BUTANTAN/SINOVAC,11856,6692,5164
Adamantina,350010,SP,Sudeste,FIOCRUZ/ASTRAZENECA,8853,8123,730
Adamantina,350010,SP,Sudeste,PFIZER/BIONTECH,423,423,0
Adelândia,520015,GO,Centro-Oeste,FIOCRUZ/ASTRAZENECA,593,558,35
Adelândia,520015,GO,Centro-Oeste,BUTANTAN/SINOVAC,467,257,210
Adolfo,350020,SP,Sudeste,BUTANTAN/SINOVAC,1377,810,567
Adolfo,350020,SP,Sudeste,FIOCRUZ/ASTRAZENECA,1160,1053,107
Adolfo,350020,SP,Sudeste,PFIZER/BIONTECH,133,133,0
Adrianópolis,410020,PR,Sul,FIOCRUZ/ASTRAZENECA,1905,1821,84
Adrianópolis,410020,PR,Sul,BUTANTAN/SINOVAC,1583,818,765
Adustina,290035,BA,Nordeste,FIOCRUZ/ASTRAZENECA,4727,4222,505
Adustina,290035,BA,Nordeste,BUTANTAN/SINOVAC,3134,1610,1524
Adustina,290035,BA,Nordeste,PFIZER/BIONTECH,246,246,0
Afogados Da Ingazeira,260010,PE,Nordeste,BUTANTAN/SINOVAC,8853,4873,3980
Afogados Da Ingazeira,260010,PE,Nordeste,FIOCRUZ/ASTRAZENECA,7051,6488,563
Afogados Da Ingazeira,260010,PE,Nordeste,PFIZER/BIONTECH,844,842,2
Afonso Bezerra,240030,RN,Nordeste,FIOCRUZ/ASTRAZENECA,1726,1674,52
Afonso Bezerra,240030,RN,Nordeste,BUTANTAN/SINOVAC,1564,802,762
Afonso Bezerra,240030,RN,Nordeste,PFIZER/BIONTECH,138,138,0
Afonso Cláudio,320010,ES,Sudeste,BUTANTAN/SINOVAC,9229,4924,4305
Afonso Cláudio,320010,ES,Sudeste,FIOCRUZ/ASTRAZENECA,7897,7567,330
Afonso Cláudio,320010,ES,Sudeste,PFIZER/BIONTECH,1275,1275,0
Afonso Cunha,210010,MA,Nordeste,FIOCRUZ/ASTRAZENECA,1443,1345,98
Afonso Cunha,210010,MA,Nordeste,BUTANTAN/SINOVAC,1342,966,376
Afrânio,260020,PE,Nordeste,FIOCRUZ/ASTRAZENECA,4991,4666,325
Afrânio,260020,PE,Nordeste,BUTANTAN/SINOVAC,3279,1647,1632
Afrânio,260020,PE,Nordeste,PFIZER/BIONTECH,507,507,0
Afuá,150030,PA,Norte,FIOCRUZ/ASTRAZENECA,7065,6804,261
Afuá,150030,PA,Norte,BUTANTAN/SINOVAC,1943,1013,930
Agrestina,260030,PE,Nordeste,BUTANTAN/SINOVAC,3754,2089,1665
Agrestina,260030,PE,Nordeste,FIOCRUZ/ASTRAZENECA,2444,2281,163
Agrestina,260030,PE,Nordeste,PFIZER/BIONTECH,98,98,0
Agricolândia,220010,PI,Nordeste,BUTANTAN/SINOVAC,1111,650,461
Agricolândia,220010,PI,Nordeste,FIOCRUZ/ASTRAZENECA,1008,920,88
Agricolândia,220010,PI,Nordeste,PFIZER/BIONTECH,45,45,0
Agrolândia,420020,SC,Sul,BUTANTAN/SINOVAC,2093,1100,993
Agrolândia,420020,SC,Sul,FIOCRUZ/ASTRAZENECA,2083,1921,162
Agrolândia,420020,SC,Sul,PFIZER/BIONTECH,349,349,0
Agronômica,420030,SC,Sul,FIOCRUZ/ASTRAZENECA,1204,1127,77
Agronômica,420030,SC,Sul,BUTANTAN/SINOVAC,1107,572,535
Agronômica,420030,SC,Sul,PFIZER/BIONTECH,143,143,0
Água Azul Do Norte,150034,PA,Norte,FIOCRUZ/ASTRAZENECA,2858,2003,855
Água Azul Do Norte,150034,PA,Norte,BUTANTAN/SINOVAC,2004,1093,911
Água Boa,310060,MG,Sudeste,FIOCRUZ/ASTRAZENECA,2237,2023,214
Água Boa,310060,MG,Sudeste,BUTANTAN/SINOVAC,2220,1123,1097
Água Boa,310060,MG,Sudeste,PFIZER/BIONTECH,144,144,0
Água Boa,510020,MT,Centro-Oeste,BUTANTAN/SINOVAC,6307,3337,2970
Água Boa,510020,MT,Centro-Oeste,FIOCRUZ/ASTRAZENECA,4334,3970,364
Água Boa,510020,MT,Centro-Oeste,PFIZER/BIONTECH,535,535,0
Água Branca,220020,PI,Nordeste,FIOCRUZ/ASTRAZENECA,4116,3834,282
Água Branca,220020,PI,Nordeste,BUTANTAN/SINOVAC,3827,1969,1858
Água Branca,220020,PI,Nordeste,PFIZER/BIONTECH,460,460,0
Água Branca,250010,PB,Nordeste,BUTANTAN/SINOVAC,2066,1056,1010
Água Branca,250010,PB,Nordeste,FIOCRUZ/ASTRAZENECA,1657,1509,148
Água Branca,250010,PB,Nordeste,PFIZER/BIONTECH,167,167,0
Água Branca,270010,AL,Nordeste,FIOCRUZ/ASTRAZENECA,4246,3713,533
Água Branca,270010,AL,Nordeste,BUTANTAN/SINOVAC,4173,2112,2061
Água Clara,500020,MS,Centro-Oeste,FIOCRUZ/ASTRAZENECA,2901,2720,181
Água Clara,500020,MS,Centro-Oeste,BUTANTAN/SINOVAC,2199,1165,1034
Água Clara,500020,MS,Centro-Oeste,PFIZER/BIONTECH,380,380,0
Água Comprida,310070,MG,Sudeste,BUTANTAN/SINOVAC,740,385,355
Água Comprida,310070,MG,Sudeste,FIOCRUZ/ASTRAZENECA,591,523,68
Água Comprida,310070,MG,Sudeste,PFIZER/BIONTECH,42,42,0
Água Doce,420040,SC,Sul,FIOCRUZ/ASTRAZENECA,1949,1724,225
Água Doce,420040,SC,Sul,BUTANTAN/SINOVAC,1897,1129,768
Água Doce,420040,SC,Sul,PFIZER/BIONTECH,167,167,0
Água Doce Do Maranhão,210015,MA,Nordeste,FIOCRUZ/ASTRAZENECA,2207,1922,285
Água Doce Do Maranhão,210015,MA,Nordeste,BUTANTAN/SINOVAC,2187,1142,1045
Água Doce Do Norte,320016,ES,Sudeste,BUTANTAN/SINOVAC,3140,1742,1398
Água Doce Do Norte,320016,ES,Sudeste,FIOCRUZ/ASTRAZENECA,2138,2017,121
Água Doce Do Norte,320016,ES,Sudeste,PFIZER/BIONTECH,460,460,0
Água Fria,290040,BA,Nordeste,BUTANTAN/SINOVAC,2787,1700,1087
Água Fria,290040,BA,Nordeste,FIOCRUZ/ASTRAZENECA,1084,1078,6
Água Fria,290040,BA,Nordeste,PFIZER/BIONTECH,149,149,0
Água Fria De Goiás,520017,GO,Centro-Oeste,FIOCRUZ/ASTRAZENECA,1583,1383,200
Água Fria De Goiás,520017,GO,Centro-Oeste,BUTANTAN/SINOVAC,552,296,256
Água Fria De Goiás,520017,GO,Centro-Oeste,PFIZER/BIONTECH,78,78,0
Água Limpa,520020,GO,Centro-Oeste,FIOCRUZ/ASTRAZENECA,825,761,64
Água Limpa,520020,GO,Centro-Oeste,BUTANTAN/SINOVAC,607,306,301
Água Limpa,520020,GO,Centro-Oeste,PFIZER/BIONTECH,12,12,0
Água Nova,240040,RN,Nordeste,BUTANTAN/SINOVAC,882,446,436
Água Nova,240040,RN,Nordeste,FIOCRUZ/ASTRAZENECA,686,656,30
Água Nova,240040,RN,Nordeste,PFIZER/BIONTECH,122,122,0
Água Preta,260040,PE,Nordeste,FIOCRUZ/ASTRAZENECA,4097,3876,221
Água Preta,260040,PE,Nordeste,BUTANTAN/SINOVAC,3496,1891,1605
Água Preta,260040,PE,Nordeste,PFIZER/BIONTECH,184,184,0
Água Santa,430005,RS,Sul,BUTANTAN/SINOVAC,1081,602,479
Água Santa,430005,RS,Sul,FIOCRUZ/ASTRAZENECA,989,929,60
Água Santa,430005,RS,Sul,PFIZER/BIONTECH,146,146,0
Aguaí,350030,SP,Sudeste,FIOCRUZ/ASTRAZENECA,7347,6811,536
Aguaí,350030,SP,Sudeste,BUTANTAN/SINOVAC,6466,3338,3128
Aguaí,350030,SP,Sudeste,PFIZER/BIONTECH,672,670,2
Aguanil,310080,MG,Sudeste,BUTANTAN/SINOVAC,1366,697,669
Aguanil,310080,MG,Sudeste,FIOCRUZ/ASTRAZENECA,1308,1185,123
Aguanil,310080,MG,Sudeste,PFIZER/BIONTECH,43,42,1
Águas Belas,260050,PE,Nordeste,FIOCRUZ/ASTRAZENECA,12260,11185,1075
Águas Belas,260050,PE,Nordeste,BUTANTAN/SINOVAC,11654,5898,5756
Águas Belas,260050,PE,Nordeste,PFIZER/BIONTECH,1165,1165,0
Águas Da Prata,350040,SP,Sudeste,BUTANTAN/SINOVAC,2445,1338,1107
Águas Da Prata,350040,SP,Sudeste,FIOCRUZ/ASTRAZENECA,2245,1935,310
Águas Da Prata,350040,SP,Sudeste,PFIZER/BIONTECH,237,237,0
Águas De Chapecó,420050,SC,Sul,FIOCRUZ/ASTRAZENECA,1590,1444,146
Águas De Chapecó,420050,SC,Sul,BUTANTAN/SINOVAC,1276,646,630
Águas De Lindóia,350050,SP,Sudeste,BUTANTAN/SINOVAC,4953,2645,2308
Águas De Lindóia,350050,SP,Sudeste,FIOCRUZ/ASTRAZENECA,4175,3818,357
Águas De Lindóia,350050,SP,Sudeste,PFIZER/BIONTECH,115,115,0
Águas De Santa Bárbara,350055,SP,Sudeste,BUTANTAN/SINOVAC,1854,1105,749
Águas De Santa Bárbara,350055,SP,Sudeste,FIOCRUZ/ASTRAZENECA,1530,1404,126
Águas De Santa Bárbara,350055,SP,Sudeste,PFIZER/BIONTECH,85,85,0
Águas De São Pedro,350060,SP,Sudeste,BUTANTAN/SINOVAC,1879,1005,874
Águas De São Pedro,350060,SP,Sudeste,FIOCRUZ/ASTRAZENECA,1056,914,142
Águas De São Pedro,350060,SP,Sudeste,PFIZER/BIONTECH,136,136,0
Águas Formosas,310090,MG,Sudeste,BUTANTAN/SINOVAC,1916,1047,869
Águas Formosas,310090,MG,Sudeste,FIOCRUZ/ASTRAZENECA,569,567,2
Águas Frias,420055,SC,Sul,BUTANTAN/SINOVAC,831,464,367
Águas Frias,420055,SC,Sul,FIOCRUZ/ASTRAZENECA,749,697,52
Águas Frias,420055,SC,Sul,PFIZER/BIONTECH,30,30,0
Águas Lindas De Goiás,520025,GO,Centro-Oeste,FIOCRUZ/ASTRAZENECA,25066,22885,2181
Águas Lindas De Goiás,520025,GO,Centro-Oeste,BUTANTAN/SINOVAC,18323,9820,8503
Águas Mornas,420060,SC,Sul,FIOCRUZ/ASTRAZENECA,1807,1697,110
Águas Mornas,420060,SC,Sul,BUTANTAN/SINOVAC,1685,858,827
Águas Mornas,420060,SC,Sul,PFIZER/BIONTECH,103,103,0
Águas Vermelhas,310100,MG,Sudeste,BUTANTAN/SINOVAC,2604,1327,1277
Águas Vermelhas,310100,MG,Sudeste,FIOCRUZ/ASTRAZENECA,2482,2234,248
Águas Vermelhas,310100,MG,Sudeste,PFIZER/BIONTECH,149,149,0
Agudo,430010,RS,Sul,FIOCRUZ/ASTRAZENECA,4338,4029,309
Agudo,430010,RS,Sul,BUTANTAN/SINOVAC,4081,2061,2020
Agudo,430010,RS,Sul,PFIZER/BIONTECH,416,414,2
Agudos,350070,SP,Sudeste,BUTANTAN/SINOVAC,9556,5404,4152
Agudos,350070,SP,Sudeste,FIOCRUZ/ASTRAZENECA,8610,7947,663
Agudos,350070,SP,Sudeste,PFIZER/BIONTECH,903,903,0
Agudos Do Sul,410030,PR,Sul,FIOCRUZ/ASTRAZENECA,2905,2829,76
Agudos Do Sul,410030,PR,Sul,BUTANTAN/SINOVAC,1870,1055,815
Agudos Do Sul,410030,PR,Sul,PFIZER/BIONTECH,96,96,0
Águia Branca,320013,ES,Sudeste,BUTANTAN/SINOVAC,2517,1398,1119
Águia Branca,320013,ES,Sudeste,FIOCRUZ/ASTRAZENECA,2103,2021,82
Águia Branca,320013,ES,Sudeste,PFIZER/BIONTECH,394,394,0
Aguiar,250020,PB,Nordeste,BUTANTAN/SINOVAC,1614,823,791
Aguiar,250020,PB,Nordeste,FIOCRUZ/ASTRAZENECA,1287,1150,137
Aguiar,250020,PB,Nordeste,PFIZER/BIONTECH,82,82,0
Aguiarnópolis,170030,TO,Norte,FIOCRUZ/ASTRAZENECA,799,759,40
Aguiarnópolis,170030,TO,Norte,BUTANTAN/SINOVAC,720,376,344
Aimorés,310110,MG,Sudeste,BUTANTAN/SINOVAC,3223,1511,1712
Aimorés,310110,MG,Sudeste,FIOCRUZ/ASTRAZENECA,1414,1409,5
Aimorés,310110,MG,Sudeste,PFIZER/BIONTECH,2,2,0
Aiquara,290060,BA,Nordeste,BUTANTAN/SINOVAC,1188,613,575
Aiquara,290060,BA,Nordeste,FIOCRUZ/ASTRAZENECA,1107,989,118
Aiquara,290060,BA,Nordeste,PFIZER/BIONTECH,117,117,0
Aiuaba,230040,CE,Nordeste,BUTANTAN/SINOVAC,2915,1541,1374
Aiuaba,230040,CE,Nordeste,FIOCRUZ/ASTRAZENECA,1588,1292,296
Aiuruoca,310120,MG,Sudeste,BUTANTAN/SINOVAC,2215,1181,1034
Aiuruoca,310120,MG,Sudeste,FIOCRUZ/ASTRAZENECA,1661,1540,121
Aiuruoca,310120,MG,Sudeste,PFIZER/BIONTECH,81,81,0
Ajuricaba,430020,RS,Sul,BUTANTAN/SINOVAC,2296,1152,1144
Ajuricaba,430020,RS,Sul,FIOCRUZ/ASTRAZENECA,1910,1661,249
Ajuricaba,430020,RS,Sul,PFIZER/BIONTECH,285,285,0
Alagoa,310130,MG,Sudeste,FIOCRUZ/ASTRAZENECA,887,812,75
Alagoa,310130,MG,Sudeste,BUTANTAN/SINOVAC,771,402,369
Alagoa,310130,MG,Sudeste,PFIZER/BIONTECH,51,51,0
Alagoa Grande,250030,PB,Nordeste,BUTANTAN/SINOVAC,8052,4208,3844
Alagoa Grande,250030,PB,Nordeste,FIOCRUZ/ASTRAZENECA,4831,4483,348
Alagoa Grande,250030,PB,Nordeste,PFIZER/BIONTECH,398,398,0
Alagoa Nova,250040,PB,Nordeste,BUTANTAN/SINOVAC,4482,2253,2229
Alagoa Nova,250040,PB,Nordeste,FIOCRUZ/ASTRAZENECA,2729,2484,245
Alagoa Nova,250040,PB,Nordeste,PFIZER/BIONTECH,69,69,0
Alagoinha,250050,PB,Nordeste,BUTANTAN/SINOVAC,2726,1357,1369
Alagoinha,250050,PB,Nordeste,FIOCRUZ/ASTRAZENECA,2264,2035,229
Alagoinha,250050,PB,Nordeste,PFIZER/BIONTECH,270,270,0
Alagoinha,260060,PE,Nordeste,FIOCRUZ/ASTRAZENECA,5602,4937,665
Alagoinha,260060,PE,Nordeste,BUTANTAN/SINOVAC,2683,1362,1321
Alagoinha,260060,PE,Nordeste,PFIZER/BIONTECH,94,94,0
Alagoinha Do Piauí,220025,PI,Nordeste,FIOCRUZ/ASTRAZENECA,1455,1337,118
Alagoinha Do Piauí,220025,PI,Nordeste,BUTANTAN/SINOVAC,1454,738,716
Alagoinhas,290070,BA,Nordeste,BUTANTAN/SINOVAC,26478,13470,13008
Alagoinhas,290070,BA,Nordeste,FIOCRUZ/ASTRAZENECA,21814,19288,2526
Alagoinhas,290070,BA,Nordeste,PFIZER/BIONTECH,6213,6211,2
Alambari,350075,SP,Sudeste,BUTANTAN/SINOVAC,1285,629,656
Alambari,350075,SP,Sudeste,FIOCRUZ/ASTRAZENECA,1052,963,89
Alambari,350075,SP,Sudeste,PFIZER/BIONTECH,101,101,0
Albertina,310140,MG,Sudeste,FIOCRUZ/ASTRAZENECA,845,812,33
Albertina,310140,MG,Sudeste,BUTANTAN/SINOVAC,802,430,372
Albertina,310140,MG,Sudeste,PFIZER/BIONTECH,66,66,0
Alcântara,210020,MA,Nordeste,FIOCRUZ/ASTRAZENECA,20737,13029,7708
Alcântara,210020,MA,Nordeste,BUTANTAN/SINOVAC,2382,1544,838
Alcântaras,230050,CE,Nordeste,BUTANTAN/SINOVAC,2173,1149,1024
Alcântaras,230050,CE,Nordeste,FIOCRUZ/ASTRAZENECA,971,804,167
Alcantil,250053,PB,Nordeste,BUTANTAN/SINOVAC,1441,727,714
Alcantil,250053,PB,Nordeste,FIOCRUZ/ASTRAZENECA,941,839,102
Alcantil,250053,PB,Nordeste,PFIZER/BIONTECH,48,48,0
Alcinópolis,500025,MS,Centro-Oeste,FIOCRUZ/ASTRAZENECA,1228,1042,186
Alcinópolis,500025,MS,Centro-Oeste,BUTANTAN/SINOVAC,1062,552,510
Alcinópolis,500025,MS,Centro-Oeste,PFIZER/BIONTECH,214,214,0
Alcobaça,290080,BA,Nordeste,BUTANTAN/SINOVAC,3684,2564,1120
Alcobaça,290080,BA,Nordeste,FIOCRUZ/ASTRAZENECA,1183,1126,57
Aldeias Altas,210030,MA,Nordeste,BUTANTAN/SINOVAC,3282,1694,1588
Aldeias Altas,210030,MA,Nordeste,FIOCRUZ/ASTRAZENECA,2557,2357,200
Alecrim,430030,RS,Sul,BUTANTAN/SINOVAC,2464,1243,1221
Alecrim,430030,RS,Sul,FIOCRUZ/ASTRAZENECA,1798,1643,155
Alecrim,430030,RS,Sul,PFIZER/BIONTECH,246,246,0
Alegre,320020,ES,Sudeste,BUTANTAN/SINOVAC,9543,5030,4513
Alegre,320020,ES,Sudeste,FIOCRUZ/ASTRAZENECA,6997,6618,379
Alegre,320020,ES,Sudeste,PFIZER/BIONTECH,1207,1206,1
Alegrete,430040,RS,Sul,BUTANTAN/SINOVAC,21294,10739,10555
Alegrete,430040,RS,Sul,FIOCRUZ/ASTRAZENECA,19540,17842,1698
Alegrete,430040,RS,Sul,PFIZER/BIONTECH,1920,1915,5
Alegrete Do Piauí,220027,PI,Nordeste,BUTANTAN/SINOVAC,897,459,438
Alegrete Do Piauí,220027,PI,Nordeste,FIOCRUZ/ASTRAZENECA,856,789,67
Alegrete Do Piauí,220027,PI,Nordeste,PFIZER/BIONTECH,52,52,0
Alegria,430045,RS,Sul,BUTANTAN/SINOVAC,1398,706,692
Alegria,430045,RS,Sul,FIOCRUZ/ASTRAZENECA,1202,1096,106
Alegria,430045,RS,Sul,PFIZER/BIONTECH,169,169,0
Além Paraíba,310150,MG,Sudeste,BUTANTAN/SINOVAC,8388,4362,4026
Além Paraíba,310150,MG,Sudeste,FIOCRUZ/ASTRAZENECA,6879,6121,758
Alenquer,150040,PA,Norte,FIOCRUZ/ASTRAZENECA,13101,9128,3973
Alenquer,150040,PA,Norte,BUTANTAN/SINOVAC,2049,1062,987
Alexandria,240050,RN,Nordeste,FIOCRUZ/ASTRAZENECA,5777,5296,481
Alexandria,240050,RN,Nordeste,BUTANTAN/SINOVAC,5109,2652,2457
Alexandria,240050,RN,Nordeste,PFIZER/BIONTECH,574,573,1
Alexânia,520030,GO,Centro-Oeste,FIOCRUZ/ASTRAZENECA,7205,6870,335
Alexânia,520030,GO,Centro-Oeste,BUTANTAN/SINOVAC,4361,2346,2015
Alexânia,520030,GO,Centro-Oeste,PFIZER/BIONTECH,410,406,4
Alfenas,310160,MG,Sudeste,BUTANTAN/SINOVAC,6061,4332,1729
Alfenas,310160,MG,Sudeste,FIOCRUZ/ASTRAZENECA,3727,3725,2
Alfenas,310160,MG,Sudeste,PFIZER/BIONTECH,225,225,0
Alfredo Chaves,320030,ES,Sudeste,BUTANTAN/SINOVAC,4746,2446,2300
Alfredo Chaves,320030,ES,Sudeste,FIOCRUZ/ASTRAZENECA,3219,3053,166
Alfredo Chaves,320030,ES,Sudeste,PFIZER/BIONTECH,539,539,0
Alfredo Marcondes,350080,SP,Sudeste,BUTANTAN/SINOVAC,1652,858,794
Alfredo Marcondes,350080,SP,Sudeste,FIOCRUZ/ASTRAZENECA,1315,1174,141
Alfredo Marcondes,350080,SP,Sudeste,PFIZER/BIONTECH,129,129,0
Alfredo Vasconcelos,310163,MG,Sudeste,FIOCRUZ/ASTRAZENECA,1578,1307,271
Alfredo Vasconcelos,310163,MG,Sudeste,BUTANTAN/SINOVAC,1095,619,476
Alfredo Vasconcelos,310163,MG,Sudeste,PFIZER/BIONTECH,85,85,0
Alfredo Wagner,420070,SC,Sul,FIOCRUZ/ASTRAZENECA,2246,2087,159
Alfredo Wagner,420070,SC,Sul,BUTANTAN/SINOVAC,2013,1071,942
Alfredo Wagner,420070,SC,Sul,PFIZER/BIONTECH,291,291,0
Algodão De Jandaíra,250057,PB,Nordeste,BUTANTAN/SINOVAC,606,309,297
Algodão De Jandaíra,250057,PB,Nordeste,FIOCRUZ/ASTRAZENECA,420,381,39
Algodão De Jandaíra,250057,PB,Nordeste,PFIZER/BIONTECH,47,47,0
Alhandra,250060,PB,Nordeste,BUTANTAN/SINOVAC,2275,1243,1032
Alhandra,250060,PB,Nordeste,FIOCRUZ/ASTRAZENECA,2259,2121,138
Alhandra,250060,PB,Nordeste,PFIZER/BIONTECH,35,35,0
Aliança,260070,PE,Nordeste,FIOCRUZ/ASTRAZENECA,7983,7488,495
Aliança,260070,PE,Nordeste,BUTANTAN/SINOVAC,5983,3056,2927
Aliança,260070,PE,Nordeste,PFIZER/BIONTECH,542,542,0
Aliança Do Tocantins,170035,TO,Norte,BUTANTAN/SINOVAC,1323,675,648
Aliança Do Tocantins,170035,TO,Norte,FIOCRUZ/ASTRAZENECA,865,825,40
Almadina,290090,BA,Nordeste,BUTANTAN/SINOVAC,1544,793,751
Almadina,290090,BA,Nordeste,FIOCRUZ/ASTRAZENECA,1083,1018,65
Almadina,290090,BA,Nordeste,PFIZER/BIONTECH,18,18,0
Almas,170040,TO,Norte,FIOCRUZ/ASTRAZENECA,1576,1534,42
Almas,170040,TO,Norte,BUTANTAN/SINOVAC,1281,663,618
Almeirim,150050,PA,Norte,FIOCRUZ/ASTRAZENECA,6542,4640,1902
Almeirim,150050,PA,Norte,BUTANTAN/SINOVAC,1606,889,717
Almenara,310170,MG,Sudeste,BUTANTAN/SINOVAC,8517,4386,4131
Almenara,310170,MG,Sudeste,FIOCRUZ/ASTRAZENECA,8380,7811,569
Almenara,310170,MG,Sudeste,PFIZER/BIONTECH,639,639,0
Almino Afonso,240060,RN,Nordeste,BUTANTAN/SINOVAC,1317,673,644
Almino Afonso,240060,RN,Nordeste,FIOCRUZ/ASTRAZENECA,1031,974,57
Almino Afonso,240060,RN,Nordeste,PFIZER/BIONTECH,114,114,0
Almirante Tamandaré,410040,PR,Sul,FIOCRUZ/ASTRAZENECA,16681,16036,645
Almirante Tamandaré,410040,PR,Sul,BUTANTAN/SINOVAC,14479,7471,7008
Almirante Tamandaré,410040,PR,Sul,PFIZER/BIONTECH,3155,3153,2
Almirante Tamandaré Do Sul,430047,RS,Sul,BUTANTAN/SINOVAC,638,319,319
Almirante Tamandaré Do Sul,430047,RS,Sul,FIOCRUZ/ASTRAZENECA,591,509,82
Almirante Tamandaré Do Sul,430047,RS,Sul,PFIZER/BIONTECH,90,90,0
Aloândia,520050,GO,Centro-Oeste,FIOCRUZ/ASTRAZENECA,833,781,52
Aloândia,520050,GO,Centro-Oeste,BUTANTAN/SINOVAC,595,300,295
Aloândia,520050,GO,Centro-Oeste,PFIZER/BIONTECH,6,6,0
Alpercata,310180,MG,Sudeste,BUTANTAN/SINOVAC,1698,867,831
Alpercata,310180,MG,Sudeste,FIOCRUZ/ASTRAZENECA,1279,1179,100
Alpercata,310180,MG,Sudeste,PFIZER/BIONTECH,77,77,0
Alpestre,430050,RS,Sul,BUTANTAN/SINOVAC,1976,1041,935
Alpestre,430050,RS,Sul,FIOCRUZ/ASTRAZENECA,1912,1759,153
Alpestre,430050,RS,Sul,PFIZER/BIONTECH,249,247,2
Alpinópolis,310190,MG,Sudeste,BUTANTAN/SINOVAC,4037,2029,2008
Alpinópolis,310190,MG,Sudeste,FIOCRUZ/ASTRAZENECA,3940,3706,234
Alpinópolis,310190,MG,Sudeste,PFIZER/BIONTECH,185,185,0
Alta Floresta,510025,MT,Centro-Oeste,FIOCRUZ/ASTRAZENECA,8197,7425,772
Alta Floresta,510025,MT,Centro-Oeste,BUTANTAN/SINOVAC,6944,3564,3380
Alta Floresta,510025,MT,Centro-Oeste,PFIZER/BIONTECH,480,480,0
Alta Floresta D'Oeste,110001,RO,Norte,BUTANTAN/SINOVAC,5062,2729,2333
Alta Floresta D'Oeste,110001,RO,Norte,FIOCRUZ/ASTRAZENECA,4321,3858,463
Alta Floresta D'Oeste,110001,RO,Norte,PFIZER/BIONTECH,251,251,0
Altair,350090,SP,Sudeste,FIOCRUZ/ASTRAZENECA,888,799,89
Altair,350090,SP,Sudeste,BUTANTAN/SINOVAC,825,438,387
Altair,350090,SP,Sudeste,PFIZER/BIONTECH,132,132,0
Altamira,150060,PA,Norte,FIOCRUZ/ASTRAZENECA,21281,15988,5293
Altamira,150060,PA,Norte,BUTANTAN/SINOVAC,15483,8000,7483
Altamira,150060,PA,Norte,PFIZER/BIONTECH,50,48,2
Altamira Do Maranhão,210040,MA,Nordeste,FIOCRUZ/ASTRAZENECA,1495,1399,96
Altamira Do Maranhão,210040,MA,Nordeste,BUTANTAN/SINOVAC,1140,608,532
Altamira Do Paraná,410045,PR,Sul,FIOCRUZ/ASTRAZENECA,1285,1220,65
Altamira Do Paraná,410045,PR,Sul,BUTANTAN/SINOVAC,580,307,273
Altamira Do Paraná,410045,PR,Sul,PFIZER/BIONTECH,12,12,0
Altaneira,230060,CE,Nordeste,BUTANTAN/SINOVAC,2017,955,1062
Altaneira,230060,CE,Nordeste,FIOCRUZ/ASTRAZENECA,1796,1627,169
Altaneira,230060,CE,Nordeste,PFIZER/BIONTECH,5,5,0
Alterosa,310200,MG,Sudeste,FIOCRUZ/ASTRAZENECA,4529,4269,260
Alterosa,310200,MG,Sudeste,BUTANTAN/SINOVAC,2960,1718,1242
Alterosa,310200,MG,Sudeste,PFIZER/BIONTECH,273,273,0
Altinho,260080,PE,Nordeste,FIOCRUZ/ASTRAZENECA,5488,5035,453
Altinho,260080,PE,Nordeste,BUTANTAN/SINOVAC,4535,2324,2211
Altinho,260080,PE,Nordeste,PFIZER/BIONTECH,294,292,2
Altinópolis,350100,SP,Sudeste,BUTANTAN/SINOVAC,4640,2533,2107
Altinópolis,350100,SP,Sudeste,FIOCRUZ/ASTRAZENECA,4225,3807,418
Altinópolis,350100,SP,Sudeste,PFIZER/BIONTECH,369,369,0
Alto Alegre,140005,RR,Norte,BUTANTAN/SINOVAC,7894,4480,3414
Alto Alegre,140005,RR,Norte,FIOCRUZ/ASTRAZENECA,1912,1908,4
Alto Alegre,350110,SP,Sudeste,BUTANTAN/SINOVAC,1608,859,749
Alto Alegre,350110,SP,Sudeste,FIOCRUZ/ASTRAZENECA,1102,955,147
Alto Alegre,350110,SP,Sudeste,PFIZER/BIONTECH,68,68,0
Alto Alegre,430055,RS,Sul,BUTANTAN/SINOVAC,563,289,274
Alto Alegre,430055,RS,Sul,FIOCRUZ/ASTRAZENECA,432,375,57
Alto Alegre,430055,RS,Sul,PFIZER/BIONTECH,84,84,0
Alto Alegre Do Maranhão,210043,MA,Nordeste,FIOCRUZ/ASTRAZENECA,5257,4990,267
Alto Alegre Do Maranhão,210043,MA,Nordeste,BUTANTAN/SINOVAC,2908,1574,1334
Alto Alegre Do Pindaré,210047,MA,Nordeste,FIOCRUZ/ASTRAZENECA,6668,6339,329
Alto Alegre Do Pindaré,210047,MA,Nordeste,BUTANTAN/SINOVAC,6042,3474,2568
Alto Alegre Dos Parecis,110037,RO,Norte,BUTANTAN/SINOVAC,1997,1108,889
Alto Alegre Dos Parecis,110037,RO,Norte,FIOCRUZ/ASTRAZENECA,1552,1493,59
Alto Alegre Dos Parecis,110037,RO,Norte,PFIZER/BIONTECH,52,52,0
Alto Araguaia,510030,MT,Centro-Oeste,FIOCRUZ/ASTRAZENECA,3240,2994,246
Alto Araguaia,510030,MT,Centro-Oeste,BUTANTAN/SINOVAC,3225,1746,1479
Alto Araguaia,510030,MT,Centro-Oeste,PFIZER/BIONTECH,24,24,0
Alto Bela Vista,420075,SC,Sul,BUTANTAN/SINOVAC,680,351,329
Alto Bela Vista,420075,SC,Sul,FIOCRUZ/ASTRAZENECA,622,543,79
Alto Bela Vista,420075,SC,Sul,PFIZER/BIONTECH,55,55,0
Alto Boa Vista,510035,MT,Centro-Oeste,BUTANTAN/SINOVAC,1930,1007,923
Alto Boa Vista,510035,MT,Centro-Oeste,FIOCRUZ/ASTRAZENECA,788,725,63
Alto Boa Vista,510035,MT,Centro-Oeste,PFIZER/BIONTECH,48,48,0
Alto Caparaó,310205,MG,Sudeste,BUTANTAN/SINOVAC,1073,550,523
Alto Caparaó,310205,MG,Sudeste,FIOCRUZ/ASTRAZENECA,800,708,92
Alto Caparaó,310205,MG,Sudeste,PFIZER/BIONTECH,29,29,0
Alto Do Rodrigues,240070,RN,Nordeste,FIOCRUZ/ASTRAZENECA,2914,2785,129
Alto Do Rodrigues,240070,RN,Nordeste,BUTANTAN/SINOVAC,2022,1023,999
Alto Do Rodrigues,240070,RN,Nordeste,PFIZER/BIONTECH,416,416,0
Alto Feliz,430057,RS,Sul,BUTANTAN/SINOVAC,1453,727,726
Alto Feliz,430057,RS,Sul,FIOCRUZ/ASTRAZENECA,1450,1267,183
Alto Feliz,430057,RS,Sul,PFIZER/BIONTECH,50,50,0
Alto Garças,510040,MT,Centro-Oeste,FIOCRUZ/ASTRAZENECA,2437,2342,95
Alto Garças,510040,MT,Centro-Oeste,BUTANTAN/SINOVAC,2082,1058,1024
Alto Garças,510040,MT,Centro-Oeste,PFIZER/BIONTECH,206,206,0
Alto Horizonte,520055,GO,Centro-Oeste,FIOCRUZ/ASTRAZENECA,1613,1475,138
Alto Horizonte,520055,GO,Centro-Oeste,BUTANTAN/SINOVAC,1027,528,499
Alto Horizonte,520055,GO,Centro-Oeste,PFIZER/BIONTECH,105,105,0
Alto Jequitibá,315350,MG,Sudeste,BUTANTAN/SINOVAC,1908,1008,900
Alto Jequitibá,315350,MG,Sudeste,FIOCRUZ/ASTRAZENECA,1884,1740,144
Alto Jequitibá,315350,MG,Sudeste,PFIZER/BIONTECH,64,64,0
Alto Longá,220030,PI,Nordeste,FIOCRUZ/ASTRAZENECA,2941,2622,319
Alto Longá,220030,PI,Nordeste,BUTANTAN/SINOVAC,2642,1351,1291
Alto Longá,220030,PI,Nordeste,PFIZER/BIONTECH,303,303,0
Alto Paraguai,510050,MT,Centro-Oeste,BUTANTAN/SINOVAC,1534,798,736
Alto Paraguai,510050,MT,Centro-Oeste,FIOCRUZ/ASTRAZENECA,1426,1370,56
Alto Paraguai,510050,MT,Centro-Oeste,PFIZER/BIONTECH,46,46,0
Alto Paraíso,110040,RO,Norte,BUTANTAN/SINOVAC,2994,1638,1356
Alto Paraíso,110040,RO,Norte,FIOCRUZ/ASTRAZENECA,2401,2331,70
Alto Paraíso,110040,RO,Norte,PFIZER/BIONTECH,255,255,0
Alto Paraíso,412862,PR,Sul,FIOCRUZ/ASTRAZENECA,1267,1210,57
Alto Paraíso,412862,PR,Sul,BUTANTAN/SINOVAC,626,353,273
Alto Paraíso,412862,PR,Sul,PFIZER/BIONTECH,14,14,0
Alto Paraíso De Goiás,520060,GO,Centro-Oeste,FIOCRUZ/ASTRAZENECA,1961,1858,103
Alto Paraíso De Goiás,520060,GO,Centro-Oeste,BUTANTAN/SINOVAC,1363,693,670
Alto Paraíso De Goiás,520060,GO,Centro-Oeste,PFIZER/BIONTECH,30,30,0
Alto Paraná,410060,PR,Sul,FIOCRUZ/ASTRAZENECA,3580,3404,176
Alto Paraná,410060,PR,Sul,BUTANTAN/SINOVAC,2713,1372,1341
Alto Parnaíba,210050,MA,Nordeste,FIOCRUZ/ASTRAZENECA,2033,1928,105
Alto Parnaíba,210050,MA,Nordeste,BUTANTAN/SINOVAC,1412,810,602
Alto Piquiri,410070,PR,Sul,BUTANTAN/SINOVAC,2253,1159,1094
Alto Piquiri,410070,PR,Sul,FIOCRUZ/ASTRAZENECA,2231,2062,169
Alto Piquiri,410070,PR,Sul,PFIZER/BIONTECH,136,136,0
Alto Rio Doce,310210,MG,Sudeste,FIOCRUZ/ASTRAZENECA,3544,3084,460
Alto Rio Doce,310210,MG,Sudeste,BUTANTAN/SINOVAC,2913,1487,1426
Alto Rio Novo,320035,ES,Sudeste,BUTANTAN/SINOVAC,1979,1025,954
Alto Rio Novo,320035,ES,Sudeste,FIOCRUZ/ASTRAZENECA,1641,1571,70
Alto Rio Novo,320035,ES,Sudeste,PFIZER/BIONTECH,215,215,0
Alto Santo,230070,CE,Nordeste,BUTANTAN/SINOVAC,3016,1531,1485
Alto Santo,230070,CE,Nordeste,FIOCRUZ/ASTRAZENECA,2009,1741,268
Alto Taquari,510060,MT,Centro-Oeste,FIOCRUZ/ASTRAZENECA,1519,1428,91
Alto Taquari,510060,MT,Centro-Oeste,BUTANTAN/SINOVAC,1174,611,563
Alto Taquari,510060,MT,Centro-Oeste,PFIZER/BIONTECH,101,101,0
Altônia,410050,PR,Sul,FIOCRUZ/ASTRAZENECA,5530,5194,336
Altônia,410050,PR,Sul,BUTANTAN/SINOVAC,5005,2584,2421
Altônia,410050,PR,Sul,PFIZER/BIONTECH,646,646,0
Altos,220040,PI,Nordeste,FIOCRUZ/ASTRAZENECA,8053,7434,619
Altos,220040,PI,Nordeste,BUTANTAN/SINOVAC,6432,3440,2992
Alumínio,350115,SP,Sudeste,FIOCRUZ/ASTRAZENECA,3451,3222,229
Alumínio,350115,SP,Sudeste,BUTANTAN/SINOVAC,2722,1401,1321
Alumínio,350115,SP,Sudeste,PFIZER/BIONTECH,178,178,0
Alvarães,130002,AM,Norte,BUTANTAN/SINOVAC,2964,1514,1450
Alvarães,130002,AM,Norte,FIOCRUZ/ASTRAZENECA,2619,2047,572
Alvarenga,310220,MG,Sudeste,BUTANTAN/SINOVAC,1114,574,540
Alvarenga,310220,MG,Sudeste,FIOCRUZ/ASTRAZENECA,1102,1002,100
Alvarenga,310220,MG,Sudeste,PFIZER/BIONTECH,30,30,0
Álvares Florence,350120,SP,Sudeste,BUTANTAN/SINOVAC,1436,806,630
Álvares Florence,350120,SP,Sudeste,FIOCRUZ/ASTRAZENECA,1072,963,109
Álvares Florence,350120,SP,Sudeste,PFIZER/BIONTECH,90,90,0
Álvares Machado,350130,SP,Sudeste,BUTANTAN/SINOVAC,6092,3437,2655
Álvares Machado,350130,SP,Sudeste,FIOCRUZ/ASTRAZENECA,5683,5294,389
Álvares Machado,350130,SP,Sudeste,PFIZER/BIONTECH,524,524,0
Álvaro De Carvalho,350140,SP,Sudeste,BUTANTAN/SINOVAC,1525,917,608
Álvaro De Carvalho,350140,SP,Sudeste,FIOCRUZ/ASTRAZENECA,884,828,56
Álvaro De Carvalho,350140,SP,Sudeste,PFIZER/BIONTECH,149,149,0
Alvinlândia,350150,SP,Sudeste,BUTANTAN/SINOVAC,823,446,377
Alvinlândia,350150,SP,Sudeste,FIOCRUZ/ASTRAZENECA,743,673,70
Alvinlândia,350150,SP,Sudeste,PFIZER/BIONTECH,40,40,0
Alvinópolis,310230,MG,Sudeste,BUTANTAN/SINOVAC,3861,1993,1868
Alvinópolis,310230,MG,Sudeste,FIOCRUZ/ASTRAZENECA,3232,2968,264
Alvinópolis,310230,MG,Sudeste,PFIZER/BIONTECH,168,168,0
Alvorada,170070,TO,Norte,BUTANTAN/SINOVAC,1573,820,753
Alvorada,170070,TO,Norte,FIOCRUZ/ASTRAZENECA,1316,1240,76
Alvorada,430060,RS,Sul,FIOCRUZ/ASTRAZENECA,47406,44895,2511
Alvorada,430060,RS,Sul,BUTANTAN/SINOVAC,37679,19055,18624
Alvorada,430060,RS,Sul,PFIZER/BIONTECH,6809,6527,282
Alvorada D'Oeste,110034,RO,Norte,BUTANTAN/SINOVAC,2914,1619,1295
Alvorada D'Oeste,110034,RO,Norte,FIOCRUZ/ASTRAZENECA,2581,2492,89
Alvorada D'Oeste,110034,RO,Norte,PFIZER/BIONTECH,270,264,6
Alvorada De Minas,310240,MG,Sudeste,FIOCRUZ/ASTRAZENECA,811,738,73
Alvorada De Minas,310240,MG,Sudeste,BUTANTAN/SINOVAC,713,404,309
Alvorada De Minas,310240,MG,Sudeste,PFIZER/BIONTECH,47,47,0
Alvorada Do Gurguéia,220045,PI,Nordeste,FIOCRUZ/ASTRAZENECA,1133,1075,58
Alvorada Do Gurguéia,220045,PI,Nordeste,BUTANTAN/SINOVAC,1048,569,479
Alvorada Do Norte,520080,GO,Centro-Oeste,FIOCRUZ/ASTRAZENECA,2707,2415,292
Alvorada Do Norte,520080,GO,Centro-Oeste,BUTANTAN/SINOVAC,912,524,388
Alvorada Do Sul,410080,PR,Sul,FIOCRUZ/ASTRAZENECA,2874,2687,187
Alvorada Do Sul,410080,PR,Sul,BUTANTAN/SINOVAC,2511,1315,1196
Amajari,140002,RR,Norte,BUTANTAN/SINOVAC,6265,3415,2850
Amajari,140002,RR,Norte,FIOCRUZ/ASTRAZENECA,998,996,2
Amambai,500060,MS,Centro-Oeste,BUTANTAN/SINOVAC,20903,11322,9581
Amambai,500060,MS,Centro-Oeste,FIOCRUZ/ASTRAZENECA,9678,8887,791
Amambai,500060,MS,Centro-Oeste,PFIZER/BIONTECH,922,921,1
Amapá,160010,AP,Norte,BUTANTAN/SINOVAC,1355,685,670
Amapá,160010,AP,Norte,FIOCRUZ/ASTRAZENECA,1136,1067,69
Amapá,160010,AP,Norte,PFIZER/BIONTECH,108,108,0
Amapá Do Maranhão,210055,MA,Nordeste,FIOCRUZ/ASTRAZENECA,1182,1085,97
Amapá Do Maranhão,210055,MA,Nordeste,BUTANTAN/SINOVAC,1072,543,529
Amaporã,410090,PR,Sul,FIOCRUZ/ASTRAZENECA,1480,1382,98
Amaporã,410090,PR,Sul,BUTANTAN/SINOVAC,920,500,420
Amaporã,410090,PR,Sul,PFIZER/BIONTECH,19,19,0
Amaraji,260090,PE,Nordeste,FIOCRUZ/ASTRAZENECA,3132,2961,171
Amaraji,260090,PE,Nordeste,BUTANTAN/SINOVAC,2487,1407,1080
Amaraji,260090,PE,Nordeste,PFIZER/BIONTECH,90,90,0
Amaral Ferrador,430063,RS,Sul,BUTANTAN/SINOVAC,1454,734,720
Amaral Ferrador,430063,RS,Sul,FIOCRUZ/ASTRAZENECA,808,776,32
Amaral Ferrador,430063,RS,Sul,PFIZER/BIONTECH,234,234,0
Amaralina,520082,GO,Centro-Oeste,FIOCRUZ/ASTRAZENECA,910,875,35
Amaralina,520082,GO,Centro-Oeste,BUTANTAN/SINOVAC,613,338,275
Amarante,220050,PI,Nordeste,FIOCRUZ/ASTRAZENECA,5188,4587,601
Amarante,220050,PI,Nordeste,BUTANTAN/SINOVAC,4506,2178,2328
Amarante,220050,PI,Nordeste,PFIZER/BIONTECH,451,445,6
Amarante Do Maranhão,210060,MA,Nordeste,BUTANTAN/SINOVAC,7235,3938,3297
Amarante Do Maranhão,210060,MA,Nordeste,FIOCRUZ/ASTRAZENECA,5761,5411,350
Amargosa,290100,BA,Nordeste,BUTANTAN/SINOVAC,7482,3870,3612
Amargosa,290100,BA,Nordeste,FIOCRUZ/ASTRAZENECA,6721,6176,545
Amargosa,290100,BA,Nordeste,PFIZER/BIONTECH,689,687,2
Amaturá,130006,AM,Norte,BUTANTAN/SINOVAC,1895,1492,403
Amélia Rodrigues,290110,BA,Nordeste,FIOCRUZ/ASTRAZENECA,5001,4408,593
Amélia Rodrigues,290110,BA,Nordeste,BUTANTAN/SINOVAC,4113,2104,2009
Amélia Rodrigues,290110,BA,Nordeste,PFIZER/BIONTECH,844,839,5
América Dourada,290115,BA,Nordeste,FIOCRUZ/ASTRAZENECA,6812,6172,640
América Dourada,290115,BA,Nordeste,BUTANTAN/SINOVAC,2784,1435,1349
América Dourada,290115,BA,Nordeste,PFIZER/BIONTECH,166,166,0
Americana,350160,SP,Sudeste,BUTANTAN/SINOVAC,56634,33421,23213
Americana,350160,SP,Sudeste,FIOCRUZ/ASTRAZENECA,55605,51413,4192
Americana,350160,SP,Sudeste,PFIZER/BIONTECH,4491,4489,2
Americano Do Brasil,520085,GO,Centro-Oeste,BUTANTAN/SINOVAC,903,494,409
Americano Do Brasil,520085,GO,Centro-Oeste,FIOCRUZ/ASTRAZENECA,748,700,48
Américo Brasiliense,350170,SP,Sudeste,BUTANTAN/SINOVAC,8469,4672,3797
Américo Brasiliense,350170,SP,Sudeste,FIOCRUZ/ASTRAZENECA,6920,6616,304
Américo Brasiliense,350170,SP,Sudeste,PFIZER/BIONTECH,770,769,1
Américo De Campos,350180,SP,Sudeste,BUTANTAN/SINOVAC,1615,908,707
Américo De Campos,350180,SP,Sudeste,FIOCRUZ/ASTRAZENECA,1521,1354,167
Américo De Campos,350180,SP,Sudeste,PFIZER/BIONTECH,131,131,0
Ametista Do Sul,430064,RS,Sul,BUTANTAN/SINOVAC,1740,882,858
Ametista Do Sul,430064,RS,Sul,FIOCRUZ/ASTRAZENECA,1651,1540,111
Ametista Do Sul,430064,RS,Sul,PFIZER/BIONTECH,291,291,0
Amontada,230075,CE,Nordeste,BUTANTAN/SINOVAC,6125,3269,2856
Amontada,230075,CE,Nordeste,FIOCRUZ/ASTRAZENECA,2742,1853,889
Amontada,230075,CE,Nordeste,PFIZER/BIONTECH,3,1,2
Amorinópolis,520090,GO,Centro-Oeste,FIOCRUZ/ASTRAZENECA,1008,953,55
Amorinópolis,520090,GO,Centro-Oeste,BUTANTAN/SINOVAC,888,458,430
Amparo,250073,PB,Nordeste,BUTANTAN/SINOVAC,562,298,264
Amparo,250073,PB,Nordeste,FIOCRUZ/ASTRAZENECA,419,377,42
Amparo,250073,PB,Nordeste,PFIZER/BIONTECH,52,52,0
Amparo,350190,SP,Sudeste,FIOCRUZ/ASTRAZENECA,19874,18284,1590
Amparo,350190,SP,Sudeste,BUTANTAN/SINOVAC,19182,10724,8458
Amparo,350190,SP,Sudeste,PFIZER/BIONTECH,922,921,1
Amparo Da Serra,310250,MG,Sudeste,BUTANTAN/SINOVAC,1251,631,620
Amparo Da Serra,310250,MG,Sudeste,FIOCRUZ/ASTRAZENECA,936,866,70
Amparo De São Francisco,280010,SE,Nordeste,FIOCRUZ/ASTRAZENECA,703,672,31
Amparo De São Francisco,280010,SE,Nordeste,BUTANTAN/SINOVAC,680,396,284
Amparo De São Francisco,280010,SE,Nordeste,PFIZER/BIONTECH,43,43,0
Ampére,410100,PR,Sul,FIOCRUZ/ASTRAZENECA,4437,4230,207
Ampére,410100,PR,Sul,BUTANTAN/SINOVAC,3599,1907,1692
Ampére,410100,PR,Sul,PFIZER/BIONTECH,627,627,0
Anadia,270020,AL,Nordeste,FIOCRUZ/ASTRAZENECA,3618,3212,406
Anadia,270020,AL,Nordeste,BUTANTAN/SINOVAC,3031,1540,1491
Anagé,290120,BA,Nordeste,BUTANTAN/SINOVAC,5020,2604,2416
Anagé,290120,BA,Nordeste,FIOCRUZ/ASTRAZENECA,3615,3371,244
Anahy,410105,PR,Sul,FIOCRUZ/ASTRAZENECA,1272,1195,77
Anahy,410105,PR,Sul,BUTANTAN/SINOVAC,753,394,359
Anahy,410105,PR,Sul,PFIZER/BIONTECH,18,18,0
Anajás,150070,PA,Norte,FIOCRUZ/ASTRAZENECA,2764,2559,205
Anajás,150070,PA,Norte,BUTANTAN/SINOVAC,1075,567,508
Anajatuba,210070,MA,Nordeste,FIOCRUZ/ASTRAZENECA,8282,7945,337
Anajatuba,210070,MA,Nordeste,BUTANTAN/SINOVAC,4526,2566,1960
Analândia,350200,SP,Sudeste,FIOCRUZ/ASTRAZENECA,1155,1090,65
Analândia,350200,SP,Sudeste,BUTANTAN/SINOVAC,1083,546,537
Analândia,350200,SP,Sudeste,PFIZER/BIONTECH,116,116,0
Anamã,130008,AM,Norte,FIOCRUZ/ASTRAZENECA,2660,2395,265
Anamã,130008,AM,Norte,BUTANTAN/SINOVAC,1481,810,671
Ananás,170100,TO,Norte,BUTANTAN/SINOVAC,1909,987,922
Ananás,170100,TO,Norte,FIOCRUZ/ASTRAZENECA,1577,1498,79
Ananindeua,150080,PA,Norte,BUTANTAN/SINOVAC,88116,47947,40169
Ananindeua,150080,PA,Norte,FIOCRUZ/ASTRAZENECA,51281,51175,106
Ananindeua,150080,PA,Norte,PFIZER/BIONTECH,18153,18146,7
Anápolis,520110,GO,Centro-Oeste,BUTANTAN/SINOVAC,77990,42313,35677
Anápolis,520110,GO,Centro-Oeste,FIOCRUZ/ASTRAZENECA,75581,70055,5526
Anápolis,520110,GO,Centro-Oeste,PFIZER/BIONTECH,22448,22422,26
Anapu,150085,PA,Norte,BUTANTAN/SINOVAC,3320,1752,1568
Anapu,150085,PA,Norte,FIOCRUZ/ASTRAZENECA,2712,2194,518
Anapurus,210080,MA,Nordeste,FIOCRUZ/ASTRAZENECA,2196,2032,164
Anapurus,210080,MA,Nordeste,BUTANTAN/SINOVAC,1987,1114,873
Anastácio,500070,MS,Centro-Oeste,FIOCRUZ/ASTRAZENECA,5768,5074,694
Anastácio,500070,MS,Centro-Oeste,BUTANTAN/SINOVAC,5296,2725,2571
Anastácio,500070,MS,Centro-Oeste,PFIZER/BIONTECH,857,857,0
Anaurilândia,500080,MS,Centro-Oeste,BUTANTAN/SINOVAC,2408,1288,1120
Anaurilândia,500080,MS,Centro-Oeste,FIOCRUZ/ASTRAZENECA,2342,2072,270
Anaurilândia,500080,MS,Centro-Oeste,PFIZER/BIONTECH,329,329,0
Anchieta,320040,ES,Sudeste,BUTANTAN/SINOVAC,8282,4346,3936
Anchieta,320040,ES,Sudeste,FIOCRUZ/ASTRAZENECA,6663,6368,295
Anchieta,320040,ES,Sudeste,PFIZER/BIONTECH,1152,1152,0
Anchieta,420080,SC,Sul,FIOCRUZ/ASTRAZENECA,1921,1758,163
Anchieta,420080,SC,Sul,BUTANTAN/SINOVAC,1671,896,775
Anchieta,420080,SC,Sul,PFIZER/BIONTECH,84,84,0
Andaraí,290130,BA,Nordeste,FIOCRUZ/ASTRAZENECA,2574,2278,296
Andaraí,290130,BA,Nordeste,BUTANTAN/SINOVAC,2026,1058,968
Andaraí,290130,BA,Nordeste,PFIZER/BIONTECH,162,162,0
Andirá,410110,PR,Sul,FIOCRUZ/ASTRAZENECA,5966,5713,253
Andirá,410110,PR,Sul,BUTANTAN/SINOVAC,5045,2628,2417
Andirá,410110,PR,Sul,PFIZER/BIONTECH,145,145,0
Andorinha,290135,BA,Nordeste,FIOCRUZ/ASTRAZENECA,3629,3169,460
Andorinha,290135,BA,Nordeste,BUTANTAN/SINOVAC,2649,1400,1249
Andorinha,290135,BA,Nordeste,PFIZER/BIONTECH,344,344,0
Andradas,310260,MG,Sudeste,FIOCRUZ/ASTRAZENECA,9188,8454,734
Andradas,310260,MG,Sudeste,BUTANTAN/SINOVAC,8637,4354,4283
Andradas,310260,MG,Sudeste,PFIZER/BIONTECH,786,786,0
Andradina,350210,SP,Sudeste,BUTANTAN/SINOVAC,15593,8241,7352
Andradina,350210,SP,Sudeste,FIOCRUZ/ASTRAZENECA,15495,14226,1269
Andradina,350210,SP,Sudeste,PFIZER/BIONTECH,1321,1321,0
André Da Rocha,430066,RS,Sul,FIOCRUZ/ASTRAZENECA,445,384,61
André Da Rocha,430066,RS,Sul,BUTANTAN/SINOVAC,418,227,191
André Da Rocha,430066,RS,Sul,PFIZER/BIONTECH,48,48,0
Andrelândia,310280,MG,Sudeste,FIOCRUZ/ASTRAZENECA,2921,2699,222
Andrelândia,310280,MG,Sudeste,BUTANTAN/SINOVAC,2885,1494,1391
Andrelândia,310280,MG,Sudeste,PFIZER/BIONTECH,427,426,1
Angatuba,350220,SP,Sudeste,FIOCRUZ/ASTRAZENECA,8149,7490,659
Angatuba,350220,SP,Sudeste,BUTANTAN/SINOVAC,6996,3513,3483
Angatuba,350220,SP,Sudeste,PFIZER/BIONTECH,1112,1104,8
Angelândia,310285,MG,Sudeste,BUTANTAN/SINOVAC,1542,774,768
Angelândia,310285,MG,Sudeste,FIOCRUZ/ASTRAZENECA,1383,1276,107
Angelândia,310285,MG,Sudeste,PFIZER/BIONTECH,44,44,0
Angélica,500085,MS,Centro-Oeste,FIOCRUZ/ASTRAZENECA,2599,2182,417
Angélica,500085,MS,Centro-Oeste,BUTANTAN/SINOVAC,2292,1188,1104
Angélica,500085,MS,Centro-Oeste,PFIZER/BIONTECH,462,462,0
Angelim,260100,PE,Nordeste,FIOCRUZ/ASTRAZENECA,3489,3267,222
Angelim,260100,PE,Nordeste,BUTANTAN/SINOVAC,2033,1030,1003
Angelim,260100,PE,Nordeste,PFIZER/BIONTECH,280,279,1
Angelina,420090,SC,Sul,FIOCRUZ/ASTRAZENECA,1302,1205,97
Angelina,420090,SC,Sul,BUTANTAN/SINOVAC,1170,588,582
Angical,290140,BA,Nordeste,BUTANTAN/SINOVAC,2966,1544,1422
Angical,290140,BA,Nordeste,FIOCRUZ/ASTRAZENECA,2210,2132,78
Angical,290140,BA,Nordeste,PFIZER/BIONTECH,17,17,0
Angical Do Piauí,220060,PI,Nordeste,FIOCRUZ/ASTRAZENECA,1562,1441,121
Angical Do Piauí,220060,PI,Nordeste,BUTANTAN/SINOVAC,1424,749,675
Angical Do Piauí,220060,PI,Nordeste,PFIZER/BIONTECH,22,22,0
Angico,170105,TO,Norte,BUTANTAN/SINOVAC,642,344,298
Angico,170105,TO,Norte,FIOCRUZ/ASTRAZENECA,397,385,12
Angicos,240080,RN,Nordeste,FIOCRUZ/ASTRAZENECA,2454,2317,137
Angicos,240080,RN,Nordeste,BUTANTAN/SINOVAC,2378,1271,1107
Angicos,240080,RN,Nordeste,PFIZER/BIONTECH,91,91,0
Angra Dos Reis,330010,RJ,Sudeste,BUTANTAN/SINOVAC,37035,19286,17749
Angra Dos Reis,330010,RJ,Sudeste,FIOCRUZ/ASTRAZENECA,36770,33312,3458
Angra Dos Reis,330010,RJ,Sudeste,PFIZER/BIONTECH,1768,1767,1
Anguera,290150,BA,Nordeste,BUTANTAN/SINOVAC,2828,1438,1390
Anguera,290150,BA,Nordeste,FIOCRUZ/ASTRAZENECA,2086,1925,161
Anguera,290150,BA,Nordeste,PFIZER/BIONTECH,162,162,0
Ângulo,410115,PR,Sul,FIOCRUZ/ASTRAZENECA,1040,990,50
Ângulo,410115,PR,Sul,BUTANTAN/SINOVAC,680,354,326
Anhanguera,520120,GO,Centro-Oeste,FIOCRUZ/ASTRAZENECA,417,394,23
Anhanguera,520120,GO,Centro-Oeste,BUTANTAN/SINOVAC,269,145,124
Anhembi,350230,SP,Sudeste,BUTANTAN/SINOVAC,1605,961,644
Anhembi,350230,SP,Sudeste,FIOCRUZ/ASTRAZENECA,1507,1402,105
Anhembi,350230,SP,Sudeste,PFIZER/BIONTECH,70,70,0
Anhumas,350240,SP,Sudeste,FIOCRUZ/ASTRAZENECA,1083,948,135
Anhumas,350240,SP,Sudeste,BUTANTAN/SINOVAC,1040,511,529
Anhumas,350240,SP,Sudeste,PFIZER/BIONTECH,105,105,0
Anicuns,520130,GO,Centro-Oeste,FIOCRUZ/ASTRAZENECA,5884,5371,513
Anicuns,520130,GO,Centro-Oeste,BUTANTAN/SINOVAC,4314,2230,2084
Anicuns,520130,GO,Centro-Oeste,PFIZER/BIONTECH,72,72,0
Anísio De Abreu,220070,PI,Nordeste,FIOCRUZ/ASTRAZENECA,1863,1751,112
Anísio De Abreu,220070,PI,Nordeste,BUTANTAN/SINOVAC,1406,725,681
Anísio De Abreu,220070,PI,Nordeste,PFIZER/BIONTECH,192,192,0
Anita Garibaldi,420100,SC,Sul,FIOCRUZ/ASTRAZENECA,2250,2081,169
Anita Garibaldi,420100,SC,Sul,BUTANTAN/SINOVAC,1692,865,827
Anita Garibaldi,420100,SC,Sul,PFIZER/BIONTECH,96,96,0
Anitápolis,420110,SC,Sul,FIOCRUZ/ASTRAZENECA,1100,1033,67
Anitápolis,420110,SC,Sul,BUTANTAN/SINOVAC,766,405,361
Anitápolis,420110,SC,Sul,PFIZER/BIONTECH,41,41,0
Anori,130010,AM,Norte,FIOCRUZ/ASTRAZENECA,2204,1730,474
Anori,130010,AM,Norte,BUTANTAN/SINOVAC,734,403,331
Anta Gorda,430070,RS,Sul,BUTANTAN/SINOVAC,2177,1097,1080
Anta Gorda,430070,RS,Sul,FIOCRUZ/ASTRAZENECA,1539,1391,148
Anta Gorda,430070,RS,Sul,PFIZER/BIONTECH,234,234,0
Antas,290160,BA,Nordeste,BUTANTAN/SINOVAC,4204,2308,1896
Antas,290160,BA,Nordeste,FIOCRUZ/ASTRAZENECA,3701,3540,161
Antonina,410120,PR,Sul,FIOCRUZ/ASTRAZENECA,7991,7700,291
Antonina,410120,PR,Sul,BUTANTAN/SINOVAC,5129,2615,2514
Antonina Do Norte,230080,CE,Nordeste,BUTANTAN/SINOVAC,1454,761,693
Antonina Do Norte,230080,CE,Nordeste,FIOCRUZ/ASTRAZENECA,544,366,178
Antônio Almeida,220080,PI,Nordeste,FIOCRUZ/ASTRAZENECA,752,591,161
Antônio Almeida,220080,PI,Nordeste,BUTANTAN/SINOVAC,505,262,243
Antônio Almeida,220080,PI,Nordeste,PFIZER/BIONTECH,42,42,0
Antônio Cardoso,290170,BA,Nordeste,FIOCRUZ/ASTRAZENECA,2463,2351,112
Antônio Cardoso,290170,BA,Nordeste,BUTANTAN/SINOVAC,2054,1043,1011
Antônio Cardoso,290170,BA,Nordeste,PFIZER/BIONTECH,152,151,1
Antônio Carlos,310290,MG,Sudeste,FIOCRUZ/ASTRAZENECA,2879,2276,603
Antônio Carlos,310290,MG,Sudeste,BUTANTAN/SINOVAC,2556,1306,1250
Antônio Carlos,310290,MG,Sudeste,PFIZER/BIONTECH,102,102,0
Antônio Carlos,420120,SC,Sul,FIOCRUZ/ASTRAZENECA,2893,2537,356
Antônio Carlos,420120,SC,Sul,BUTANTAN/SINOVAC,2121,1273,848
Antônio Dias,310300,MG,Sudeste,FIOCRUZ/ASTRAZENECA,2366,2131,235
Antônio Dias,310300,MG,Sudeste,BUTANTAN/SINOVAC,1806,954,852
Antônio Dias,310300,MG,Sudeste,PFIZER/BIONTECH,201,201,0
Antônio Gonçalves,290180,BA,Nordeste,FIOCRUZ/ASTRAZENECA,1936,1854,82
Antônio Gonçalves,290180,BA,Nordeste,BUTANTAN/SINOVAC,1780,964,816
Antônio Gonçalves,290180,BA,Nordeste,PFIZER/BIONTECH,6,6,0
Antônio João,500090,MS,Centro-Oeste,BUTANTAN/SINOVAC,3789,2001,1788
Antônio João,500090,MS,Centro-Oeste,FIOCRUZ/ASTRAZENECA,2210,1972,238
Antônio João,500090,MS,Centro-Oeste,PFIZER/BIONTECH,301,300,1
Antônio Martins,240090,RN,Nordeste,BUTANTAN/SINOVAC,1500,745,755
Antônio Martins,240090,RN,Nordeste,FIOCRUZ/ASTRAZENECA,1346,1243,103
Antônio Martins,240090,RN,Nordeste,PFIZER/BIONTECH,65,65,0
Antônio Olinto,410130,PR,Sul,FIOCRUZ/ASTRAZENECA,2362,2243,119
Antônio Olinto,410130,PR,Sul,BUTANTAN/SINOVAC,1532,790,742
Antônio Olinto,410130,PR,Sul,PFIZER/BIONTECH,98,98,0
Antônio Prado,430080,RS,Sul,BUTANTAN/SINOVAC,4230,2122,2108
Antônio Prado,430080,RS,Sul,FIOCRUZ/ASTRAZENECA,4158,3530,628
Antônio Prado,430080,RS,Sul,PFIZER/BIONTECH,432,432,0
Antônio Prado De Minas,310310,MG,Sudeste,BUTANTAN/SINOVAC,838,435,403
Antônio Prado De Minas,310310,MG,Sudeste,FIOCRUZ/ASTRAZENECA,586,526,60
Antônio Prado De Minas,310310,MG,Sudeste,PFIZER/BIONTECH,44,44,0
Aparecida,250077,PB,Nordeste,BUTANTAN/SINOVAC,2023,1070,953
Aparecida,250077,PB,Nordeste,FIOCRUZ/ASTRAZENECA,1460,1332,128
Aparecida,250077,PB,Nordeste,PFIZER/BIONTECH,144,144,0
Aparecida,350250,SP,Sudeste,FIOCRUZ/ASTRAZENECA,8984,8496,488
Aparecida,350250,SP,Sudeste,BUTANTAN/SINOVAC,8365,4413,3952
Aparecida,350250,SP,Sudeste,PFIZER/BIONTECH,638,636,2
Aparecida D'Oeste,350260,SP,Sudeste,FIOCRUZ/ASTRAZENECA,1774,1595,179
Aparecida D'Oeste,350260,SP,Sudeste,BUTANTAN/SINOVAC,1735,915,820
Aparecida D'Oeste,350260,SP,Sudeste,PFIZER/BIONTECH,153,153,0
Aparecida De Goiânia,520140,GO,Centro-Oeste,FIOCRUZ/ASTRAZENECA,86147,78357,7790
Aparecida De Goiânia,520140,GO,Centro-Oeste,BUTANTAN/SINOVAC,80448,42464,37984
Aparecida De Goiânia,520140,GO,Centro-Oeste,PFIZER/BIONTECH,31490,31423,67
Aparecida Do Rio Doce,520145,GO,Centro-Oeste,FIOCRUZ/ASTRAZENECA,697,646,51
Aparecida Do Rio Doce,520145,GO,Centro-Oeste,BUTANTAN/SINOVAC,511,259,252
Aparecida Do Rio Negro,170110,TO,Norte,BUTANTAN/SINOVAC,1016,539,477
Aparecida Do Rio Negro,170110,TO,Norte,FIOCRUZ/ASTRAZENECA,752,725,27
Aparecida Do Taboado,500100,MS,Centro-Oeste,FIOCRUZ/ASTRAZENECA,4509,3812,697
Aparecida Do Taboado,500100,MS,Centro-Oeste,BUTANTAN/SINOVAC,3632,2632,1000
Aparecida Do Taboado,500100,MS,Centro-Oeste,PFIZER/BIONTECH,801,801,0
Aperibé,330015,RJ,Sudeste,BUTANTAN/SINOVAC,3038,1598,1440
Aperibé,330015,RJ,Sudeste,FIOCRUZ/ASTRAZENECA,2800,2523,277
Apiacá,320050,ES,Sudeste,BUTANTAN/SINOVAC,2426,1230,1196
Apiacá,320050,ES,Sudeste,FIOCRUZ/ASTRAZENECA,2019,1927,92
Apiacá,320050,ES,Sudeste,PFIZER/BIONTECH,280,280,0
Apiacás,510080,MT,Centro-Oeste,BUTANTAN/SINOVAC,1518,852,666
Apiacás,510080,MT,Centro-Oeste,FIOCRUZ/ASTRAZENECA,913,857,56
Apiacás,510080,MT,Centro-Oeste,PFIZER/BIONTECH,135,135,0
Apiaí,350270,SP,Sudeste,BUTANTAN/SINOVAC,5456,3165,2291
Apiaí,350270,SP,Sudeste,FIOCRUZ/ASTRAZENECA,5416,5074,342
Apiaí,350270,SP,Sudeste,PFIZER/BIONTECH,815,815,0
Apicum-Açu,210083,MA,Nordeste,FIOCRUZ/ASTRAZENECA,2236,2094,142
Apicum-Açu,210083,MA,Nordeste,BUTANTAN/SINOVAC,1826,955,871
Apiúna,420125,SC,Sul,BUTANTAN/SINOVAC,2504,1233,1271
Apiúna,420125,SC,Sul,FIOCRUZ/ASTRAZENECA,1358,1294,64
Apodi,240100,RN,Nordeste,FIOCRUZ/ASTRAZENECA,11462,10457,1005
Apodi,240100,RN,Nordeste,BUTANTAN/SINOVAC,8767,4556,4211
Apodi,240100,RN,Nordeste,PFIZER/BIONTECH,1243,1242,1
Aporá,290190,BA,Nordeste,BUTANTAN/SINOVAC,987,765,222
Aporá,290190,BA,Nordeste,FIOCRUZ/ASTRAZENECA,237,236,1
Aporé,520150,GO,Centro-Oeste,BUTANTAN/SINOVAC,710,368,342
Aporé,520150,GO,Centro-Oeste,FIOCRUZ/ASTRAZENECA,555,492,63
Apuarema,290195,BA,Nordeste,BUTANTAN/SINOVAC,1568,809,759
Apuarema,290195,BA,Nordeste,FIOCRUZ/ASTRAZENECA,1543,1357,186
Apuarema,290195,BA,Nordeste,PFIZER/BIONTECH,100,100,0
Apucarana,410140,PR,Sul,FIOCRUZ/ASTRAZENECA,27901,26641,1260
Apucarana,410140,PR,Sul,BUTANTAN/SINOVAC,25073,14162,10911
Apucarana,410140,PR,Sul,PFIZER/BIONTECH,6065,6023,42
Apuí,130014,AM,Norte,FIOCRUZ/ASTRAZENECA,2650,2371,279
Apuí,130014,AM,Norte,BUTANTAN/SINOVAC,2217,1238,979
Apuiarés,230090,CE,Nordeste,BUTANTAN/SINOVAC,1941,1131,810
Apuiarés,230090,CE,Nordeste,FIOCRUZ/ASTRAZENECA,819,702,117
Aquidabã,280020,SE,Nordeste,BUTANTAN/SINOVAC,4429,2242,2187
Aquidabã,280020,SE,Nordeste,FIOCRUZ/ASTRAZENECA,4424,4185,239
Aquidabã,280020,SE,Nordeste,PFIZER/BIONTECH,302,302,0
Aquidauana,500110,MS,Centro-Oeste,BUTANTAN/SINOVAC,15480,8618,6862
Aquidauana,500110,MS,Centro-Oeste,FIOCRUZ/ASTRAZENECA,10070,8968,1102
Aquidauana,500110,MS,Centro-Oeste,PFIZER/BIONTECH,658,651,7
Aquiraz,230100,CE,Nordeste,FIOCRUZ/ASTRAZENECA,6385,5957,428
Aquiraz,230100,CE,Nordeste,BUTANTAN/SINOVAC,6043,3610,2433
Arabutã,420127,SC,Sul,BUTANTAN/SINOVAC,1338,717,621
Arabutã,420127,SC,Sul,FIOCRUZ/ASTRAZENECA,1128,1089,39
Arabutã,420127,SC,Sul,PFIZER/BIONTECH,132,132,0
Araçagi,250080,PB,Nordeste,BUTANTAN/SINOVAC,3858,1986,1872
Araçagi,250080,PB,Nordeste,FIOCRUZ/ASTRAZENECA,2506,2262,244
Araçagi,250080,PB,Nordeste,PFIZER/BIONTECH,73,73,0
Araçaí,310320,MG,Sudeste,BUTANTAN/SINOVAC,700,359,341
Araçaí,310320,MG,Sudeste,FIOCRUZ/ASTRAZENECA,603,520,83
Araçaí,310320,MG,Sudeste,PFIZER/BIONTECH,83,83,0
Aracaju,280030,SE,Nordeste,FIOCRUZ/ASTRAZENECA,199787,179745,20042
Aracaju,280030,SE,Nordeste,BUTANTAN/SINOVAC,139012,77400,61612
Aracaju,280030,SE,Nordeste,PFIZER/BIONTECH,43133,43124,9
Araçariguama,350275,SP,Sudeste,BUTANTAN/SINOVAC,3060,1604,1456
Araçariguama,350275,SP,Sudeste,FIOCRUZ/ASTRAZENECA,2905,2730,175
Araçariguama,350275,SP,Sudeste,PFIZER/BIONTECH,435,435,0
Araçás,290205,BA,Nordeste,FIOCRUZ/ASTRAZENECA,2271,2188,83
Araçás,290205,BA,Nordeste,BUTANTAN/SINOVAC,1424,792,632
Aracati,230110,CE,Nordeste,BUTANTAN/SINOVAC,13207,6758,6449
Aracati,230110,CE,Nordeste,FIOCRUZ/ASTRAZENECA,3400,2517,883
Aracatu,290200,BA,Nordeste,BUTANTAN/SINOVAC,2394,1536,858
Aracatu,290200,BA,Nordeste,FIOCRUZ/ASTRAZENECA,1785,1745,40
Araçatuba,350280,SP,Sudeste,BUTANTAN/SINOVAC,50453,26552,23901
Araçatuba,350280,SP,Sudeste,FIOCRUZ/ASTRAZENECA,50025,45821,4204
Araçatuba,350280,SP,Sudeste,PFIZER/BIONTECH,2741,2740,1
Araci,290210,BA,Nordeste,BUTANTAN/SINOVAC,8440,4518,3922
Araci,290210,BA,Nordeste,FIOCRUZ/ASTRAZENECA,8392,7362,1030
Araci,290210,BA,Nordeste,PFIZER/BIONTECH,1195,1193,2
Aracitaba,310330,MG,Sudeste,BUTANTAN/SINOVAC,771,392,379
Aracitaba,310330,MG,Sudeste,FIOCRUZ/ASTRAZENECA,587,536,51
Aracitaba,310330,MG,Sudeste,PFIZER/BIONTECH,71,70,1
Aracoiaba,230120,CE,Nordeste,BUTANTAN/SINOVAC,90,90,0
Aracoiaba,230120,CE,Nordeste,FIOCRUZ/ASTRAZENECA,20,20,0
Araçoiaba,260105,PE,Nordeste,BUTANTAN/SINOVAC,3053,1864,1189
Araçoiaba,260105,PE,Nordeste,FIOCRUZ/ASTRAZENECA,1742,1661,81
Araçoiaba,260105,PE,Nordeste,PFIZER/BIONTECH,109,109,0
Araçoiaba Da Serra,350290,SP,Sudeste,BUTANTAN/SINOVAC,6131,3548,2583
Araçoiaba Da Serra,350290,SP,Sudeste,FIOCRUZ/ASTRAZENECA,5760,5293,467
Araçoiaba Da Serra,350290,SP,Sudeste,PFIZER/BIONTECH,462,458,4
Aracruz,320060,ES,Sudeste,BUTANTAN/SINOVAC,23433,12416,11017
Aracruz,320060,ES,Sudeste,FIOCRUZ/ASTRAZENECA,21017,19734,1283
Aracruz,320060,ES,Sudeste,PFIZER/BIONTECH,2571,2566,5
Araçu,520160,GO,Centro-Oeste,FIOCRUZ/ASTRAZENECA,2221,2095,126
Araçu,520160,GO,Centro-Oeste,BUTANTAN/SINOVAC,1516,729,787
Araçuaí,310340,MG,Sudeste,BUTANTAN/SINOVAC,6756,3494,3262
Araçuaí,310340,MG,Sudeste,FIOCRUZ/ASTRAZENECA,5530,4994,536
Araçuaí,310340,MG,Sudeste,PFIZER/BIONTECH,893,893,0
Aragarças,520170,GO,Centro-Oeste,FIOCRUZ/ASTRAZENECA,3915,3776,139
Aragarças,520170,GO,Centro-Oeste,BUTANTAN/SINOVAC,3164,1678,1486
Aragoiânia,520180,GO,Centro-Oeste,FIOCRUZ/ASTRAZENECA,2999,2805,194
Aragoiânia,520180,GO,Centro-Oeste,BUTANTAN/SINOVAC,2324,1295,1029
Aragominas,170130,TO,Norte,FIOCRUZ/ASTRAZENECA,1495,1228,267
Aragominas,170130,TO,Norte,BUTANTAN/SINOVAC,1246,647,599
Araguacema,170190,TO,Norte,BUTANTAN/SINOVAC,1114,611,503
Araguacema,170190,TO,Norte,FIOCRUZ/ASTRAZENECA,933,898,35
Araguaçu,170200,TO,Norte,BUTANTAN/SINOVAC,2187,1102,1085
Araguaçu,170200,TO,Norte,FIOCRUZ/ASTRAZENECA,1631,1524,107
Araguaiana,510100,MT,Centro-Oeste,FIOCRUZ/ASTRAZENECA,1271,1236,35
Araguaiana,510100,MT,Centro-Oeste,BUTANTAN/SINOVAC,614,337,277
Araguaiana,510100,MT,Centro-Oeste,PFIZER/BIONTECH,14,14,0
Araguaína,170210,TO,Norte,FIOCRUZ/ASTRAZENECA,29705,26510,3195
Araguaína,170210,TO,Norte,BUTANTAN/SINOVAC,29579,15194,14385
Araguaína,170210,TO,Norte,PFIZER/BIONTECH,11876,11874,2
Araguainha,510120,MT,Centro-Oeste,BUTANTAN/SINOVAC,360,186,174
Araguainha,510120,MT,Centro-Oeste,FIOCRUZ/ASTRAZENECA,180,169,11
Araguanã,170215,TO,Norte,BUTANTAN/SINOVAC,953,507,446
Araguanã,170215,TO,Norte,FIOCRUZ/ASTRAZENECA,891,838,53
Araguanã,210087,MA,Nordeste,FIOCRUZ/ASTRAZENECA,2116,1984,132
Araguanã,210087,MA,Nordeste,BUTANTAN/SINOVAC,1835,989,846
Araguapaz,520215,GO,Centro-Oeste,FIOCRUZ/ASTRAZENECA,1823,1706,117
Araguapaz,520215,GO,Centro-Oeste,BUTANTAN/SINOVAC,1459,834,625
Araguari,310350,MG,Sudeste,BUTANTAN/SINOVAC,25766,13407,12359
Araguari,310350,MG,Sudeste,FIOCRUZ/ASTRAZENECA,20518,18296,2222
Araguari,310350,MG,Sudeste,PFIZER/BIONTECH,1943,1941,2
Araguatins,170220,TO,Norte,BUTANTAN/SINOVAC,5322,2720,2602
Araguatins,170220,TO,Norte,FIOCRUZ/ASTRAZENECA,3802,3617,185
Araioses,210090,MA,Nordeste,FIOCRUZ/ASTRAZENECA,8728,8503,225
Araioses,210090,MA,Nordeste,BUTANTAN/SINOVAC,5271,2999,2272
Aral Moreira,500124,MS,Centro-Oeste,BUTANTAN/SINOVAC,2975,1536,1439
Aral Moreira,500124,MS,Centro-Oeste,FIOCRUZ/ASTRAZENECA,2631,2179,452
Aral Moreira,500124,MS,Centro-Oeste,PFIZER/BIONTECH,289,288,1
Aramari,290220,BA,Nordeste,FIOCRUZ/ASTRAZENECA,1848,1792,56
Aramari,290220,BA,Nordeste,BUTANTAN/SINOVAC,1835,980,855
Arambaré,430085,RS,Sul,BUTANTAN/SINOVAC,1396,707,689
Arambaré,430085,RS,Sul,FIOCRUZ/ASTRAZENECA,1052,961,91
Arambaré,430085,RS,Sul,PFIZER/BIONTECH,51,51,0
Arame,210095,MA,Nordeste,BUTANTAN/SINOVAC,5306,3084,2222
Arame,210095,MA,Nordeste,FIOCRUZ/ASTRAZENECA,4463,4218,245
Aramina,350300,SP,Sudeste,BUTANTAN/SINOVAC,1447,801,646
Aramina,350300,SP,Sudeste,FIOCRUZ/ASTRAZENECA,1212,1090,122
Aramina,350300,SP,Sudeste,PFIZER/BIONTECH,70,69,1
Arandu,350310,SP,Sudeste,BUTANTAN/SINOVAC,1672,971,701
Arandu,350310,SP,Sudeste,FIOCRUZ/ASTRAZENECA,1593,1476,117
Arandu,350310,SP,Sudeste,PFIZER/BIONTECH,200,190,10
Arantina,310360,MG,Sudeste,BUTANTAN/SINOVAC,719,366,353
Arantina,310360,MG,Sudeste,FIOCRUZ/ASTRAZENECA,541,512,29
Arantina,310360,MG,Sudeste,PFIZER/BIONTECH,30,30,0
Arapeí,350315,SP,Sudeste,BUTANTAN/SINOVAC,650,361,289
Arapeí,350315,SP,Sudeste,FIOCRUZ/ASTRAZENECA,552,490,62
Arapeí,350315,SP,Sudeste,PFIZER/BIONTECH,44,44,0
Arapiraca,270030,AL,Nordeste,FIOCRUZ/ASTRAZENECA,40796,35975,4821
Arapiraca,270030,AL,Nordeste,BUTANTAN/SINOVAC,40409,20586,19823
Arapiraca,270030,AL,Nordeste,PFIZER/BIONTECH,12214,12197,17
Arapoema,170230,TO,Norte,FIOCRUZ/ASTRAZENECA,1260,1188,72
Arapoema,170230,TO,Norte,BUTANTAN/SINOVAC,1247,726,521
Araponga,310370,MG,Sudeste,BUTANTAN/SINOVAC,1163,655,508
Araponga,310370,MG,Sudeste,FIOCRUZ/ASTRAZENECA,1123,1085,38
Araponga,310370,MG,Sudeste,PFIZER/BIONTECH,104,104,0
Arapongas,410150,PR,Sul,FIOCRUZ/ASTRAZENECA,29327,26984,2343
Arapongas,410150,PR,Sul,BUTANTAN/SINOVAC,28161,15334,12827
Arapongas,410150,PR,Sul,PFIZER/BIONTECH,491,489,2
Araporã,310375,MG,Sudeste,BUTANTAN/SINOVAC,1741,881,860
Araporã,310375,MG,Sudeste,FIOCRUZ/ASTRAZENECA,1073,1012,61
Araporã,310375,MG,Sudeste,PFIZER/BIONTECH,30,30,0
Arapoti,410160,PR,Sul,FIOCRUZ/ASTRAZENECA,5572,5287,285
Arapoti,410160,PR,Sul,BUTANTAN/SINOVAC,4626,2396,2230
Arapoti,410160,PR,Sul,PFIZER/BIONTECH,546,546,0
Arapuá,310380,MG,Sudeste,BUTANTAN/SINOVAC,1090,549,541
Arapuá,310380,MG,Sudeste,FIOCRUZ/ASTRAZENECA,843,737,106
Arapuá,310380,MG,Sudeste,PFIZER/BIONTECH,124,124,0
Arapuã,410165,PR,Sul,FIOCRUZ/ASTRAZENECA,1084,1010,74
Arapuã,410165,PR,Sul,BUTANTAN/SINOVAC,1012,528,484
Arapuã,410165,PR,Sul,PFIZER/BIONTECH,17,17,0
Araputanga,510125,MT,Centro-Oeste,FIOCRUZ/ASTRAZENECA,3887,3641,246
Araputanga,510125,MT,Centro-Oeste,BUTANTAN/SINOVAC,2862,1451,1411
Araputanga,510125,MT,Centro-Oeste,PFIZER/BIONTECH,223,222,1
Araquari,420130,SC,Sul,FIOCRUZ/ASTRAZENECA,6918,6518,400
Araquari,420130,SC,Sul,BUTANTAN/SINOVAC,3970,2158,1812
Araquari,420130,SC,Sul,PFIZER/BIONTECH,711,709,2
Arara,250090,PB,Nordeste,BUTANTAN/SINOVAC,3970,2036,1934
Arara,250090,PB,Nordeste,FIOCRUZ/ASTRAZENECA,2604,2323,281
Arara,250090,PB,Nordeste,PFIZER/BIONTECH,39,39,0
Araranguá,420140,SC,Sul,FIOCRUZ/ASTRAZENECA,15584,14041,1543
Araranguá,420140,SC,Sul,BUTANTAN/SINOVAC,12195,6591,5604
Araranguá,420140,SC,Sul,PFIZER/BIONTECH,2904,2904,0
Araraquara,350320,SP,Sudeste,BUTANTAN/SINOVAC,61827,32944,28883
Araraquara,350320,SP,Sudeste,FIOCRUZ/ASTRAZENECA,55388,50214,5174
Araraquara,350320,SP,Sudeste,PFIZER/BIONTECH,3859,3852,7
Araras,350330,SP,Sudeste,FIOCRUZ/ASTRAZENECA,32826,29874,2952
Araras,350330,SP,Sudeste,BUTANTAN/SINOVAC,25999,14378,11621
Araras,350330,SP,Sudeste,PFIZER/BIONTECH,1946,1946,0
Ararendá,230125,CE,Nordeste,BUTANTAN/SINOVAC,2352,1175,1177
Ararendá,230125,CE,Nordeste,FIOCRUZ/ASTRAZENECA,1275,1034,241
Arari,210100,MA,Nordeste,FIOCRUZ/ASTRAZENECA,4343,4080,263
Arari,210100,MA,Nordeste,BUTANTAN/SINOVAC,3913,2089,1824
Araricá,430087,RS,Sul,BUTANTAN/SINOVAC,1952,1002,950
Araricá,430087,RS,Sul,FIOCRUZ/ASTRAZENECA,1403,1398,5
Araricá,430087,RS,Sul,PFIZER/BIONTECH,220,220,0
Araripe,230130,CE,Nordeste,BUTANTAN/SINOVAC,3092,1628,1464
Araripe,230130,CE,Nordeste,FIOCRUZ/ASTRAZENECA,2698,2156,542
Araripina,260110,PE,Nordeste,FIOCRUZ/ASTRAZENECA,16730,15483,1247
Araripina,260110,PE,Nordeste,BUTANTAN/SINOVAC,12625,6419,6206
Araripina,260110,PE,Nordeste,PFIZER/BIONTECH,2003,2003,0
Araruama,330020,RJ,Sudeste,BUTANTAN/SINOVAC,28376,14050,14326
Araruama,330020,RJ,Sudeste,FIOCRUZ/ASTRAZENECA,21549,18977,2572
Araruna,250100,PB,Nordeste,BUTANTAN/SINOVAC,3767,2024,1743
Araruna,250100,PB,Nordeste,FIOCRUZ/ASTRAZENECA,2325,2083,242
Araruna,250100,PB,Nordeste,PFIZER/BIONTECH,247,246,1
Araruna,410170,PR,Sul,FIOCRUZ/ASTRAZENECA,3937,3697,240
Araruna,410170,PR,Sul,BUTANTAN/SINOVAC,2814,1514,1300
Araruna,410170,PR,Sul,PFIZER/BIONTECH,101,101,0
Arataca,290225,BA,Nordeste,BUTANTAN/SINOVAC,1586,875,711
Arataca,290225,BA,Nordeste,FIOCRUZ/ASTRAZENECA,1408,1321,87
Arataca,290225,BA,Nordeste,PFIZER/BIONTECH,16,16,0
Aratiba,430090,RS,Sul,BUTANTAN/SINOVAC,2402,1203,1199
Aratiba,430090,RS,Sul,FIOCRUZ/ASTRAZENECA,1998,1735,263
Aratiba,430090,RS,Sul,PFIZER/BIONTECH,191,191,0
Aratuba,230140,CE,Nordeste,BUTANTAN/SINOVAC,3518,1764,1754
Aratuba,230140,CE,Nordeste,FIOCRUZ/ASTRAZENECA,2620,2412,208
Aratuba,230140,CE,Nordeste,PFIZER/BIONTECH,51,51,0
Aratuípe,290230,BA,Nordeste,BUTANTAN/SINOVAC,1366,743,623
Aratuípe,290230,BA,Nordeste,FIOCRUZ/ASTRAZENECA,1339,1256,83
Aratuípe,290230,BA,Nordeste,PFIZER/BIONTECH,160,160,0
Arauá,280040,SE,Nordeste,FIOCRUZ/ASTRAZENECA,1777,1689,88
Arauá,280040,SE,Nordeste,BUTANTAN/SINOVAC,1765,935,830
Arauá,280040,SE,Nordeste,PFIZER/BIONTECH,219,219,0
Araucária,410180,PR,Sul,FIOCRUZ/ASTRAZENECA,26165,24875,1290
Araucária,410180,PR,Sul,BUTANTAN/SINOVAC,17927,9212,8715
Araucária,410180,PR,Sul,PFIZER/BIONTECH,7238,7236,2
Araújos,310390,MG,Sudeste,FIOCRUZ/ASTRAZENECA,1955,1821,134
Araújos,310390,MG,Sudeste,BUTANTAN/SINOVAC,1609,822,787
Araújos,310390,MG,Sudeste,PFIZER/BIONTECH,107,107,0
Araxá,310400,MG,Sudeste,FIOCRUZ/ASTRAZENECA,21591,19415,2176
Araxá,310400,MG,Sudeste,BUTANTAN/SINOVAC,20299,10346,9953
Araxá,310400,MG,Sudeste,PFIZER/BIONTECH,2166,2166,0
Arceburgo,310410,MG,Sudeste,FIOCRUZ/ASTRAZENECA,2386,2171,215
Arceburgo,310410,MG,Sudeste,BUTANTAN/SINOVAC,2352,1197,1155
Arceburgo,310410,MG,Sudeste,PFIZER/BIONTECH,102,102,0
Arco-Íris,350335,SP,Sudeste,BUTANTAN/SINOVAC,1261,612,649
Arco-Íris,350335,SP,Sudeste,FIOCRUZ/ASTRAZENECA,551,486,65
Arco-Íris,350335,SP,Sudeste,PFIZER/BIONTECH,94,94,0
Arcos,310420,MG,Sudeste,FIOCRUZ/ASTRAZENECA,8560,7940,620
Arcos,310420,MG,Sudeste,BUTANTAN/SINOVAC,7620,4033,3587
Arcos,310420,MG,Sudeste,PFIZER/BIONTECH,1176,1176,0
Arcoverde,260120,PE,Nordeste,BUTANTAN/SINOVAC,15311,8230,7081
Arcoverde,260120,PE,Nordeste,FIOCRUZ/ASTRAZENECA,13624,12446,1178
Arcoverde,260120,PE,Nordeste,PFIZER/BIONTECH,760,759,1
Areado,310430,MG,Sudeste,BUTANTAN/SINOVAC,3198,1647,1551
Areado,310430,MG,Sudeste,FIOCRUZ/ASTRAZENECA,1932,1842,90
Areado,310430,MG,Sudeste,PFIZER/BIONTECH,8,8,0
Areal,330022,RJ,Sudeste,BUTANTAN/SINOVAC,3487,1823,1664
Areal,330022,RJ,Sudeste,FIOCRUZ/ASTRAZENECA,2996,2779,217
Arealva,350340,SP,Sudeste,BUTANTAN/SINOVAC,2563,1418,1145
Arealva,350340,SP,Sudeste,FIOCRUZ/ASTRAZENECA,1958,1759,199
Arealva,350340,SP,Sudeste,PFIZER/BIONTECH,313,312,1
Areia,250110,PB,Nordeste,BUTANTAN/SINOVAC,5631,3052,2579
Areia,250110,PB,Nordeste,FIOCRUZ/ASTRAZENECA,4040,3691,349
Areia,250110,PB,Nordeste,PFIZER/BIONTECH,167,167,0
Areia Branca,240110,RN,Nordeste,FIOCRUZ/ASTRAZENECA,5367,4964,403
Areia Branca,240110,RN,Nordeste,BUTANTAN/SINOVAC,4450,2294,2156
Areia Branca,240110,RN,Nordeste,PFIZER/BIONTECH,621,621,0
Areia Branca,280050,SE,Nordeste,BUTANTAN/SINOVAC,2766,1447,1319
Areia Branca,280050,SE,Nordeste,FIOCRUZ/ASTRAZENECA,2452,2305,147
Areia Branca,280050,SE,Nordeste,PFIZER/BIONTECH,29,29,0
Areia De Baraúnas,250115,PB,Nordeste,BUTANTAN/SINOVAC,624,323,301
Areia De Baraúnas,250115,PB,Nordeste,FIOCRUZ/ASTRAZENECA,240,212,28
Areia De Baraúnas,250115,PB,Nordeste,PFIZER/BIONTECH,21,21,0
Areial,250120,PB,Nordeste,BUTANTAN/SINOVAC,1517,848,669
Areial,250120,PB,Nordeste,FIOCRUZ/ASTRAZENECA,1217,1086,131
Areial,250120,PB,Nordeste,PFIZER/BIONTECH,107,107,0
Areias,350350,SP,Sudeste,BUTANTAN/SINOVAC,892,495,397
Areias,350350,SP,Sudeste,FIOCRUZ/ASTRAZENECA,711,662,49
Areias,350350,SP,Sudeste,PFIZER/BIONTECH,48,48,0
Areiópolis,350360,SP,Sudeste,FIOCRUZ/ASTRAZENECA,2084,1962,122
Areiópolis,350360,SP,Sudeste,BUTANTAN/SINOVAC,1912,1174,738
Areiópolis,350360,SP,Sudeste,PFIZER/BIONTECH,183,183,0
Arenápolis,510130,MT,Centro-Oeste,BUTANTAN/SINOVAC,2208,1225,983
Arenápolis,510130,MT,Centro-Oeste,FIOCRUZ/ASTRAZENECA,2056,1779,277
Arenápolis,510130,MT,Centro-Oeste,PFIZER/BIONTECH,28,28,0
Arenópolis,520235,GO,Centro-Oeste,FIOCRUZ/ASTRAZENECA,723,661,62
Arenópolis,520235,GO,Centro-Oeste,BUTANTAN/SINOVAC,697,356,341
Arês,240120,RN,Nordeste,FIOCRUZ/ASTRAZENECA,2364,2267,97
Arês,240120,RN,Nordeste,BUTANTAN/SINOVAC,2090,1009,1081
Arês,240120,RN,Nordeste,PFIZER/BIONTECH,312,312,0
Argirita,310440,MG,Sudeste,BUTANTAN/SINOVAC,810,415,395
Argirita,310440,MG,Sudeste,FIOCRUZ/ASTRAZENECA,236,235,1
Argirita,310440,MG,Sudeste,PFIZER/BIONTECH,35,35,0
Aricanduva,310445,MG,Sudeste,BUTANTAN/SINOVAC,1453,795,658
Aricanduva,310445,MG,Sudeste,FIOCRUZ/ASTRAZENECA,801,704,97
Aricanduva,310445,MG,Sudeste,PFIZER/BIONTECH,148,148,0
Arinos,310450,MG,Sudeste,BUTANTAN/SINOVAC,3831,2061,1770
Arinos,310450,MG,Sudeste,FIOCRUZ/ASTRAZENECA,2499,2230,269
Arinos,310450,MG,Sudeste,PFIZER/BIONTECH,381,381,0
Aripuanã,510140,MT,Centro-Oeste,BUTANTAN/SINOVAC,2611,1391,1220
Aripuanã,510140,MT,Centro-Oeste,FIOCRUZ/ASTRAZENECA,2268,2134,134
Aripuanã,510140,MT,Centro-Oeste,PFIZER/BIONTECH,236,236,0
Ariquemes,110002,RO,Norte,FIOCRUZ/ASTRAZENECA,15844,15327,517
Ariquemes,110002,RO,Norte,BUTANTAN/SINOVAC,15244,8314,6930
Ariquemes,110002,RO,Norte,PFIZER/BIONTECH,2289,2288,1
Ariranha,350370,SP,Sudeste,BUTANTAN/SINOVAC,2294,1320,974
Ariranha,350370,SP,Sudeste,FIOCRUZ/ASTRAZENECA,2061,1837,224
Ariranha,350370,SP,Sudeste,PFIZER/BIONTECH,187,187,0
Ariranha Do Ivaí,410185,PR,Sul,FIOCRUZ/ASTRAZENECA,733,691,42
Ariranha Do Ivaí,410185,PR,Sul,BUTANTAN/SINOVAC,655,348,307
Ariranha Do Ivaí,410185,PR,Sul,PFIZER/BIONTECH,12,12,0
Armação Dos Búzios,330023,RJ,Sudeste,FIOCRUZ/ASTRAZENECA,5831,5554,277
Armação Dos Búzios,330023,RJ,Sudeste,BUTANTAN/SINOVAC,5823,3329,2494
Armação Dos Búzios,330023,RJ,Sudeste,PFIZER/BIONTECH,236,236,0
Armazém,420150,SC,Sul,FIOCRUZ/ASTRAZENECA,2789,2395,394
Armazém,420150,SC,Sul,BUTANTAN/SINOVAC,1509,868,641
Armazém,420150,SC,Sul,PFIZER/BIONTECH,136,136,0
Arneiroz,230150,CE,Nordeste,BUTANTAN/SINOVAC,910,732,178
Arneiroz,230150,CE,Nordeste,FIOCRUZ/ASTRAZENECA,245,235,10
Aroazes,220090,PI,Nordeste,BUTANTAN/SINOVAC,1539,797,742
Aroazes,220090,PI,Nordeste,FIOCRUZ/ASTRAZENECA,1173,1142,31
Aroazes,220090,PI,Nordeste,PFIZER/BIONTECH,135,135,0
Aroeiras,250130,PB,Nordeste,BUTANTAN/SINOVAC,4593,2315,2278
Aroeiras,250130,PB,Nordeste,FIOCRUZ/ASTRAZENECA,2973,2719,254
Aroeiras,250130,PB,Nordeste,PFIZER/BIONTECH,144,144,0
Aroeiras Do Itaim,220095,PI,Nordeste,BUTANTAN/SINOVAC,585,293,292
Aroeiras Do Itaim,220095,PI,Nordeste,FIOCRUZ/ASTRAZENECA,556,492,64
Arraial,220100,PI,Nordeste,FIOCRUZ/ASTRAZENECA,1048,966,82
Arraial,220100,PI,Nordeste,BUTANTAN/SINOVAC,906,458,448
Arraial,220100,PI,Nordeste,PFIZER/BIONTECH,94,94,0
Arraial Do Cabo,330025,RJ,Sudeste,FIOCRUZ/ASTRAZENECA,7645,7021,624
Arraial Do Cabo,330025,RJ,Sudeste,BUTANTAN/SINOVAC,7594,4083,3511
Arraial Do Cabo,330025,RJ,Sudeste,PFIZER/BIONTECH,735,735,0
Arraias,170240,TO,Norte,FIOCRUZ/ASTRAZENECA,3194,2955,239
Arraias,170240,TO,Norte,BUTANTAN/SINOVAC,2184,1137,1047
Arroio Do Meio,430100,RS,Sul,FIOCRUZ/ASTRAZENECA,5901,5233,668
Arroio Do Meio,430100,RS,Sul,BUTANTAN/SINOVAC,5774,2912,2862
Arroio Do Meio,430100,RS,Sul,PFIZER/BIONTECH,763,763,0
Arroio Do Padre,430107,RS,Sul,BUTANTAN/SINOVAC,1045,526,519
Arroio Do Padre,430107,RS,Sul,FIOCRUZ/ASTRAZENECA,604,565,39
Arroio Do Padre,430107,RS,Sul,PFIZER/BIONTECH,110,110,0
Arroio Do Sal,430105,RS,Sul,BUTANTAN/SINOVAC,3420,1781,1639
Arroio Do Sal,430105,RS,Sul,FIOCRUZ/ASTRAZENECA,3043,2801,242
Arroio Do Sal,430105,RS,Sul,PFIZER/BIONTECH,387,387,0
Arroio Do Tigre,430120,RS,Sul,FIOCRUZ/ASTRAZENECA,3346,2939,407
Arroio Do Tigre,430120,RS,Sul,BUTANTAN/SINOVAC,2855,1435,1420
Arroio Do Tigre,430120,RS,Sul,PFIZER/BIONTECH,214,214,0
Arroio Dos Ratos,430110,RS,Sul,BUTANTAN/SINOVAC,4305,2208,2097
Arroio Dos Ratos,430110,RS,Sul,FIOCRUZ/ASTRAZENECA,3018,2833,185
Arroio Dos Ratos,430110,RS,Sul,PFIZER/BIONTECH,174,174,0
Arroio Grande,430130,RS,Sul,BUTANTAN/SINOVAC,5315,2686,2629
Arroio Grande,430130,RS,Sul,FIOCRUZ/ASTRAZENECA,4416,4094,322
Arroio Grande,430130,RS,Sul,PFIZER/BIONTECH,675,675,0
Arroio Trinta,420160,SC,Sul,FIOCRUZ/ASTRAZENECA,1140,1045,95
Arroio Trinta,420160,SC,Sul,BUTANTAN/SINOVAC,1023,540,483
Arroio Trinta,420160,SC,Sul,PFIZER/BIONTECH,105,105,0
Artur Nogueira,350380,SP,Sudeste,FIOCRUZ/ASTRAZENECA,10175,9629,546
Artur Nogueira,350380,SP,Sudeste,BUTANTAN/SINOVAC,9797,5772,4025
Artur Nogueira,350380,SP,Sudeste,PFIZER/BIONTECH,787,787,0
Aruanã,520250,GO,Centro-Oeste,FIOCRUZ/ASTRAZENECA,1532,1451,81
Aruanã,520250,GO,Centro-Oeste,BUTANTAN/SINOVAC,1464,754,710
Arujá,350390,SP,Sudeste,FIOCRUZ/ASTRAZENECA,15733,14764,969
Arujá,350390,SP,Sudeste,BUTANTAN/SINOVAC,12463,7085,5378
Arujá,350390,SP,Sudeste,PFIZER/BIONTECH,1807,1802,5
Arvoredo,420165,SC,Sul,BUTANTAN/SINOVAC,848,519,329
Arvoredo,420165,SC,Sul,FIOCRUZ/ASTRAZENECA,749,696,53
Arvoredo,420165,SC,Sul,PFIZER/BIONTECH,70,70,0
Arvorezinha,430140,RS,Sul,FIOCRUZ/ASTRAZENECA,2789,2578,211
Arvorezinha,430140,RS,Sul,BUTANTAN/SINOVAC,2741,1396,1345
Arvorezinha,430140,RS,Sul,PFIZER/BIONTECH,124,124,0
Ascurra,420170,SC,Sul,BUTANTAN/SINOVAC,2227,1116,1111
Ascurra,420170,SC,Sul,FIOCRUZ/ASTRAZENECA,1198,1143,55
Ascurra,420170,SC,Sul,PFIZER/BIONTECH,237,237,0
Aspásia,350395,SP,Sudeste,BUTANTAN/SINOVAC,592,312,280
Aspásia,350395,SP,Sudeste,FIOCRUZ/ASTRAZENECA,562,522,40
Aspásia,350395,SP,Sudeste,PFIZER/BIONTECH,29,29,0
Assaí,410190,PR,Sul,FIOCRUZ/ASTRAZENECA,4283,4003,280
Assaí,410190,PR,Sul,BUTANTAN/SINOVAC,3599,1848,1751
Assaí,410190,PR,Sul,PFIZER/BIONTECH,186,186,0
Assaré,230160,CE,Nordeste,BUTANTAN/SINOVAC,4470,2567,1903
Assaré,230160,CE,Nordeste,FIOCRUZ/ASTRAZENECA,1780,1531,249
Assaré,230160,CE,Nordeste,PFIZER/BIONTECH,1,1,0
Assis,350400,SP,Sudeste,BUTANTAN/SINOVAC,35713,18665,17048
Assis,350400,SP,Sudeste,FIOCRUZ/ASTRAZENECA,29881,27114,2767
Assis,350400,SP,Sudeste,PFIZER/BIONTECH,2875,2872,3
Assis Brasil,120005,AC,Norte,BUTANTAN/SINOVAC,2322,1289,1033
Assis Brasil,120005,AC,Norte,FIOCRUZ/ASTRAZENECA,1302,1162,140
Assis Chateaubriand,410200,PR,Sul,FIOCRUZ/ASTRAZENECA,9410,8867,543
Assis Chateaubriand,410200,PR,Sul,BUTANTAN/SINOVAC,8613,4426,4187
Assis Chateaubriand,410200,PR,Sul,PFIZER/BIONTECH,969,969,0
Assunção,250135,PB,Nordeste,BUTANTAN/SINOVAC,1084,515,569
Assunção,250135,PB,Nordeste,FIOCRUZ/ASTRAZENECA,636,582,54
Assunção,250135,PB,Nordeste,PFIZER/BIONTECH,82,82,0
Assunção Do Piauí,220105,PI,Nordeste,FIOCRUZ/ASTRAZENECA,1945,1429,516
Assunção Do Piauí,220105,PI,Nordeste,BUTANTAN/SINOVAC,1215,614,601
Astolfo Dutra,310460,MG,Sudeste,BUTANTAN/SINOVAC,2253,1193,1060
Astolfo Dutra,310460,MG,Sudeste,FIOCRUZ/ASTRAZENECA,821,621,200
Astorga,410210,PR,Sul,FIOCRUZ/ASTRAZENECA,6190,5827,363
Astorga,410210,PR,Sul,BUTANTAN/SINOVAC,6043,3111,2932
Astorga,410210,PR,Sul,PFIZER/BIONTECH,723,723,0
Atalaia,270040,AL,Nordeste,FIOCRUZ/ASTRAZENECA,5925,5345,580
Atalaia,270040,AL,Nordeste,BUTANTAN/SINOVAC,5756,2951,2805
Atalaia,270040,AL,Nordeste,PFIZER/BIONTECH,429,429,0
Atalaia,410220,PR,Sul,FIOCRUZ/ASTRAZENECA,1656,1556,100
Atalaia,410220,PR,Sul,BUTANTAN/SINOVAC,1065,559,506
Atalaia,410220,PR,Sul,PFIZER/BIONTECH,21,21,0
Atalaia Do Norte,130020,AM,Norte,BUTANTAN/SINOVAC,4777,2757,2020
Atalaia Do Norte,130020,AM,Norte,FIOCRUZ/ASTRAZENECA,1731,1588,143
Atalanta,420180,SC,Sul,FIOCRUZ/ASTRAZENECA,857,811,46
Atalanta,420180,SC,Sul,BUTANTAN/SINOVAC,812,423,389
Atalanta,420180,SC,Sul,PFIZER/BIONTECH,91,91,0
Ataléia,310470,MG,Sudeste,BUTANTAN/SINOVAC,3634,1886,1748
Ataléia,310470,MG,Sudeste,FIOCRUZ/ASTRAZENECA,1101,916,185
Ataléia,310470,MG,Sudeste,PFIZER/BIONTECH,93,92,1
Atibaia,350410,SP,Sudeste,BUTANTAN/SINOVAC,34671,19545,15126
Atibaia,350410,SP,Sudeste,FIOCRUZ/ASTRAZENECA,27415,24699,2716
Atibaia,350410,SP,Sudeste,PFIZER/BIONTECH,2311,2309,2
Atilio Vivacqua,320070,ES,Sudeste,BUTANTAN/SINOVAC,3719,2062,1657
Atilio Vivacqua,320070,ES,Sudeste,FIOCRUZ/ASTRAZENECA,2482,2380,102
Atilio Vivacqua,320070,ES,Sudeste,PFIZER/BIONTECH,398,398,0
Augustinópolis,170255,TO,Norte,FIOCRUZ/ASTRAZENECA,3237,2932,305
Augustinópolis,170255,TO,Norte,BUTANTAN/SINOVAC,3038,1606,1432
Augusto Corrêa,150090,PA,Norte,FIOCRUZ/ASTRAZENECA,5899,5331,568
Augusto Corrêa,150090,PA,Norte,BUTANTAN/SINOVAC,4207,2495,1712
Augusto De Lima,310480,MG,Sudeste,BUTANTAN/SINOVAC,1122,588,534
Augusto De Lima,310480,MG,Sudeste,FIOCRUZ/ASTRAZENECA,489,449,40
Augusto De Lima,310480,MG,Sudeste,PFIZER/BIONTECH,24,24,0
Augusto Pestana,430150,RS,Sul,BUTANTAN/SINOVAC,2753,1397,1356
Augusto Pestana,430150,RS,Sul,FIOCRUZ/ASTRAZENECA,1909,1640,269
Augusto Pestana,430150,RS,Sul,PFIZER/BIONTECH,265,263,2
Augusto Severo,240130,RN,Nordeste,BUTANTAN/SINOVAC,2981,1558,1423
Augusto Severo,240130,RN,Nordeste,FIOCRUZ/ASTRAZENECA,2618,2469,149
Augusto Severo,240130,RN,Nordeste,PFIZER/BIONTECH,441,441,0
Áurea,430155,RS,Sul,BUTANTAN/SINOVAC,1329,669,660
Áurea,430155,RS,Sul,FIOCRUZ/ASTRAZENECA,968,825,143
Áurea,430155,RS,Sul,PFIZER/BIONTECH,142,142,0
Aurelino Leal,290240,BA,Nordeste,FIOCRUZ/ASTRAZENECA,2262,2072,190
Aurelino Leal,290240,BA,Nordeste,BUTANTAN/SINOVAC,2098,1173,925
Aurelino Leal,290240,BA,Nordeste,PFIZER/BIONTECH,257,257,0
Auriflama,350420,SP,Sudeste,BUTANTAN/SINOVAC,4248,2450,1798
Auriflama,350420,SP,Sudeste,FIOCRUZ/ASTRAZENECA,3406,3072,334
Auriflama,350420,SP,Sudeste,PFIZER/BIONTECH,478,478,0
Aurilândia,520260,GO,Centro-Oeste,FIOCRUZ/ASTRAZENECA,1287,1201,86
Aurilândia,520260,GO,Centro-Oeste,BUTANTAN/SINOVAC,1024,523,501
Aurilândia,520260,GO,Centro-Oeste,PFIZER/BIONTECH,17,17,0
Aurora,230170,CE,Nordeste,BUTANTAN/SINOVAC,4558,2407,2151
Aurora,230170,CE,Nordeste,FIOCRUZ/ASTRAZENECA,2939,2505,434
Aurora,420190,SC,Sul,FIOCRUZ/ASTRAZENECA,1577,1468,109
Aurora,420190,SC,Sul,BUTANTAN/SINOVAC,1274,671,603
Aurora,420190,SC,Sul,PFIZER/BIONTECH,249,249,0
Aurora Do Pará,150095,PA,Norte,FIOCRUZ/ASTRAZENECA,4145,3967,178
Aurora Do Pará,150095,PA,Norte,BUTANTAN/SINOVAC,2791,1491,1300
Aurora Do Tocantins,170270,TO,Norte,BUTANTAN/SINOVAC,881,457,424
Aurora Do Tocantins,170270,TO,Norte,FIOCRUZ/ASTRAZENECA,742,713,29
Autazes,130030,AM,Norte,BUTANTAN/SINOVAC,7860,4269,3591
Autazes,130030,AM,Norte,FIOCRUZ/ASTRAZENECA,6369,5260,1109
Avaí,350430,SP,Sudeste,BUTANTAN/SINOVAC,1955,987,968
Avaí,350430,SP,Sudeste,FIOCRUZ/ASTRAZENECA,1214,1108,106
Avaí,350430,SP,Sudeste,PFIZER/BIONTECH,180,180,0
Avanhandava,350440,SP,Sudeste,FIOCRUZ/ASTRAZENECA,2572,2420,152
Avanhandava,350440,SP,Sudeste,BUTANTAN/SINOVAC,2182,1239,943
Avanhandava,350440,SP,Sudeste,PFIZER/BIONTECH,289,289,0
Avaré,350450,SP,Sudeste,BUTANTAN/SINOVAC,23175,13195,9980
Avaré,350450,SP,Sudeste,FIOCRUZ/ASTRAZENECA,21562,19973,1589
Avaré,350450,SP,Sudeste,PFIZER/BIONTECH,2587,2587,0
Aveiro,150100,PA,Norte,FIOCRUZ/ASTRAZENECA,2081,1913,168
Aveiro,150100,PA,Norte,BUTANTAN/SINOVAC,1165,609,556
Avelino Lopes,220110,PI,Nordeste,FIOCRUZ/ASTRAZENECA,2141,2008,133
Avelino Lopes,220110,PI,Nordeste,BUTANTAN/SINOVAC,2039,1032,1007
Avelino Lopes,220110,PI,Nordeste,PFIZER/BIONTECH,244,244,0
Avelinópolis,520280,GO,Centro-Oeste,FIOCRUZ/ASTRAZENECA,1038,973,65
Avelinópolis,520280,GO,Centro-Oeste,BUTANTAN/SINOVAC,678,363,315
Avelinópolis,520280,GO,Centro-Oeste,PFIZER/BIONTECH,12,12,0
Axixá,210110,MA,Nordeste,FIOCRUZ/ASTRAZENECA,4766,3939,827
Axixá,210110,MA,Nordeste,BUTANTAN/SINOVAC,1873,986,887
Axixá Do Tocantins,170290,TO,Norte,BUTANTAN/SINOVAC,1772,998,774
Axixá Do Tocantins,170290,TO,Norte,FIOCRUZ/ASTRAZENECA,1596,1532,64
Babaçulândia,170300,TO,Norte,BUTANTAN/SINOVAC,1902,1015,887
Babaçulândia,170300,TO,Norte,FIOCRUZ/ASTRAZENECA,1061,1016,45
Bacabal,210120,MA,Nordeste,FIOCRUZ/ASTRAZENECA,24201,22308,1893
Bacabal,210120,MA,Nordeste,BUTANTAN/SINOVAC,16338,8715,7623
Bacabal,210120,MA,Nordeste,PFIZER/BIONTECH,976,976,0
Bacabeira,210125,MA,Nordeste,FIOCRUZ/ASTRAZENECA,2617,2412,205
Bacabeira,210125,MA,Nordeste,BUTANTAN/SINOVAC,2005,1033,972
Bacuri,210130,MA,Nordeste,FIOCRUZ/ASTRAZENECA,4212,3616,596
Bacuri,210130,MA,Nordeste,BUTANTAN/SINOVAC,3083,1587,1496
Bacurituba,210135,MA,Nordeste,FIOCRUZ/ASTRAZENECA,2451,1984,467
Bacurituba,210135,MA,Nordeste,BUTANTAN/SINOVAC,971,501,470
Bady Bassitt,350460,SP,Sudeste,BUTANTAN/SINOVAC,4860,2872,1988
Bady Bassitt,350460,SP,Sudeste,FIOCRUZ/ASTRAZENECA,4073,3798,275
Bady Bassitt,350460,SP,Sudeste,PFIZER/BIONTECH,361,361,0
Baependi,310490,MG,Sudeste,BUTANTAN/SINOVAC,5179,2659,2520
Baependi,310490,MG,Sudeste,FIOCRUZ/ASTRAZENECA,5099,4681,418
Baependi,310490,MG,Sudeste,PFIZER/BIONTECH,24,24,0
Bagé,430160,RS,Sul,FIOCRUZ/ASTRAZENECA,36363,33879,2484
Bagé,430160,RS,Sul,BUTANTAN/SINOVAC,29291,16309,12982
Bagé,430160,RS,Sul,PFIZER/BIONTECH,2455,2454,1
Bagre,150110,PA,Norte,FIOCRUZ/ASTRAZENECA,5491,4796,695
Bagre,150110,PA,Norte,BUTANTAN/SINOVAC,951,490,461
Baía Da Traição,250140,PB,Nordeste,BUTANTAN/SINOVAC,7274,3785,3489
Baía Da Traição,250140,PB,Nordeste,FIOCRUZ/ASTRAZENECA,2229,2151,78
Baía Da Traição,250140,PB,Nordeste,PFIZER/BIONTECH,211,211,0
Baía Formosa,240140,RN,Nordeste,FIOCRUZ/ASTRAZENECA,2136,1729,407
Baía Formosa,240140,RN,Nordeste,BUTANTAN/SINOVAC,1397,741,656
Baía Formosa,240140,RN,Nordeste,PFIZER/BIONTECH,226,226,0
Baianópolis,290250,BA,Nordeste,FIOCRUZ/ASTRAZENECA,2966,2713,253
Baianópolis,290250,BA,Nordeste,BUTANTAN/SINOVAC,2081,1123,958
Baianópolis,290250,BA,Nordeste,PFIZER/BIONTECH,121,120,1
Baião,150120,PA,Norte,FIOCRUZ/ASTRAZENECA,7773,7232,541
Baião,150120,PA,Norte,BUTANTAN/SINOVAC,3303,1689,1614
Baixa Grande,290260,BA,Nordeste,BUTANTAN/SINOVAC,4274,2299,1975
Baixa Grande,290260,BA,Nordeste,FIOCRUZ/ASTRAZENECA,2995,2774,221
Baixa Grande,290260,BA,Nordeste,PFIZER/BIONTECH,1,1,0
Baixa Grande Do Ribeiro,220115,PI,Nordeste,FIOCRUZ/ASTRAZENECA,1986,1899,87
Baixa Grande Do Ribeiro,220115,PI,Nordeste,BUTANTAN/SINOVAC,1192,697,495
Baixio,230180,CE,Nordeste,BUTANTAN/SINOVAC,1353,677,676
Baixio,230180,CE,Nordeste,FIOCRUZ/ASTRAZENECA,967,911,56
Baixo Guandu,320080,ES,Sudeste,BUTANTAN/SINOVAC,9473,5141,4332
Baixo Guandu,320080,ES,Sudeste,FIOCRUZ/ASTRAZENECA,7139,6815,324
Baixo Guandu,320080,ES,Sudeste,PFIZER/BIONTECH,1330,1329,1
Balbinos,350470,SP,Sudeste,FIOCRUZ/ASTRAZENECA,1217,1158,59
Balbinos,350470,SP,Sudeste,BUTANTAN/SINOVAC,976,630,346
Balbinos,350470,SP,Sudeste,PFIZER/BIONTECH,63,63,0
Baldim,310500,MG,Sudeste,FIOCRUZ/ASTRAZENECA,2163,2033,130
Baldim,310500,MG,Sudeste,BUTANTAN/SINOVAC,1738,872,866
Baldim,310500,MG,Sudeste,PFIZER/BIONTECH,103,103,0
Baliza,520310,GO,Centro-Oeste,FIOCRUZ/ASTRAZENECA,1013,974,39
Baliza,520310,GO,Centro-Oeste,BUTANTAN/SINOVAC,685,364,321
Balneário Arroio Do Silva,420195,SC,Sul,FIOCRUZ/ASTRAZENECA,3515,3230,285
Balneário Arroio Do Silva,420195,SC,Sul,BUTANTAN/SINOVAC,3249,1631,1618
Balneário Arroio Do Silva,420195,SC,Sul,PFIZER/BIONTECH,52,52,0
Balneário Barra Do Sul,420205,SC,Sul,FIOCRUZ/ASTRAZENECA,4220,3761,459
Balneário Barra Do Sul,420205,SC,Sul,BUTANTAN/SINOVAC,2971,1557,1414
Balneário Barra Do Sul,420205,SC,Sul,PFIZER/BIONTECH,355,355,0
Balneário Camboriú,420200,SC,Sul,BUTANTAN/SINOVAC,38360,19654,18706
Balneário Camboriú,420200,SC,Sul,FIOCRUZ/ASTRAZENECA,24795,23540,1255
Balneário Camboriú,420200,SC,Sul,PFIZER/BIONTECH,8633,8632,1
Balneário Gaivota,420207,SC,Sul,FIOCRUZ/ASTRAZENECA,3189,3069,120
Balneário Gaivota,420207,SC,Sul,BUTANTAN/SINOVAC,2658,1398,1260
Balneário Gaivota,420207,SC,Sul,PFIZER/BIONTECH,92,92,0
Balneário Piçarras,421280,SC,Sul,BUTANTAN/SINOVAC,5949,3131,2818
Balneário Piçarras,421280,SC,Sul,FIOCRUZ/ASTRAZENECA,5570,5425,145
Balneário Piçarras,421280,SC,Sul,PFIZER/BIONTECH,580,580,0
Balneário Pinhal,430163,RS,Sul,BUTANTAN/SINOVAC,5145,2722,2423
Balneário Pinhal,430163,RS,Sul,FIOCRUZ/ASTRAZENECA,3900,3585,315
Balneário Pinhal,430163,RS,Sul,PFIZER/BIONTECH,350,350,0
Balneário Rincão,422000,SC,Sul,FIOCRUZ/ASTRAZENECA,3994,3893,101
Balneário Rincão,422000,SC,Sul,BUTANTAN/SINOVAC,2786,1436,1350
Balneário Rincão,422000,SC,Sul,PFIZER/BIONTECH,159,159,0
Balsa Nova,410230,PR,Sul,FIOCRUZ/ASTRAZENECA,2784,2695,89
Balsa Nova,410230,PR,Sul,BUTANTAN/SINOVAC,2265,1181,1084
Balsa Nova,410230,PR,Sul,PFIZER/BIONTECH,156,156,0
Bálsamo,350480,SP,Sudeste,BUTANTAN/SINOVAC,2774,1514,1260
Bálsamo,350480,SP,Sudeste,FIOCRUZ/ASTRAZENECA,2218,1950,268
Bálsamo,350480,SP,Sudeste,PFIZER/BIONTECH,309,309,0
Balsas,210140,MA,Nordeste,PFIZER/BIONTECH,13575,13572,3
Balsas,210140,MA,Nordeste,FIOCRUZ/ASTRAZENECA,12329,11137,1192
Balsas,210140,MA,Nordeste,BUTANTAN/SINOVAC,10678,5478,5200
Bambuí,310510,MG,Sudeste,BUTANTAN/SINOVAC,5487,2900,2587
Bambuí,310510,MG,Sudeste,FIOCRUZ/ASTRAZENECA,3076,3004,72
Bambuí,310510,MG,Sudeste,PFIZER/BIONTECH,9,9,0
Banabuiú,230185,CE,Nordeste,BUTANTAN/SINOVAC,3136,1590,1546
Banabuiú,230185,CE,Nordeste,FIOCRUZ/ASTRAZENECA,1262,991,271
Bananal,350490,SP,Sudeste,BUTANTAN/SINOVAC,3175,1802,1373
Bananal,350490,SP,Sudeste,FIOCRUZ/ASTRAZENECA,1990,1720,270
Bananal,350490,SP,Sudeste,PFIZER/BIONTECH,211,211,0
Bananeiras,250150,PB,Nordeste,BUTANTAN/SINOVAC,4924,2591,2333
Bananeiras,250150,PB,Nordeste,FIOCRUZ/ASTRAZENECA,3424,3155,269
Bananeiras,250150,PB,Nordeste,PFIZER/BIONTECH,471,471,0
Bandeira,310520,MG,Sudeste,BUTANTAN/SINOVAC,1279,657,622
Bandeira,310520,MG,Sudeste,FIOCRUZ/ASTRAZENECA,891,807,84
Bandeira,310520,MG,Sudeste,PFIZER/BIONTECH,27,27,0
Bandeira Do Sul,310530,MG,Sudeste,FIOCRUZ/ASTRAZENECA,1311,1221,90
Bandeira Do Sul,310530,MG,Sudeste,BUTANTAN/SINOVAC,1123,574,549
Bandeira Do Sul,310530,MG,Sudeste,PFIZER/BIONTECH,182,182,0
Bandeirante,420208,SC,Sul,BUTANTAN/SINOVAC,863,452,411
Bandeirante,420208,SC,Sul,FIOCRUZ/ASTRAZENECA,803,719,84
Bandeirante,420208,SC,Sul,PFIZER/BIONTECH,68,68,0
Bandeirantes,410240,PR,Sul,FIOCRUZ/ASTRAZENECA,7847,7328,519
Bandeirantes,410240,PR,Sul,BUTANTAN/SINOVAC,7511,3840,3671
Bandeirantes,410240,PR,Sul,PFIZER/BIONTECH,1768,1768,0
Bandeirantes,500150,MS,Centro-Oeste,FIOCRUZ/ASTRAZENECA,1797,1550,247
Bandeirantes,500150,MS,Centro-Oeste,BUTANTAN/SINOVAC,1665,869,796
Bandeirantes,500150,MS,Centro-Oeste,PFIZER/BIONTECH,238,238,0
Bandeirantes Do Tocantins,170305,TO,Norte,BUTANTAN/SINOVAC,566,287,279
Bandeirantes Do Tocantins,170305,TO,Norte,FIOCRUZ/ASTRAZENECA,508,488,20
Bannach,150125,PA,Norte,FIOCRUZ/ASTRAZENECA,698,530,168
Bannach,150125,PA,Norte,BUTANTAN/SINOVAC,607,366,241
Banzaê,290265,BA,Nordeste,BUTANTAN/SINOVAC,5406,2751,2655
Banzaê,290265,BA,Nordeste,FIOCRUZ/ASTRAZENECA,3378,3032,346
Banzaê,290265,BA,Nordeste,PFIZER/BIONTECH,214,214,0
Barão,430165,RS,Sul,BUTANTAN/SINOVAC,1703,860,843
Barão,430165,RS,Sul,FIOCRUZ/ASTRAZENECA,1309,1194,115
Barão,430165,RS,Sul,PFIZER/BIONTECH,208,208,0
Barão De Antonina,350500,SP,Sudeste,BUTANTAN/SINOVAC,1058,606,452
Barão De Antonina,350500,SP,Sudeste,FIOCRUZ/ASTRAZENECA,984,915,69
Barão De Antonina,350500,SP,Sudeste,PFIZER/BIONTECH,115,115,0
Barão De Cocais,310540,MG,Sudeste,BUTANTAN/SINOVAC,5162,2649,2513
Barão De Cocais,310540,MG,Sudeste,FIOCRUZ/ASTRAZENECA,4779,4388,391
Barão De Cocais,310540,MG,Sudeste,PFIZER/BIONTECH,502,486,16
Barão De Cotegipe,430170,RS,Sul,BUTANTAN/SINOVAC,2256,1131,1125
Barão De Cotegipe,430170,RS,Sul,FIOCRUZ/ASTRAZENECA,1706,1475,231
Barão De Cotegipe,430170,RS,Sul,PFIZER/BIONTECH,270,270,0
Barão De Grajaú,210150,MA,Nordeste,FIOCRUZ/ASTRAZENECA,3570,3347,223
Barão De Grajaú,210150,MA,Nordeste,BUTANTAN/SINOVAC,3003,1634,1369
Barão De Melgaço,510160,MT,Centro-Oeste,BUTANTAN/SINOVAC,1926,1032,894
Barão De Melgaço,510160,MT,Centro-Oeste,FIOCRUZ/ASTRAZENECA,1346,1288,58
Barão De Melgaço,510160,MT,Centro-Oeste,PFIZER/BIONTECH,9,9,0
Barão De Monte Alto,310550,MG,Sudeste,BUTANTAN/SINOVAC,1812,923,889
Barão De Monte Alto,310550,MG,Sudeste,FIOCRUZ/ASTRAZENECA,1441,1289,152
Barão De Monte Alto,310550,MG,Sudeste,PFIZER/BIONTECH,39,39,0
Barão Do Triunfo,430175,RS,Sul,FIOCRUZ/ASTRAZENECA,1579,1497,82
Barão Do Triunfo,430175,RS,Sul,BUTANTAN/SINOVAC,1477,733,744
Barão Do Triunfo,430175,RS,Sul,PFIZER/BIONTECH,203,203,0
Baraúna,240145,RN,Nordeste,FIOCRUZ/ASTRAZENECA,4299,4021,278
Baraúna,240145,RN,Nordeste,BUTANTAN/SINOVAC,4015,1997,2018
Baraúna,240145,RN,Nordeste,PFIZER/BIONTECH,316,316,0
Baraúna,250153,PB,Nordeste,BUTANTAN/SINOVAC,1201,605,596
Baraúna,250153,PB,Nordeste,FIOCRUZ/ASTRAZENECA,739,652,87
Baraúna,250153,PB,Nordeste,PFIZER/BIONTECH,18,18,0
Barbacena,310560,MG,Sudeste,BUTANTAN/SINOVAC,33761,17136,16625
Barbacena,310560,MG,Sudeste,FIOCRUZ/ASTRAZENECA,24200,19404,4796
Barbacena,310560,MG,Sudeste,PFIZER/BIONTECH,3505,3499,6
Barbalha,230190,CE,Nordeste,BUTANTAN/SINOVAC,11599,6322,5277
Barbalha,230190,CE,Nordeste,FIOCRUZ/ASTRAZENECA,2846,2458,388
Barbosa,350510,SP,Sudeste,BUTANTAN/SINOVAC,1615,914,701
Barbosa,350510,SP,Sudeste,FIOCRUZ/ASTRAZENECA,1490,1373,117
Barbosa,350510,SP,Sudeste,PFIZER/BIONTECH,178,178,0
Barbosa Ferraz,410250,PR,Sul,FIOCRUZ/ASTRAZENECA,3513,3306,207
Barbosa Ferraz,410250,PR,Sul,BUTANTAN/SINOVAC,3107,1585,1522
Barbosa Ferraz,410250,PR,Sul,PFIZER/BIONTECH,84,84,0
Barcarena,150130,PA,Norte,FIOCRUZ/ASTRAZENECA,20561,18371,2190
Barcarena,150130,PA,Norte,BUTANTAN/SINOVAC,12071,6260,5811
Barcelona,240150,RN,Nordeste,BUTANTAN/SINOVAC,1025,519,506
Barcelona,240150,RN,Nordeste,FIOCRUZ/ASTRAZENECA,851,783,68
Barcelona,240150,RN,Nordeste,PFIZER/BIONTECH,131,131,0
Barcelos,130040,AM,Norte,BUTANTAN/SINOVAC,7501,4602,2899
Barcelos,130040,AM,Norte,FIOCRUZ/ASTRAZENECA,2302,1924,378
Bariri,350520,SP,Sudeste,BUTANTAN/SINOVAC,8923,4748,4175
Bariri,350520,SP,Sudeste,FIOCRUZ/ASTRAZENECA,8484,7564,920
Bariri,350520,SP,Sudeste,PFIZER/BIONTECH,745,745,0
Barra,290270,BA,Nordeste,FIOCRUZ/ASTRAZENECA,9268,8272,996
Barra,290270,BA,Nordeste,BUTANTAN/SINOVAC,6901,3710,3191
Barra,290270,BA,Nordeste,PFIZER/BIONTECH,343,343,0
Barra Bonita,350530,SP,Sudeste,FIOCRUZ/ASTRAZENECA,9743,9003,740
Barra Bonita,350530,SP,Sudeste,BUTANTAN/SINOVAC,9609,5326,4283
Barra Bonita,350530,SP,Sudeste,PFIZER/BIONTECH,970,970,0
Barra Bonita,420209,SC,Sul,FIOCRUZ/ASTRAZENECA,620,561,59
Barra Bonita,420209,SC,Sul,BUTANTAN/SINOVAC,562,293,269
Barra D'Alcântara,220117,PI,Nordeste,FIOCRUZ/ASTRAZENECA,815,757,58
Barra D'Alcântara,220117,PI,Nordeste,BUTANTAN/SINOVAC,799,412,387
Barra D'Alcântara,220117,PI,Nordeste,PFIZER/BIONTECH,96,96,0
Barra Da Estiva,290280,BA,Nordeste,FIOCRUZ/ASTRAZENECA,3840,3608,232
Barra Da Estiva,290280,BA,Nordeste,BUTANTAN/SINOVAC,3306,1743,1563
Barra Da Estiva,290280,BA,Nordeste,PFIZER/BIONTECH,337,337,0
Barra De Guabiraba,260130,PE,Nordeste,BUTANTAN/SINOVAC,1873,956,917
Barra De Guabiraba,260130,PE,Nordeste,FIOCRUZ/ASTRAZENECA,1796,1716,80
Barra De Guabiraba,260130,PE,Nordeste,PFIZER/BIONTECH,243,243,0
Barra De Santa Rosa,250160,PB,Nordeste,BUTANTAN/SINOVAC,3437,1878,1559
Barra De Santa Rosa,250160,PB,Nordeste,FIOCRUZ/ASTRAZENECA,2514,2264,250
Barra De Santa Rosa,250160,PB,Nordeste,PFIZER/BIONTECH,84,84,0
Barra De Santana,250157,PB,Nordeste,BUTANTAN/SINOVAC,2330,1172,1158
Barra De Santana,250157,PB,Nordeste,FIOCRUZ/ASTRAZENECA,1714,1540,174
Barra De Santana,250157,PB,Nordeste,PFIZER/BIONTECH,87,87,0
Barra De Santo Antônio,270050,AL,Nordeste,FIOCRUZ/ASTRAZENECA,2138,1938,200
Barra De Santo Antônio,270050,AL,Nordeste,BUTANTAN/SINOVAC,1987,1037,950
Barra De São Francisco,320090,ES,Sudeste,FIOCRUZ/ASTRAZENECA,12609,12196,413
Barra De São Francisco,320090,ES,Sudeste,BUTANTAN/SINOVAC,10847,5877,4970
Barra De São Francisco,320090,ES,Sudeste,PFIZER/BIONTECH,971,971,0
Barra De São Miguel,250170,PB,Nordeste,BUTANTAN/SINOVAC,1518,777,741
Barra De São Miguel,250170,PB,Nordeste,FIOCRUZ/ASTRAZENECA,1016,948,68
Barra De São Miguel,250170,PB,Nordeste,PFIZER/BIONTECH,76,76,0
Barra De São Miguel,270060,AL,Nordeste,FIOCRUZ/ASTRAZENECA,1196,1084,112
Barra De São Miguel,270060,AL,Nordeste,BUTANTAN/SINOVAC,1019,548,471
Barra Do Bugres,510170,MT,Centro-Oeste,FIOCRUZ/ASTRAZENECA,4259,4000,259
Barra Do Bugres,510170,MT,Centro-Oeste,BUTANTAN/SINOVAC,3304,1739,1565
Barra Do Bugres,510170,MT,Centro-Oeste,PFIZER/BIONTECH,419,419,0
Barra Do Chapéu,350535,SP,Sudeste,FIOCRUZ/ASTRAZENECA,1173,1093,80
Barra Do Chapéu,350535,SP,Sudeste,BUTANTAN/SINOVAC,960,555,405
Barra Do Chapéu,350535,SP,Sudeste,PFIZER/BIONTECH,203,203,0
Barra Do Choça,290290,BA,Nordeste,BUTANTAN/SINOVAC,802,489,313
Barra Do Choça,290290,BA,Nordeste,FIOCRUZ/ASTRAZENECA,549,537,12
Barra Do Choça,290290,BA,Nordeste,PFIZER/BIONTECH,12,12,0
Barra Do Corda,210160,MA,Nordeste,BUTANTAN/SINOVAC,22637,12159,10478
Barra Do Corda,210160,MA,Nordeste,FIOCRUZ/ASTRAZENECA,13631,12806,825
Barra Do Corda,210160,MA,Nordeste,PFIZER/BIONTECH,762,762,0
Barra Do Garças,510180,MT,Centro-Oeste,BUTANTAN/SINOVAC,14827,7670,7157
Barra Do Garças,510180,MT,Centro-Oeste,FIOCRUZ/ASTRAZENECA,12569,11843,726
Barra Do Garças,510180,MT,Centro-Oeste,PFIZER/BIONTECH,490,489,1
Barra Do Guarita,430185,RS,Sul,BUTANTAN/SINOVAC,806,406,400
Barra Do Guarita,430185,RS,Sul,FIOCRUZ/ASTRAZENECA,715,652,63
Barra Do Guarita,430185,RS,Sul,PFIZER/BIONTECH,131,131,0
Barra Do Jacaré,410270,PR,Sul,FIOCRUZ/ASTRAZENECA,1006,975,31
Barra Do Jacaré,410270,PR,Sul,BUTANTAN/SINOVAC,867,472,395
Barra Do Mendes,290300,BA,Nordeste,FIOCRUZ/ASTRAZENECA,4313,3618,695
Barra Do Mendes,290300,BA,Nordeste,BUTANTAN/SINOVAC,3345,1723,1622
Barra Do Mendes,290300,BA,Nordeste,PFIZER/BIONTECH,169,160,9
Barra Do Ouro,170307,TO,Norte,BUTANTAN/SINOVAC,707,368,339
Barra Do Ouro,170307,TO,Norte,FIOCRUZ/ASTRAZENECA,471,442,29
Barra Do Piraí,330030,RJ,Sudeste,BUTANTAN/SINOVAC,17573,9997,7576
Barra Do Piraí,330030,RJ,Sudeste,FIOCRUZ/ASTRAZENECA,12030,11486,544
Barra Do Piraí,330030,RJ,Sudeste,PFIZER/BIONTECH,465,465,0
Barra Do Quaraí,430187,RS,Sul,FIOCRUZ/ASTRAZENECA,922,842,80
Barra Do Quaraí,430187,RS,Sul,BUTANTAN/SINOVAC,857,445,412
Barra Do Quaraí,430187,RS,Sul,PFIZER/BIONTECH,138,138,0
Barra Do Ribeiro,430190,RS,Sul,BUTANTAN/SINOVAC,8730,4508,4222
Barra Do Ribeiro,430190,RS,Sul,FIOCRUZ/ASTRAZENECA,3557,3225,332
Barra Do Ribeiro,430190,RS,Sul,PFIZER/BIONTECH,419,419,0
Barra Do Rio Azul,430192,RS,Sul,BUTANTAN/SINOVAC,1354,678,676
Barra Do Rio Azul,430192,RS,Sul,FIOCRUZ/ASTRAZENECA,899,779,120
Barra Do Rio Azul,430192,RS,Sul,PFIZER/BIONTECH,95,95,0
Barra Do Rocha,290310,BA,Nordeste,FIOCRUZ/ASTRAZENECA,944,896,48
Barra Do Rocha,290310,BA,Nordeste,BUTANTAN/SINOVAC,893,481,412
Barra Do Rocha,290310,BA,Nordeste,PFIZER/BIONTECH,22,22,0
Barra Do Turvo,350540,SP,Sudeste,BUTANTAN/SINOVAC,2758,1442,1316
Barra Do Turvo,350540,SP,Sudeste,FIOCRUZ/ASTRAZENECA,1007,908,99
Barra Do Turvo,350540,SP,Sudeste,PFIZER/BIONTECH,35,35,0
Barra Dos Coqueiros,280060,SE,Nordeste,FIOCRUZ/ASTRAZENECA,6392,5986,406
Barra Dos Coqueiros,280060,SE,Nordeste,BUTANTAN/SINOVAC,5121,2703,2418
Barra Dos Coqueiros,280060,SE,Nordeste,PFIZER/BIONTECH,694,694,0
Barra Funda,430195,RS,Sul,BUTANTAN/SINOVAC,785,395,390
Barra Funda,430195,RS,Sul,FIOCRUZ/ASTRAZENECA,678,609,69
Barra Funda,430195,RS,Sul,PFIZER/BIONTECH,108,108,0
Barra Longa,310570,MG,Sudeste,BUTANTAN/SINOVAC,1726,865,861
Barra Longa,310570,MG,Sudeste,FIOCRUZ/ASTRAZENECA,1560,1418,142
Barra Longa,310570,MG,Sudeste,PFIZER/BIONTECH,63,63,0
Barra Mansa,330040,RJ,Sudeste,BUTANTAN/SINOVAC,43409,22591,20818
Barra Mansa,330040,RJ,Sudeste,FIOCRUZ/ASTRAZENECA,28784,27185,1599
Barra Mansa,330040,RJ,Sudeste,PFIZER/BIONTECH,1682,1680,2
Barra Velha,420210,SC,Sul,FIOCRUZ/ASTRAZENECA,8392,7640,752
Barra Velha,420210,SC,Sul,BUTANTAN/SINOVAC,4789,2537,2252
Barra Velha,420210,SC,Sul,PFIZER/BIONTECH,596,596,0
Barracão,410260,PR,Sul,FIOCRUZ/ASTRAZENECA,2996,2877,119
Barracão,410260,PR,Sul,BUTANTAN/SINOVAC,2153,1102,1051
Barracão,410260,PR,Sul,PFIZER/BIONTECH,370,370,0
Barracão,430180,RS,Sul,FIOCRUZ/ASTRAZENECA,1685,1467,218
Barracão,430180,RS,Sul,BUTANTAN/SINOVAC,1393,712,681
Barracão,430180,RS,Sul,PFIZER/BIONTECH,222,222,0
Barras,220120,PI,Nordeste,FIOCRUZ/ASTRAZENECA,6945,6294,651
Barras,220120,PI,Nordeste,BUTANTAN/SINOVAC,6802,3787,3015
Barras,220120,PI,Nordeste,PFIZER/BIONTECH,306,306,0
Barreira,230195,CE,Nordeste,BUTANTAN/SINOVAC,3538,1815,1723
Barreira,230195,CE,Nordeste,FIOCRUZ/ASTRAZENECA,1393,1156,237
Barreiras,290320,BA,Nordeste,BUTANTAN/SINOVAC,17327,9460,7867
Barreiras,290320,BA,Nordeste,FIOCRUZ/ASTRAZENECA,15479,13803,1676
Barreiras,290320,BA,Nordeste,PFIZER/BIONTECH,90,90,0
Barreiras Do Piauí,220130,PI,Nordeste,BUTANTAN/SINOVAC,510,264,246
Barreiras Do Piauí,220130,PI,Nordeste,FIOCRUZ/ASTRAZENECA,452,433,19
Barreirinha,130050,AM,Norte,FIOCRUZ/ASTRAZENECA,9758,9519,239
Barreirinha,130050,AM,Norte,BUTANTAN/SINOVAC,6151,3518,2633
Barreirinhas,210170,MA,Nordeste,FIOCRUZ/ASTRAZENECA,14464,13896,568
Barreirinhas,210170,MA,Nordeste,BUTANTAN/SINOVAC,5260,2892,2368
Barreiros,260140,PE,Nordeste,FIOCRUZ/ASTRAZENECA,4816,4483,333
Barreiros,260140,PE,Nordeste,BUTANTAN/SINOVAC,4787,2509,2278
Barreiros,260140,PE,Nordeste,PFIZER/BIONTECH,242,242,0
Barretos,350550,SP,Sudeste,BUTANTAN/SINOVAC,35449,19168,16281
Barretos,350550,SP,Sudeste,FIOCRUZ/ASTRAZENECA,33189,30593,2596
Barretos,350550,SP,Sudeste,PFIZER/BIONTECH,2431,2431,0
Barrinha,350560,SP,Sudeste,FIOCRUZ/ASTRAZENECA,5499,5220,279
Barrinha,350560,SP,Sudeste,BUTANTAN/SINOVAC,4612,2666,1946
Barrinha,350560,SP,Sudeste,PFIZER/BIONTECH,626,626,0
Barro,230200,CE,Nordeste,BUTANTAN/SINOVAC,4419,2379,2040
Barro,230200,CE,Nordeste,FIOCRUZ/ASTRAZENECA,3827,3371,456
Barro Alto,290323,BA,Nordeste,FIOCRUZ/ASTRAZENECA,5156,4695,461
Barro Alto,290323,BA,Nordeste,BUTANTAN/SINOVAC,2775,1444,1331
Barro Alto,290323,BA,Nordeste,PFIZER/BIONTECH,107,107,0
Barro Alto,520320,GO,Centro-Oeste,FIOCRUZ/ASTRAZENECA,2127,1999,128
Barro Alto,520320,GO,Centro-Oeste,BUTANTAN/SINOVAC,1102,563,539
Barro Duro,220140,PI,Nordeste,BUTANTAN/SINOVAC,1347,759,588
Barro Duro,220140,PI,Nordeste,FIOCRUZ/ASTRAZENECA,1274,1192,82
Barro Preto,290330,BA,Nordeste,BUTANTAN/SINOVAC,2239,1241,998
Barro Preto,290330,BA,Nordeste,FIOCRUZ/ASTRAZENECA,1742,1680,62
Barro Preto,290330,BA,Nordeste,PFIZER/BIONTECH,75,75,0
Barrocas,290327,BA,Nordeste,BUTANTAN/SINOVAC,3063,1699,1364
Barrocas,290327,BA,Nordeste,FIOCRUZ/ASTRAZENECA,2667,2305,362
Barrocas,290327,BA,Nordeste,PFIZER/BIONTECH,402,401,1
Barrolândia,170310,TO,Norte,FIOCRUZ/ASTRAZENECA,1096,1060,36
Barrolândia,170310,TO,Norte,BUTANTAN/SINOVAC,1075,546,529
Barroquinha,230205,CE,Nordeste,BUTANTAN/SINOVAC,1780,1076,704
Barroquinha,230205,CE,Nordeste,FIOCRUZ/ASTRAZENECA,688,579,109
Barros Cassal,430200,RS,Sul,FIOCRUZ/ASTRAZENECA,3103,2965,138
Barros Cassal,430200,RS,Sul,BUTANTAN/SINOVAC,2344,1194,1150
Barros Cassal,430200,RS,Sul,PFIZER/BIONTECH,130,130,0
Barroso,310590,MG,Sudeste,BUTANTAN/SINOVAC,4478,2337,2141
Barroso,310590,MG,Sudeste,FIOCRUZ/ASTRAZENECA,4172,3842,330
Barueri,350570,SP,Sudeste,FIOCRUZ/ASTRAZENECA,57638,53956,3682
Barueri,350570,SP,Sudeste,BUTANTAN/SINOVAC,50996,29625,21371
Barueri,350570,SP,Sudeste,PFIZER/BIONTECH,2516,2516,0
Bastos,350580,SP,Sudeste,FIOCRUZ/ASTRAZENECA,5770,5333,437
Bastos,350580,SP,Sudeste,BUTANTAN/SINOVAC,5742,3287,2455
Bastos,350580,SP,Sudeste,PFIZER/BIONTECH,760,759,1
Bataguassu,500190,MS,Centro-Oeste,FIOCRUZ/ASTRAZENECA,4479,3908,571
Bataguassu,500190,MS,Centro-Oeste,BUTANTAN/SINOVAC,3671,1968,1703
Bataguassu,500190,MS,Centro-Oeste,PFIZER/BIONTECH,654,654,0
Batalha,220150,PI,Nordeste,BUTANTAN/SINOVAC,3172,1747,1425
Batalha,220150,PI,Nordeste,FIOCRUZ/ASTRAZENECA,2858,2666,192
Batalha,270070,AL,Nordeste,FIOCRUZ/ASTRAZENECA,4202,3917,285
Batalha,270070,AL,Nordeste,BUTANTAN/SINOVAC,3017,1552,1465
Batatais,350590,SP,Sudeste,FIOCRUZ/ASTRAZENECA,15978,14762,1216
Batatais,350590,SP,Sudeste,BUTANTAN/SINOVAC,14559,7630,6929
Batatais,350590,SP,Sudeste,PFIZER/BIONTECH,633,633,0
Batayporã,500200,MS,Centro-Oeste,FIOCRUZ/ASTRAZENECA,3169,2807,362
Batayporã,500200,MS,Centro-Oeste,BUTANTAN/SINOVAC,2614,1362,1252
Batayporã,500200,MS,Centro-Oeste,PFIZER/BIONTECH,399,399,0
Baturité,230210,CE,Nordeste,BUTANTAN/SINOVAC,5100,2796,2304
Baturité,230210,CE,Nordeste,FIOCRUZ/ASTRAZENECA,3223,2766,457
Baturité,230210,CE,Nordeste,PFIZER/BIONTECH,45,45,0
Bauru,350600,SP,Sudeste,BUTANTAN/SINOVAC,100573,55280,45293
Bauru,350600,SP,Sudeste,FIOCRUZ/ASTRAZENECA,98958,88805,10153
Bauru,350600,SP,Sudeste,PFIZER/BIONTECH,8933,8925,8
Bayeux,250180,PB,Nordeste,BUTANTAN/SINOVAC,18356,9365,8991
Bayeux,250180,PB,Nordeste,FIOCRUZ/ASTRAZENECA,13734,12684,1050
Bayeux,250180,PB,Nordeste,PFIZER/BIONTECH,1733,1729,4
Bebedouro,350610,SP,Sudeste,BUTANTAN/SINOVAC,20888,11942,8946
Bebedouro,350610,SP,Sudeste,FIOCRUZ/ASTRAZENECA,18278,16264,2014
Bebedouro,350610,SP,Sudeste,PFIZER/BIONTECH,1062,1057,5
Beberibe,230220,CE,Nordeste,BUTANTAN/SINOVAC,8902,4510,4392
Beberibe,230220,CE,Nordeste,FIOCRUZ/ASTRAZENECA,4963,4237,726
Bela Cruz,230230,CE,Nordeste,BUTANTAN/SINOVAC,5569,2844,2725
Bela Cruz,230230,CE,Nordeste,FIOCRUZ/ASTRAZENECA,4114,3597,517
Bela Vista,500210,MS,Centro-Oeste,BUTANTAN/SINOVAC,6156,3174,2982
Bela Vista,500210,MS,Centro-Oeste,FIOCRUZ/ASTRAZENECA,6011,5558,453
Bela Vista,500210,MS,Centro-Oeste,PFIZER/BIONTECH,596,596,0
Bela Vista Da Caroba,410275,PR,Sul,FIOCRUZ/ASTRAZENECA,1407,1364,43
Bela Vista Da Caroba,410275,PR,Sul,BUTANTAN/SINOVAC,978,501,477
Bela Vista De Goiás,520330,GO,Centro-Oeste,FIOCRUZ/ASTRAZENECA,6676,6314,362
Bela Vista De Goiás,520330,GO,Centro-Oeste,BUTANTAN/SINOVAC,4919,2599,2320
Bela Vista De Minas,310600,MG,Sudeste,BUTANTAN/SINOVAC,1418,823,595
Bela Vista De Minas,310600,MG,Sudeste,FIOCRUZ/ASTRAZENECA,1248,1229,19
Bela Vista De Minas,310600,MG,Sudeste,PFIZER/BIONTECH,108,108,0
Bela Vista Do Maranhão,210177,MA,Nordeste,FIOCRUZ/ASTRAZENECA,2080,1971,109
Bela Vista Do Maranhão,210177,MA,Nordeste,BUTANTAN/SINOVAC,2079,1234,845
Bela Vista Do Paraíso,410280,PR,Sul,FIOCRUZ/ASTRAZENECA,4732,4463,269
Bela Vista Do Paraíso,410280,PR,Sul,BUTANTAN/SINOVAC,3191,1575,1616
Bela Vista Do Paraíso,410280,PR,Sul,PFIZER/BIONTECH,40,40,0
Bela Vista Do Piauí,220155,PI,Nordeste,FIOCRUZ/ASTRAZENECA,865,814,51
Bela Vista Do Piauí,220155,PI,Nordeste,BUTANTAN/SINOVAC,579,301,278
Bela Vista Do Piauí,220155,PI,Nordeste,PFIZER/BIONTECH,75,75,0
Bela Vista Do Toldo,420213,SC,Sul,FIOCRUZ/ASTRAZENECA,1245,1214,31
Bela Vista Do Toldo,420213,SC,Sul,BUTANTAN/SINOVAC,989,517,472
Bela Vista Do Toldo,420213,SC,Sul,PFIZER/BIONTECH,88,88,0
Belágua,210173,MA,Nordeste,FIOCRUZ/ASTRAZENECA,1854,1719,135
Belágua,210173,MA,Nordeste,BUTANTAN/SINOVAC,1130,614,516
Belém,150140,PA,Norte,BUTANTAN/SINOVAC,404862,212957,191905
Belém,150140,PA,Norte,FIOCRUZ/ASTRAZENECA,221422,172626,48796
Belém,150140,PA,Norte,PFIZER/BIONTECH,164277,163823,454
Belém,250190,PB,Nordeste,BUTANTAN/SINOVAC,5233,2735,2498
Belém,250190,PB,Nordeste,FIOCRUZ/ASTRAZENECA,2379,2072,307
Belém,250190,PB,Nordeste,PFIZER/BIONTECH,45,45,0
Belém,270080,AL,Nordeste,FIOCRUZ/ASTRAZENECA,1148,1002,146
Belém,270080,AL,Nordeste,BUTANTAN/SINOVAC,1038,556,482
Belém De Maria,260150,PE,Nordeste,FIOCRUZ/ASTRAZENECA,1843,1705,138
Belém De Maria,260150,PE,Nordeste,BUTANTAN/SINOVAC,1644,934,710
Belém De Maria,260150,PE,Nordeste,PFIZER/BIONTECH,112,112,0
Belém Do Brejo Do Cruz,250200,PB,Nordeste,FIOCRUZ/ASTRAZENECA,2028,1893,135
Belém Do Brejo Do Cruz,250200,PB,Nordeste,BUTANTAN/SINOVAC,1609,838,771
Belém Do Brejo Do Cruz,250200,PB,Nordeste,PFIZER/BIONTECH,111,111,0
Belém Do Piauí,220157,PI,Nordeste,BUTANTAN/SINOVAC,818,419,399
Belém Do Piauí,220157,PI,Nordeste,FIOCRUZ/ASTRAZENECA,665,605,60
Belém Do São Francisco,260160,PE,Nordeste,FIOCRUZ/ASTRAZENECA,4857,4534,323
Belém Do São Francisco,260160,PE,Nordeste,BUTANTAN/SINOVAC,4494,2421,2073
Belém Do São Francisco,260160,PE,Nordeste,PFIZER/BIONTECH,432,432,0
Belford Roxo,330045,RJ,Sudeste,BUTANTAN/SINOVAC,58312,31072,27240
Belford Roxo,330045,RJ,Sudeste,FIOCRUZ/ASTRAZENECA,54821,50681,4140
Belford Roxo,330045,RJ,Sudeste,PFIZER/BIONTECH,2413,2412,1
Belmiro Braga,310610,MG,Sudeste,BUTANTAN/SINOVAC,526,376,150
Belmiro Braga,310610,MG,Sudeste,FIOCRUZ/ASTRAZENECA,368,356,12
Belmiro Braga,310610,MG,Sudeste,PFIZER/BIONTECH,43,43,0
Belmonte,290340,BA,Nordeste,BUTANTAN/SINOVAC,2470,1725,745
Belmonte,290340,BA,Nordeste,FIOCRUZ/ASTRAZENECA,903,828,75
Belmonte,420215,SC,Sul,BUTANTAN/SINOVAC,1419,874,545
Belmonte,420215,SC,Sul,FIOCRUZ/ASTRAZENECA,784,709,75
Belo Campo,290350,BA,Nordeste,BUTANTAN/SINOVAC,3663,1929,1734
Belo Campo,290350,BA,Nordeste,FIOCRUZ/ASTRAZENECA,3212,2704,508
Belo Campo,290350,BA,Nordeste,PFIZER/BIONTECH,11,11,0
Belo Horizonte,310620,MG,Sudeste,BUTANTAN/SINOVAC,731761,373660,358101
Belo Horizonte,310620,MG,Sudeste,FIOCRUZ/ASTRAZENECA,551162,487927,63235
Belo Horizonte,310620,MG,Sudeste,PFIZER/BIONTECH,153756,153473,283
Belo Jardim,260170,PE,Nordeste,BUTANTAN/SINOVAC,9677,5276,4401
Belo Jardim,260170,PE,Nordeste,FIOCRUZ/ASTRAZENECA,9401,8707,694
Belo Jardim,260170,PE,Nordeste,PFIZER/BIONTECH,2031,2027,4
Belo Monte,270090,AL,Nordeste,FIOCRUZ/ASTRAZENECA,1303,1175,128
Belo Monte,270090,AL,Nordeste,BUTANTAN/SINOVAC,1192,661,531
Belo Oriente,310630,MG,Sudeste,FIOCRUZ/ASTRAZENECA,4183,3878,305
Belo Oriente,310630,MG,Sudeste,BUTANTAN/SINOVAC,3861,1955,1906
Belo Oriente,310630,MG,Sudeste,PFIZER/BIONTECH,468,468,0
Belo Vale,310640,MG,Sudeste,FIOCRUZ/ASTRAZENECA,2679,2455,224
Belo Vale,310640,MG,Sudeste,BUTANTAN/SINOVAC,1993,1002,991
Belo Vale,310640,MG,Sudeste,PFIZER/BIONTECH,69,69,0
Belterra,150145,PA,Norte,FIOCRUZ/ASTRAZENECA,5497,4028,1469
Belterra,150145,PA,Norte,BUTANTAN/SINOVAC,1388,707,681
Beneditinos,220160,PI,Nordeste,BUTANTAN/SINOVAC,1917,1009,908
Beneditinos,220160,PI,Nordeste,FIOCRUZ/ASTRAZENECA,969,927,42
Benedito Leite,210180,MA,Nordeste,FIOCRUZ/ASTRAZENECA,1290,1124,166
Benedito Leite,210180,MA,Nordeste,BUTANTAN/SINOVAC,1021,521,500
Benedito Novo,420220,SC,Sul,BUTANTAN/SINOVAC,1825,860,965
Benedito Novo,420220,SC,Sul,FIOCRUZ/ASTRAZENECA,1417,1371,46
Benevides,150150,PA,Norte,BUTANTAN/SINOVAC,10908,6324,4584
Benevides,150150,PA,Norte,FIOCRUZ/ASTRAZENECA,8057,8016,41
Benevides,150150,PA,Norte,PFIZER/BIONTECH,1249,1249,0
Benjamin Constant,130060,AM,Norte,BUTANTAN/SINOVAC,12295,7223,5072
Benjamin Constant,130060,AM,Norte,FIOCRUZ/ASTRAZENECA,1753,1735,18
Benjamin Constant,130060,AM,Norte,PFIZER/BIONTECH,2,2,0
Benjamin Constant Do Sul,430205,RS,Sul,BUTANTAN/SINOVAC,1713,892,821
Benjamin Constant Do Sul,430205,RS,Sul,FIOCRUZ/ASTRAZENECA,370,339,31
Benjamin Constant Do Sul,430205,RS,Sul,PFIZER/BIONTECH,64,64,0
Bento De Abreu,350620,SP,Sudeste,FIOCRUZ/ASTRAZENECA,899,816,83
Bento De Abreu,350620,SP,Sudeste,BUTANTAN/SINOVAC,796,385,411
Bento De Abreu,350620,SP,Sudeste,PFIZER/BIONTECH,70,70,0
Bento Fernandes,240160,RN,Nordeste,BUTANTAN/SINOVAC,1038,559,479
Bento Fernandes,240160,RN,Nordeste,FIOCRUZ/ASTRAZENECA,644,584,60
Bento Fernandes,240160,RN,Nordeste,PFIZER/BIONTECH,65,65,0
Bento Gonçalves,430210,RS,Sul,BUTANTAN/SINOVAC,29427,15284,14143
Bento Gonçalves,430210,RS,Sul,FIOCRUZ/ASTRAZENECA,23084,21451,1633
Bento Gonçalves,430210,RS,Sul,PFIZER/BIONTECH,1447,1447,0
Bequimão,210190,MA,Nordeste,FIOCRUZ/ASTRAZENECA,4579,4389,190
Bequimão,210190,MA,Nordeste,BUTANTAN/SINOVAC,3647,1874,1773
Berilo,310650,MG,Sudeste,FIOCRUZ/ASTRAZENECA,4628,4429,199
Berilo,310650,MG,Sudeste,BUTANTAN/SINOVAC,2105,1058,1047
Berilo,310650,MG,Sudeste,PFIZER/BIONTECH,113,113,0
Berizal,310665,MG,Sudeste,FIOCRUZ/ASTRAZENECA,1597,1506,91
Berizal,310665,MG,Sudeste,BUTANTAN/SINOVAC,935,479,456
Berizal,310665,MG,Sudeste,PFIZER/BIONTECH,53,53,0
Bernardino Batista,250205,PB,Nordeste,BUTANTAN/SINOVAC,908,474,434
Bernardino Batista,250205,PB,Nordeste,FIOCRUZ/ASTRAZENECA,776,704,72
Bernardino Batista,250205,PB,Nordeste,PFIZER/BIONTECH,72,72,0
Bernardino De Campos,350630,SP,Sudeste,BUTANTAN/SINOVAC,6174,3385,2789
Bernardino De Campos,350630,SP,Sudeste,FIOCRUZ/ASTRAZENECA,3944,3551,393
Bernardino De Campos,350630,SP,Sudeste,PFIZER/BIONTECH,300,300,0
Bernardo Do Mearim,210193,MA,Nordeste,FIOCRUZ/ASTRAZENECA,1620,1547,73
Bernardo Do Mearim,210193,MA,Nordeste,BUTANTAN/SINOVAC,1193,661,532
Bernardo Sayão,170320,TO,Norte,FIOCRUZ/ASTRAZENECA,978,904,74
Bernardo Sayão,170320,TO,Norte,BUTANTAN/SINOVAC,834,455,379
Bertioga,350635,SP,Sudeste,FIOCRUZ/ASTRAZENECA,12803,12060,743
Bertioga,350635,SP,Sudeste,BUTANTAN/SINOVAC,10284,6017,4267
Bertioga,350635,SP,Sudeste,PFIZER/BIONTECH,772,772,0
Bertolínia,220170,PI,Nordeste,FIOCRUZ/ASTRAZENECA,1266,1105,161
Bertolínia,220170,PI,Nordeste,BUTANTAN/SINOVAC,902,476,426
Bertolínia,220170,PI,Nordeste,PFIZER/BIONTECH,131,131,0
Bertópolis,310660,MG,Sudeste,BUTANTAN/SINOVAC,1788,941,847
Bertópolis,310660,MG,Sudeste,FIOCRUZ/ASTRAZENECA,1272,1126,146
Bertópolis,310660,MG,Sudeste,PFIZER/BIONTECH,28,28,0
Beruri,130063,AM,Norte,BUTANTAN/SINOVAC,1877,1099,778
Beruri,130063,AM,Norte,FIOCRUZ/ASTRAZENECA,498,367,131
Betânia,260180,PE,Nordeste,FIOCRUZ/ASTRAZENECA,4741,4526,215
Betânia,260180,PE,Nordeste,BUTANTAN/SINOVAC,2278,1174,1104
Betânia,260180,PE,Nordeste,PFIZER/BIONTECH,94,94,0
Betânia Do Piauí,220173,PI,Nordeste,FIOCRUZ/ASTRAZENECA,1445,1338,107
Betânia Do Piauí,220173,PI,Nordeste,BUTANTAN/SINOVAC,878,452,426
Betim,310670,MG,Sudeste,BUTANTAN/SINOVAC,63961,32783,31178
Betim,310670,MG,Sudeste,FIOCRUZ/ASTRAZENECA,45660,42756,2904
Betim,310670,MG,Sudeste,PFIZER/BIONTECH,2224,2224,0
Bezerros,260190,PE,Nordeste,BUTANTAN/SINOVAC,13227,6846,6381
Bezerros,260190,PE,Nordeste,FIOCRUZ/ASTRAZENECA,11702,10546,1156
Bezerros,260190,PE,Nordeste,PFIZER/BIONTECH,280,280,0
Bias Fortes,310680,MG,Sudeste,FIOCRUZ/ASTRAZENECA,1259,1189,70
Bias Fortes,310680,MG,Sudeste,BUTANTAN/SINOVAC,929,488,441
Bicas,310690,MG,Sudeste,BUTANTAN/SINOVAC,4174,2148,2026
Bicas,310690,MG,Sudeste,FIOCRUZ/ASTRAZENECA,4063,3748,315
Bicas,310690,MG,Sudeste,PFIZER/BIONTECH,265,265,0
Biguaçu,420230,SC,Sul,BUTANTAN/SINOVAC,13415,7338,6077
Biguaçu,420230,SC,Sul,FIOCRUZ/ASTRAZENECA,12387,11315,1072
Biguaçu,420230,SC,Sul,PFIZER/BIONTECH,5046,5046,0
Bilac,350640,SP,Sudeste,BUTANTAN/SINOVAC,2446,1316,1130
Bilac,350640,SP,Sudeste,FIOCRUZ/ASTRAZENECA,2089,1909,180
Bilac,350640,SP,Sudeste,PFIZER/BIONTECH,54,54,0
Biquinhas,310700,MG,Sudeste,BUTANTAN/SINOVAC,700,395,305
Biquinhas,310700,MG,Sudeste,FIOCRUZ/ASTRAZENECA,647,604,43
Biquinhas,310700,MG,Sudeste,PFIZER/BIONTECH,56,56,0
Birigui,350650,SP,Sudeste,FIOCRUZ/ASTRAZENECA,27649,25574,2075
Birigui,350650,SP,Sudeste,BUTANTAN/SINOVAC,25903,14421,11482
Birigui,350650,SP,Sudeste,PFIZER/BIONTECH,922,922,0
Biritiba-Mirim,350660,SP,Sudeste,FIOCRUZ/ASTRAZENECA,6034,5704,330
Biritiba-Mirim,350660,SP,Sudeste,BUTANTAN/SINOVAC,5552,2923,2629
Biritiba-Mirim,350660,SP,Sudeste,PFIZER/BIONTECH,962,962,0
Biritinga,290360,BA,Nordeste,FIOCRUZ/ASTRAZENECA,3912,3235,677
Biritinga,290360,BA,Nordeste,BUTANTAN/SINOVAC,2762,1499,1263
Biritinga,290360,BA,Nordeste,PFIZER/BIONTECH,495,493,2
Bituruna,410290,PR,Sul,FIOCRUZ/ASTRAZENECA,3253,3179,74
Bituruna,410290,PR,Sul,BUTANTAN/SINOVAC,2685,1366,1319
Bituruna,410290,PR,Sul,PFIZER/BIONTECH,90,90,0
Blumenau,420240,SC,Sul,BUTANTAN/SINOVAC,64151,33012,31139
Blumenau,420240,SC,Sul,FIOCRUZ/ASTRAZENECA,58455,56012,2443
Blumenau,420240,SC,Sul,PFIZER/BIONTECH,10729,10729,0
Boa Esperança,310710,MG,Sudeste,BUTANTAN/SINOVAC,7020,3568,3452
Boa Esperança,310710,MG,Sudeste,FIOCRUZ/ASTRAZENECA,4339,4007,332
Boa Esperança,310710,MG,Sudeste,PFIZER/BIONTECH,823,823,0
Boa Esperança,320100,ES,Sudeste,BUTANTAN/SINOVAC,3818,1988,1830
Boa Esperança,320100,ES,Sudeste,FIOCRUZ/ASTRAZENECA,3363,3224,139
Boa Esperança,320100,ES,Sudeste,PFIZER/BIONTECH,483,483,0
Boa Esperança,410300,PR,Sul,FIOCRUZ/ASTRAZENECA,1388,1322,66
Boa Esperança,410300,PR,Sul,BUTANTAN/SINOVAC,1054,550,504
Boa Esperança,410300,PR,Sul,PFIZER/BIONTECH,23,23,0
Boa Esperança Do Iguaçu,410302,PR,Sul,FIOCRUZ/ASTRAZENECA,730,691,39
Boa Esperança Do Iguaçu,410302,PR,Sul,BUTANTAN/SINOVAC,524,281,243
Boa Esperança Do Iguaçu,410302,PR,Sul,PFIZER/BIONTECH,17,17,0
Boa Esperança Do Sul,350670,SP,Sudeste,BUTANTAN/SINOVAC,3258,1854,1404
Boa Esperança Do Sul,350670,SP,Sudeste,FIOCRUZ/ASTRAZENECA,3199,2991,208
Boa Esperança Do Sul,350670,SP,Sudeste,PFIZER/BIONTECH,335,335,0
Boa Hora,220177,PI,Nordeste,FIOCRUZ/ASTRAZENECA,1295,1262,33
Boa Hora,220177,PI,Nordeste,BUTANTAN/SINOVAC,1086,564,522
Boa Nova,290370,BA,Nordeste,BUTANTAN/SINOVAC,2754,1519,1235
Boa Nova,290370,BA,Nordeste,FIOCRUZ/ASTRAZENECA,1901,1726,175
Boa Nova,290370,BA,Nordeste,PFIZER/BIONTECH,160,160,0
Boa Ventura,250210,PB,Nordeste,BUTANTAN/SINOVAC,1446,739,707
Boa Ventura,250210,PB,Nordeste,FIOCRUZ/ASTRAZENECA,1173,1076,97
Boa Ventura,250210,PB,Nordeste,PFIZER/BIONTECH,118,118,0
Boa Ventura De São Roque,410304,PR,Sul,FIOCRUZ/ASTRAZENECA,1737,1666,71
Boa Ventura De São Roque,410304,PR,Sul,BUTANTAN/SINOVAC,1224,664,560
Boa Ventura De São Roque,410304,PR,Sul,PFIZER/BIONTECH,22,22,0
Boa Viagem,230240,CE,Nordeste,BUTANTAN/SINOVAC,10405,5362,5043
Boa Viagem,230240,CE,Nordeste,FIOCRUZ/ASTRAZENECA,4973,4061,912
Boa Vista,140010,RR,Norte,BUTANTAN/SINOVAC,63777,32745,31032
Boa Vista,140010,RR,Norte,FIOCRUZ/ASTRAZENECA,39901,36652,3249
Boa Vista,140010,RR,Norte,PFIZER/BIONTECH,15599,15575,24
Boa Vista,250215,PB,Nordeste,BUTANTAN/SINOVAC,2474,1282,1192
Boa Vista,250215,PB,Nordeste,FIOCRUZ/ASTRAZENECA,1575,1470,105
Boa Vista,250215,PB,Nordeste,PFIZER/BIONTECH,106,106,0
Boa Vista Da Aparecida,410305,PR,Sul,FIOCRUZ/ASTRAZENECA,2056,1941,115
Boa Vista Da Aparecida,410305,PR,Sul,BUTANTAN/SINOVAC,2002,1039,963
Boa Vista Da Aparecida,410305,PR,Sul,PFIZER/BIONTECH,72,72,0
Boa Vista Das Missões,430215,RS,Sul,BUTANTAN/SINOVAC,549,284,265
Boa Vista Das Missões,430215,RS,Sul,FIOCRUZ/ASTRAZENECA,444,428,16
Boa Vista Das Missões,430215,RS,Sul,PFIZER/BIONTECH,63,63,0
Boa Vista Do Buricá,430220,RS,Sul,BUTANTAN/SINOVAC,2286,1155,1131
Boa Vista Do Buricá,430220,RS,Sul,FIOCRUZ/ASTRAZENECA,1639,1441,198
Boa Vista Do Buricá,430220,RS,Sul,PFIZER/BIONTECH,278,277,1
Boa Vista Do Cadeado,430222,RS,Sul,BUTANTAN/SINOVAC,774,394,380
Boa Vista Do Cadeado,430222,RS,Sul,FIOCRUZ/ASTRAZENECA,767,670,97
Boa Vista Do Cadeado,430222,RS,Sul,PFIZER/BIONTECH,98,98,0
Boa Vista Do Gurupi,210197,MA,Nordeste,FIOCRUZ/ASTRAZENECA,1154,1060,94
Boa Vista Do Gurupi,210197,MA,Nordeste,BUTANTAN/SINOVAC,1074,561,513
Boa Vista Do Incra,430223,RS,Sul,FIOCRUZ/ASTRAZENECA,981,872,109
Boa Vista Do Incra,430223,RS,Sul,BUTANTAN/SINOVAC,765,338,427
Boa Vista Do Incra,430223,RS,Sul,PFIZER/BIONTECH,111,111,0
Boa Vista Do Ramos,130068,AM,Norte,FIOCRUZ/ASTRAZENECA,7659,6793,866
Boa Vista Do Ramos,130068,AM,Norte,BUTANTAN/SINOVAC,1869,990,879
Boa Vista Do Sul,430225,RS,Sul,BUTANTAN/SINOVAC,1080,541,539
Boa Vista Do Sul,430225,RS,Sul,FIOCRUZ/ASTRAZENECA,871,722,149
Boa Vista Do Sul,430225,RS,Sul,PFIZER/BIONTECH,114,114,0
Boa Vista Do Tupim,290380,BA,Nordeste,FIOCRUZ/ASTRAZENECA,3338,3211,127
Boa Vista Do Tupim,290380,BA,Nordeste,BUTANTAN/SINOVAC,3079,1721,1358
Boa Vista Do Tupim,290380,BA,Nordeste,PFIZER/BIONTECH,6,6,0
Boca Da Mata,270100,AL,Nordeste,FIOCRUZ/ASTRAZENECA,5608,4990,618
Boca Da Mata,270100,AL,Nordeste,BUTANTAN/SINOVAC,4487,2423,2064
Boca Do Acre,130070,AM,Norte,BUTANTAN/SINOVAC,5598,3084,2514
Boca Do Acre,130070,AM,Norte,FIOCRUZ/ASTRAZENECA,4685,3618,1067
Bocaina,220180,PI,Nordeste,FIOCRUZ/ASTRAZENECA,1146,1060,86
Bocaina,220180,PI,Nordeste,BUTANTAN/SINOVAC,1081,546,535
Bocaina,350680,SP,Sudeste,FIOCRUZ/ASTRAZENECA,2940,2696,244
Bocaina,350680,SP,Sudeste,BUTANTAN/SINOVAC,2740,1520,1220
Bocaina,350680,SP,Sudeste,PFIZER/BIONTECH,352,352,0
Bocaina De Minas,310720,MG,Sudeste,FIOCRUZ/ASTRAZENECA,1189,1085,104
Bocaina De Minas,310720,MG,Sudeste,BUTANTAN/SINOVAC,1162,596,566
Bocaina De Minas,310720,MG,Sudeste,PFIZER/BIONTECH,84,84,0
Bocaina Do Sul,420243,SC,Sul,FIOCRUZ/ASTRAZENECA,1069,1039,30
Bocaina Do Sul,420243,SC,Sul,BUTANTAN/SINOVAC,825,436,389
Bocaiúva,310730,MG,Sudeste,BUTANTAN/SINOVAC,806,418,388
Bocaiúva,310730,MG,Sudeste,PFIZER/BIONTECH,374,374,0
Bocaiúva,310730,MG,Sudeste,FIOCRUZ/ASTRAZENECA,6,0,6
Bocaiúva Do Sul,410310,PR,Sul,FIOCRUZ/ASTRAZENECA,2445,2343,102
Bocaiúva Do Sul,410310,PR,Sul,BUTANTAN/SINOVAC,2165,1130,1035
Bocaiúva Do Sul,410310,PR,Sul,PFIZER/BIONTECH,123,123,0
Bodó,240165,RN,Nordeste,FIOCRUZ/ASTRAZENECA,498,479,19
Bodó,240165,RN,Nordeste,BUTANTAN/SINOVAC,469,233,236
Bodó,240165,RN,Nordeste,PFIZER/BIONTECH,83,83,0
Bodocó,260200,PE,Nordeste,FIOCRUZ/ASTRAZENECA,6859,6356,503
Bodocó,260200,PE,Nordeste,BUTANTAN/SINOVAC,5593,2874,2719
Bodocó,260200,PE,Nordeste,PFIZER/BIONTECH,815,814,1
Bodoquena,500215,MS,Centro-Oeste,FIOCRUZ/ASTRAZENECA,2514,2209,305
Bodoquena,500215,MS,Centro-Oeste,BUTANTAN/SINOVAC,1769,922,847
Bodoquena,500215,MS,Centro-Oeste,PFIZER/BIONTECH,290,290,0
Bofete,350690,SP,Sudeste,BUTANTAN/SINOVAC,2473,1378,1095
Bofete,350690,SP,Sudeste,FIOCRUZ/ASTRAZENECA,1913,1768,145
Bofete,350690,SP,Sudeste,PFIZER/BIONTECH,56,56,0
Boituva,350700,SP,Sudeste,FIOCRUZ/ASTRAZENECA,11469,10701,768
Boituva,350700,SP,Sudeste,BUTANTAN/SINOVAC,9949,5150,4799
Boituva,350700,SP,Sudeste,PFIZER/BIONTECH,708,708,0
Bom Conselho,260210,PE,Nordeste,FIOCRUZ/ASTRAZENECA,14900,14169,731
Bom Conselho,260210,PE,Nordeste,BUTANTAN/SINOVAC,8456,4337,4119
Bom Conselho,260210,PE,Nordeste,PFIZER/BIONTECH,370,370,0
Bom Despacho,310740,MG,Sudeste,BUTANTAN/SINOVAC,11326,5862,5464
Bom Despacho,310740,MG,Sudeste,FIOCRUZ/ASTRAZENECA,10234,9254,980
Bom Despacho,310740,MG,Sudeste,PFIZER/BIONTECH,1332,1332,0
Bom Jardim,210200,MA,Nordeste,FIOCRUZ/ASTRAZENECA,5709,5439,270
Bom Jardim,210200,MA,Nordeste,BUTANTAN/SINOVAC,5234,2910,2324
Bom Jardim,260220,PE,Nordeste,FIOCRUZ/ASTRAZENECA,7299,6678,621
Bom Jardim,260220,PE,Nordeste,BUTANTAN/SINOVAC,6647,3420,3227
Bom Jardim,260220,PE,Nordeste,PFIZER/BIONTECH,350,350,0
Bom Jardim,330050,RJ,Sudeste,FIOCRUZ/ASTRAZENECA,5930,5663,267
Bom Jardim,330050,RJ,Sudeste,BUTANTAN/SINOVAC,5445,2768,2677
Bom Jardim,330050,RJ,Sudeste,PFIZER/BIONTECH,1408,1408,0
Bom Jardim Da Serra,420250,SC,Sul,FIOCRUZ/ASTRAZENECA,1154,1054,100
Bom Jardim Da Serra,420250,SC,Sul,BUTANTAN/SINOVAC,1025,562,463
Bom Jardim De Goiás,520340,GO,Centro-Oeste,FIOCRUZ/ASTRAZENECA,2468,2322,146
Bom Jardim De Goiás,520340,GO,Centro-Oeste,BUTANTAN/SINOVAC,1934,981,953
Bom Jardim De Minas,310750,MG,Sudeste,FIOCRUZ/ASTRAZENECA,1772,1642,130
Bom Jardim De Minas,310750,MG,Sudeste,BUTANTAN/SINOVAC,1708,877,831
Bom Jardim De Minas,310750,MG,Sudeste,PFIZER/BIONTECH,164,161,3
Bom Jesus,220190,PI,Nordeste,FIOCRUZ/ASTRAZENECA,4962,4546,416
Bom Jesus,220190,PI,Nordeste,BUTANTAN/SINOVAC,2953,1466,1487
Bom Jesus,220190,PI,Nordeste,PFIZER/BIONTECH,607,606,1
Bom Jesus,240170,RN,Nordeste,FIOCRUZ/ASTRAZENECA,2344,2088,256
Bom Jesus,240170,RN,Nordeste,BUTANTAN/SINOVAC,2006,1017,989
Bom Jesus,240170,RN,Nordeste,PFIZER/BIONTECH,117,117,0
Bom Jesus,250220,PB,Nordeste,BUTANTAN/SINOVAC,1009,535,474
Bom Jesus,250220,PB,Nordeste,FIOCRUZ/ASTRAZENECA,524,481,43
Bom Jesus,250220,PB,Nordeste,PFIZER/BIONTECH,47,47,0
Bom Jesus,420253,SC,Sul,BUTANTAN/SINOVAC,688,387,301
Bom Jesus,420253,SC,Sul,FIOCRUZ/ASTRAZENECA,472,428,44
Bom Jesus,420253,SC,Sul,PFIZER/BIONTECH,30,30,0
Bom Jesus,430230,RS,Sul,BUTANTAN/SINOVAC,3230,1641,1589
Bom Jesus,430230,RS,Sul,FIOCRUZ/ASTRAZENECA,2604,2316,288
Bom Jesus,430230,RS,Sul,PFIZER/BIONTECH,400,400,0
Bom Jesus Da Lapa,290390,BA,Nordeste,FIOCRUZ/ASTRAZENECA,14900,14001,899
Bom Jesus Da Lapa,290390,BA,Nordeste,BUTANTAN/SINOVAC,10160,5205,4955
Bom Jesus Da Penha,310760,MG,Sudeste,BUTANTAN/SINOVAC,1129,576,553
Bom Jesus Da Penha,310760,MG,Sudeste,FIOCRUZ/ASTRAZENECA,1038,943,95
Bom Jesus Da Serra,290395,BA,Nordeste,BUTANTAN/SINOVAC,2316,1150,1166
Bom Jesus Da Serra,290395,BA,Nordeste,FIOCRUZ/ASTRAZENECA,1760,1563,197
Bom Jesus Da Serra,290395,BA,Nordeste,PFIZER/BIONTECH,52,52,0
Bom Jesus Das Selvas,210203,MA,Nordeste,BUTANTAN/SINOVAC,2727,1418,1309
Bom Jesus Das Selvas,210203,MA,Nordeste,FIOCRUZ/ASTRAZENECA,2378,2277,101
Bom Jesus De Goiás,520350,GO,Centro-Oeste,FIOCRUZ/ASTRAZENECA,5981,5682,299
Bom Jesus De Goiás,520350,GO,Centro-Oeste,BUTANTAN/SINOVAC,3469,1836,1633
Bom Jesus De Goiás,520350,GO,Centro-Oeste,PFIZER/BIONTECH,395,395,0
Bom Jesus Do Amparo,310770,MG,Sudeste,BUTANTAN/SINOVAC,1266,726,540
Bom Jesus Do Amparo,310770,MG,Sudeste,FIOCRUZ/ASTRAZENECA,1139,1113,26
Bom Jesus Do Amparo,310770,MG,Sudeste,PFIZER/BIONTECH,35,35,0
Bom Jesus Do Araguaia,510185,MT,Centro-Oeste,FIOCRUZ/ASTRAZENECA,821,754,67
Bom Jesus Do Araguaia,510185,MT,Centro-Oeste,BUTANTAN/SINOVAC,800,414,386
Bom Jesus Do Araguaia,510185,MT,Centro-Oeste,PFIZER/BIONTECH,112,112,0
Bom Jesus Do Galho,310780,MG,Sudeste,BUTANTAN/SINOVAC,3659,2153,1506
Bom Jesus Do Galho,310780,MG,Sudeste,FIOCRUZ/ASTRAZENECA,1674,1573,101
Bom Jesus Do Galho,310780,MG,Sudeste,PFIZER/BIONTECH,23,23,0
Bom Jesus Do Itabapoana,330060,RJ,Sudeste,BUTANTAN/SINOVAC,11606,6010,5596
Bom Jesus Do Itabapoana,330060,RJ,Sudeste,FIOCRUZ/ASTRAZENECA,10206,9537,669
Bom Jesus Do Itabapoana,330060,RJ,Sudeste,PFIZER/BIONTECH,1454,1453,1
Bom Jesus Do Norte,320110,ES,Sudeste,BUTANTAN/SINOVAC,3517,1802,1715
Bom Jesus Do Norte,320110,ES,Sudeste,FIOCRUZ/ASTRAZENECA,2448,2327,121
Bom Jesus Do Norte,320110,ES,Sudeste,PFIZER/BIONTECH,478,478,0
Bom Jesus Do Oeste,420257,SC,Sul,BUTANTAN/SINOVAC,824,437,387
Bom Jesus Do Oeste,420257,SC,Sul,FIOCRUZ/ASTRAZENECA,453,391,62
Bom Jesus Do Sul,410315,PR,Sul,FIOCRUZ/ASTRAZENECA,1462,1368,94
Bom Jesus Do Sul,410315,PR,Sul,BUTANTAN/SINOVAC,1068,554,514
Bom Jesus Do Sul,410315,PR,Sul,PFIZER/BIONTECH,30,30,0
Bom Jesus Do Tocantins,150157,PA,Norte,FIOCRUZ/ASTRAZENECA,2600,2267,333
Bom Jesus Do Tocantins,150157,PA,Norte,BUTANTAN/SINOVAC,878,515,363
Bom Jesus Do Tocantins,170330,TO,Norte,FIOCRUZ/ASTRAZENECA,571,553,18
Bom Jesus Do Tocantins,170330,TO,Norte,BUTANTAN/SINOVAC,526,277,249
Bom Jesus Dos Perdões,350710,SP,Sudeste,FIOCRUZ/ASTRAZENECA,5161,4895,266
Bom Jesus Dos Perdões,350710,SP,Sudeste,BUTANTAN/SINOVAC,4702,2747,1955
Bom Jesus Dos Perdões,350710,SP,Sudeste,PFIZER/BIONTECH,327,327,0
Bom Lugar,210207,MA,Nordeste,BUTANTAN/SINOVAC,1939,1013,926
Bom Lugar,210207,MA,Nordeste,FIOCRUZ/ASTRAZENECA,1725,1585,140
Bom Princípio,430235,RS,Sul,FIOCRUZ/ASTRAZENECA,3133,2855,278
Bom Princípio,430235,RS,Sul,BUTANTAN/SINOVAC,2439,1250,1189
Bom Princípio,430235,RS,Sul,PFIZER/BIONTECH,544,544,0
Bom Princípio Do Piauí,220191,PI,Nordeste,BUTANTAN/SINOVAC,1292,768,524
Bom Princípio Do Piauí,220191,PI,Nordeste,FIOCRUZ/ASTRAZENECA,929,888,41
Bom Progresso,430237,RS,Sul,BUTANTAN/SINOVAC,654,352,302
Bom Progresso,430237,RS,Sul,FIOCRUZ/ASTRAZENECA,605,565,40
Bom Progresso,430237,RS,Sul,PFIZER/BIONTECH,96,96,0
Bom Repouso,310790,MG,Sudeste,FIOCRUZ/ASTRAZENECA,2292,2189,103
Bom Repouso,310790,MG,Sudeste,BUTANTAN/SINOVAC,1827,992,835
Bom Repouso,310790,MG,Sudeste,PFIZER/BIONTECH,150,150,0
Bom Retiro,420260,SC,Sul,BUTANTAN/SINOVAC,1916,1042,874
Bom Retiro,420260,SC,Sul,FIOCRUZ/ASTRAZENECA,1838,1777,61
Bom Retiro Do Sul,430240,RS,Sul,FIOCRUZ/ASTRAZENECA,3087,2895,192
Bom Retiro Do Sul,430240,RS,Sul,BUTANTAN/SINOVAC,2974,1506,1468
Bom Retiro Do Sul,430240,RS,Sul,PFIZER/BIONTECH,443,443,0
Bom Sucesso,250230,PB,Nordeste,BUTANTAN/SINOVAC,1617,803,814
Bom Sucesso,250230,PB,Nordeste,FIOCRUZ/ASTRAZENECA,1033,902,131
Bom Sucesso,250230,PB,Nordeste,PFIZER/BIONTECH,112,112,0
Bom Sucesso,310800,MG,Sudeste,BUTANTAN/SINOVAC,4336,2171,2165
Bom Sucesso,310800,MG,Sudeste,FIOCRUZ/ASTRAZENECA,3851,3554,297
Bom Sucesso,310800,MG,Sudeste,PFIZER/BIONTECH,94,94,0
Bom Sucesso,410320,PR,Sul,FIOCRUZ/ASTRAZENECA,1970,1866,104
Bom Sucesso,410320,PR,Sul,BUTANTAN/SINOVAC,1491,783,708
Bom Sucesso,410320,PR,Sul,PFIZER/BIONTECH,29,29,0
Bom Sucesso De Itararé,350715,SP,Sudeste,FIOCRUZ/ASTRAZENECA,661,599,62
Bom Sucesso De Itararé,350715,SP,Sudeste,BUTANTAN/SINOVAC,638,356,282
Bom Sucesso De Itararé,350715,SP,Sudeste,PFIZER/BIONTECH,99,99,0
Bom Sucesso Do Sul,410322,PR,Sul,FIOCRUZ/ASTRAZENECA,932,870,62
Bom Sucesso Do Sul,410322,PR,Sul,BUTANTAN/SINOVAC,867,461,406
Bom Sucesso Do Sul,410322,PR,Sul,PFIZER/BIONTECH,11,11,0
Bombinhas,420245,SC,Sul,FIOCRUZ/ASTRAZENECA,4483,4246,237
Bombinhas,420245,SC,Sul,BUTANTAN/SINOVAC,3370,1739,1631
Bombinhas,420245,SC,Sul,PFIZER/BIONTECH,350,350,0
Bonfim,140015,RR,Norte,BUTANTAN/SINOVAC,4682,2880,1802
Bonfim,140015,RR,Norte,FIOCRUZ/ASTRAZENECA,1758,1738,20
Bonfim,310810,MG,Sudeste,FIOCRUZ/ASTRAZENECA,2717,2561,156
Bonfim,310810,MG,Sudeste,BUTANTAN/SINOVAC,2231,1199,1032
Bonfim,310810,MG,Sudeste,PFIZER/BIONTECH,65,65,0
Bonfim Do Piauí,220192,PI,Nordeste,FIOCRUZ/ASTRAZENECA,1003,921,82
Bonfim Do Piauí,220192,PI,Nordeste,BUTANTAN/SINOVAC,1003,507,496
Bonfim Do Piauí,220192,PI,Nordeste,PFIZER/BIONTECH,37,37,0
Bonfinópolis,520355,GO,Centro-Oeste,FIOCRUZ/ASTRAZENECA,2624,2447,177
Bonfinópolis,520355,GO,Centro-Oeste,BUTANTAN/SINOVAC,1889,1058,831
Bonfinópolis De Minas,310820,MG,Sudeste,BUTANTAN/SINOVAC,1675,857,818
Bonfinópolis De Minas,310820,MG,Sudeste,FIOCRUZ/ASTRAZENECA,1497,1337,160
Bonfinópolis De Minas,310820,MG,Sudeste,PFIZER/BIONTECH,82,82,0
Boninal,290400,BA,Nordeste,BUTANTAN/SINOVAC,2586,1404,1182
Boninal,290400,BA,Nordeste,FIOCRUZ/ASTRAZENECA,2312,2201,111
Bonito,150160,PA,Norte,FIOCRUZ/ASTRAZENECA,1814,1393,421
Bonito,150160,PA,Norte,BUTANTAN/SINOVAC,1325,821,504
Bonito,260230,PE,Nordeste,BUTANTAN/SINOVAC,7063,3757,3306
Bonito,260230,PE,Nordeste,FIOCRUZ/ASTRAZENECA,6346,5804,542
Bonito,260230,PE,Nordeste,PFIZER/BIONTECH,331,330,1
Bonito,290405,BA,Nordeste,FIOCRUZ/ASTRAZENECA,7497,7283,214
Bonito,290405,BA,Nordeste,BUTANTAN/SINOVAC,2023,1026,997
Bonito,290405,BA,Nordeste,PFIZER/BIONTECH,83,83,0
Bonito,500220,MS,Centro-Oeste,FIOCRUZ/ASTRAZENECA,5948,4850,1098
Bonito,500220,MS,Centro-Oeste,BUTANTAN/SINOVAC,4720,2550,2170
Bonito,500220,MS,Centro-Oeste,PFIZER/BIONTECH,796,795,1
Bonito De Minas,310825,MG,Sudeste,FIOCRUZ/ASTRAZENECA,2220,2073,147
Bonito De Minas,310825,MG,Sudeste,BUTANTAN/SINOVAC,2005,1007,998
Bonito De Minas,310825,MG,Sudeste,PFIZER/BIONTECH,120,120,0
Bonito De Santa Fé,250240,PB,Nordeste,BUTANTAN/SINOVAC,2561,1295,1266
Bonito De Santa Fé,250240,PB,Nordeste,FIOCRUZ/ASTRAZENECA,1673,1503,170
Bonito De Santa Fé,250240,PB,Nordeste,PFIZER/BIONTECH,6,6,0
Bonópolis,520357,GO,Centro-Oeste,FIOCRUZ/ASTRAZENECA,1034,991,43
Bonópolis,520357,GO,Centro-Oeste,BUTANTAN/SINOVAC,549,298,251
Boqueirão,250250,PB,Nordeste,BUTANTAN/SINOVAC,3527,1911,1616
Boqueirão,250250,PB,Nordeste,FIOCRUZ/ASTRAZENECA,2703,2570,133
Boqueirão,250250,PB,Nordeste,PFIZER/BIONTECH,174,174,0
Boqueirão Do Leão,430245,RS,Sul,FIOCRUZ/ASTRAZENECA,1685,1541,144
Boqueirão Do Leão,430245,RS,Sul,BUTANTAN/SINOVAC,1628,838,790
Boqueirão Do Leão,430245,RS,Sul,PFIZER/BIONTECH,124,124,0
Boqueirão Do Piauí,220194,PI,Nordeste,BUTANTAN/SINOVAC,1311,717,594
Boqueirão Do Piauí,220194,PI,Nordeste,FIOCRUZ/ASTRAZENECA,837,835,2
Boqueirão Do Piauí,220194,PI,Nordeste,PFIZER/BIONTECH,71,71,0
Boquim,280067,SE,Nordeste,BUTANTAN/SINOVAC,4171,2343,1828
Boquim,280067,SE,Nordeste,FIOCRUZ/ASTRAZENECA,3793,3578,215
Boquim,280067,SE,Nordeste,PFIZER/BIONTECH,614,614,0
Boquira,290410,BA,Nordeste,BUTANTAN/SINOVAC,4739,2386,2353
Boquira,290410,BA,Nordeste,FIOCRUZ/ASTRAZENECA,3315,2993,322
Boquira,290410,BA,Nordeste,PFIZER/BIONTECH,52,52,0
Borá,350720,SP,Sudeste,BUTANTAN/SINOVAC,287,146,141
Borá,350720,SP,Sudeste,FIOCRUZ/ASTRAZENECA,192,169,23
Borá,350720,SP,Sudeste,PFIZER/BIONTECH,131,131,0
Boracéia,350730,SP,Sudeste,BUTANTAN/SINOVAC,1314,720,594
Boracéia,350730,SP,Sudeste,FIOCRUZ/ASTRAZENECA,1162,1078,84
Boracéia,350730,SP,Sudeste,PFIZER/BIONTECH,152,151,1
Borba,130080,AM,Norte,BUTANTAN/SINOVAC,5218,2693,2525
Borba,130080,AM,Norte,FIOCRUZ/ASTRAZENECA,4382,3388,994
Borborema,250270,PB,Nordeste,BUTANTAN/SINOVAC,920,485,435
Borborema,250270,PB,Nordeste,FIOCRUZ/ASTRAZENECA,849,778,71
Borborema,250270,PB,Nordeste,PFIZER/BIONTECH,99,99,0
Borborema,350740,SP,Sudeste,BUTANTAN/SINOVAC,7543,4300,3243
Borborema,350740,SP,Sudeste,FIOCRUZ/ASTRAZENECA,5935,5466,469
Borborema,350740,SP,Sudeste,PFIZER/BIONTECH,587,587,0
Borda Da Mata,310830,MG,Sudeste,FIOCRUZ/ASTRAZENECA,5332,4970,362
Borda Da Mata,310830,MG,Sudeste,BUTANTAN/SINOVAC,4743,2441,2302
Borda Da Mata,310830,MG,Sudeste,PFIZER/BIONTECH,264,264,0
Borebi,350745,SP,Sudeste,FIOCRUZ/ASTRAZENECA,671,606,65
Borebi,350745,SP,Sudeste,BUTANTAN/SINOVAC,496,257,239
Borebi,350745,SP,Sudeste,PFIZER/BIONTECH,68,68,0
Borrazópolis,410330,PR,Sul,FIOCRUZ/ASTRAZENECA,2212,2096,116
Borrazópolis,410330,PR,Sul,BUTANTAN/SINOVAC,2096,1091,1005
Borrazópolis,410330,PR,Sul,PFIZER/BIONTECH,30,30,0
Bossoroca,430250,RS,Sul,BUTANTAN/SINOVAC,2006,1007,999
Bossoroca,430250,RS,Sul,FIOCRUZ/ASTRAZENECA,1827,1599,228
Bossoroca,430250,RS,Sul,PFIZER/BIONTECH,271,271,0
Botelhos,310840,MG,Sudeste,FIOCRUZ/ASTRAZENECA,3298,2975,323
Botelhos,310840,MG,Sudeste,BUTANTAN/SINOVAC,3185,1602,1583
Botelhos,310840,MG,Sudeste,PFIZER/BIONTECH,156,156,0
Botucatu,350750,SP,Sudeste,BUTANTAN/SINOVAC,39325,21013,18312
Botucatu,350750,SP,Sudeste,FIOCRUZ/ASTRAZENECA,20006,15396,4610
Botucatu,350750,SP,Sudeste,PFIZER/BIONTECH,111,111,0
Botumirim,310850,MG,Sudeste,FIOCRUZ/ASTRAZENECA,1496,1404,92
Botumirim,310850,MG,Sudeste,BUTANTAN/SINOVAC,1174,597,577
Botumirim,310850,MG,Sudeste,PFIZER/BIONTECH,86,86,0
Botuporã,290420,BA,Nordeste,BUTANTAN/SINOVAC,2301,1193,1108
Botuporã,290420,BA,Nordeste,FIOCRUZ/ASTRAZENECA,1507,1445,62
Botuporã,290420,BA,Nordeste,PFIZER/BIONTECH,18,18,0
Botuverá,420270,SC,Sul,BUTANTAN/SINOVAC,1654,865,789
Botuverá,420270,SC,Sul,FIOCRUZ/ASTRAZENECA,1187,1160,27
Bozano,430258,RS,Sul,BUTANTAN/SINOVAC,852,432,420
Bozano,430258,RS,Sul,FIOCRUZ/ASTRAZENECA,682,535,147
Bozano,430258,RS,Sul,PFIZER/BIONTECH,84,84,0
Braço Do Norte,420280,SC,Sul,FIOCRUZ/ASTRAZENECA,8038,7480,558
Braço Do Norte,420280,SC,Sul,BUTANTAN/SINOVAC,5968,3292,2676
Braço Do Norte,420280,SC,Sul,PFIZER/BIONTECH,840,839,1
Braço Do Trombudo,420285,SC,Sul,BUTANTAN/SINOVAC,946,497,449
Braço Do Trombudo,420285,SC,Sul,FIOCRUZ/ASTRAZENECA,695,617,78
Braço Do Trombudo,420285,SC,Sul,PFIZER/BIONTECH,42,42,0
Braga,430260,RS,Sul,BUTANTAN/SINOVAC,993,499,494
Braga,430260,RS,Sul,FIOCRUZ/ASTRAZENECA,862,820,42
Braga,430260,RS,Sul,PFIZER/BIONTECH,41,31,10
Bragança,150170,PA,Norte,FIOCRUZ/ASTRAZENECA,37929,32446,5483
Bragança,150170,PA,Norte,BUTANTAN/SINOVAC,14251,7615,6636
Bragança,150170,PA,Norte,PFIZER/BIONTECH,1,1,0
Bragança Paulista,350760,SP,Sudeste,FIOCRUZ/ASTRAZENECA,44416,40443,3973
Bragança Paulista,350760,SP,Sudeste,BUTANTAN/SINOVAC,41856,24071,17785
Bragança Paulista,350760,SP,Sudeste,PFIZER/BIONTECH,2094,2092,2
Braganey,410335,PR,Sul,FIOCRUZ/ASTRAZENECA,1685,1575,110
Braganey,410335,PR,Sul,BUTANTAN/SINOVAC,1111,577,534
Braganey,410335,PR,Sul,PFIZER/BIONTECH,36,36,0
Branquinha,270110,AL,Nordeste,FIOCRUZ/ASTRAZENECA,1736,1619,117
Branquinha,270110,AL,Nordeste,BUTANTAN/SINOVAC,1631,838,793
Brás Pires,310870,MG,Sudeste,BUTANTAN/SINOVAC,1288,662,626
Brás Pires,310870,MG,Sudeste,FIOCRUZ/ASTRAZENECA,1236,1128,108
Brás Pires,310870,MG,Sudeste,PFIZER/BIONTECH,58,58,0
Brasil Novo,150172,PA,Norte,FIOCRUZ/ASTRAZENECA,3523,2613,910
Brasil Novo,150172,PA,Norte,BUTANTAN/SINOVAC,2082,1077,1005
Brasilândia,500230,MS,Centro-Oeste,FIOCRUZ/ASTRAZENECA,2892,2348,544
Brasilândia,500230,MS,Centro-Oeste,BUTANTAN/SINOVAC,2477,1310,1167
Brasilândia,500230,MS,Centro-Oeste,PFIZER/BIONTECH,344,344,0
Brasilândia De Minas,310855,MG,Sudeste,FIOCRUZ/ASTRAZENECA,2917,2719,198
Brasilândia De Minas,310855,MG,Sudeste,BUTANTAN/SINOVAC,2078,1042,1036
Brasilândia De Minas,310855,MG,Sudeste,PFIZER/BIONTECH,65,65,0
Brasilândia Do Sul,410337,PR,Sul,FIOCRUZ/ASTRAZENECA,1077,1008,69
Brasilândia Do Sul,410337,PR,Sul,BUTANTAN/SINOVAC,729,389,340
Brasilândia Do Sul,410337,PR,Sul,PFIZER/BIONTECH,12,12,0
Brasilândia Do Tocantins,170360,TO,Norte,BUTANTAN/SINOVAC,431,228,203
Brasilândia Do Tocantins,170360,TO,Norte,FIOCRUZ/ASTRAZENECA,356,325,31
Brasiléia,120010,AC,Norte,FIOCRUZ/ASTRAZENECA,4735,4294,441
Brasiléia,120010,AC,Norte,BUTANTAN/SINOVAC,3967,2034,1933
Brasileira,220196,PI,Nordeste,FIOCRUZ/ASTRAZENECA,1467,1374,93
Brasileira,220196,PI,Nordeste,BUTANTAN/SINOVAC,1384,706,678
Brasileira,220196,PI,Nordeste,PFIZER/BIONTECH,161,161,0
Brasília,530010,DF,Centro-Oeste,FIOCRUZ/ASTRAZENECA,560906,497119,63787
Brasília,530010,DF,Centro-Oeste,BUTANTAN/SINOVAC,544938,284971,259967
Brasília,530010,DF,Centro-Oeste,PFIZER/BIONTECH,83782,83596,186
Brasília De Minas,310860,MG,Sudeste,BUTANTAN/SINOVAC,7075,3910,3165
Brasília De Minas,310860,MG,Sudeste,FIOCRUZ/ASTRAZENECA,4164,3722,442
Brasília De Minas,310860,MG,Sudeste,PFIZER/BIONTECH,916,914,2
Brasnorte,510190,MT,Centro-Oeste,FIOCRUZ/ASTRAZENECA,2345,2204,141
Brasnorte,510190,MT,Centro-Oeste,BUTANTAN/SINOVAC,1768,889,879
Brasnorte,510190,MT,Centro-Oeste,PFIZER/BIONTECH,157,157,0
Braúna,350770,SP,Sudeste,BUTANTAN/SINOVAC,1631,930,701
Braúna,350770,SP,Sudeste,FIOCRUZ/ASTRAZENECA,1145,1037,108
Braúna,350770,SP,Sudeste,PFIZER/BIONTECH,185,185,0
Braúnas,310880,MG,Sudeste,FIOCRUZ/ASTRAZENECA,1397,1202,195
Braúnas,310880,MG,Sudeste,BUTANTAN/SINOVAC,1267,646,621
Braúnas,310880,MG,Sudeste,PFIZER/BIONTECH,56,56,0
Brazabrantes,520360,GO,Centro-Oeste,BUTANTAN/SINOVAC,837,425,412
Brazabrantes,520360,GO,Centro-Oeste,FIOCRUZ/ASTRAZENECA,610,539,71
Brazópolis,310890,MG,Sudeste,BUTANTAN/SINOVAC,3964,2051,1913
Brazópolis,310890,MG,Sudeste,FIOCRUZ/ASTRAZENECA,3233,2917,316
Brazópolis,310890,MG,Sudeste,PFIZER/BIONTECH,510,510,0
Brejão,260240,PE,Nordeste,FIOCRUZ/ASTRAZENECA,2955,2771,184
Brejão,260240,PE,Nordeste,BUTANTAN/SINOVAC,1886,974,912
Brejão,260240,PE,Nordeste,PFIZER/BIONTECH,246,246,0
Brejetuba,320115,ES,Sudeste,FIOCRUZ/ASTRAZENECA,2405,2351,54
Brejetuba,320115,ES,Sudeste,BUTANTAN/SINOVAC,2166,1203,963
Brejetuba,320115,ES,Sudeste,PFIZER/BIONTECH,158,157,1
Brejinho,240180,RN,Nordeste,BUTANTAN/SINOVAC,1908,965,943
Brejinho,240180,RN,Nordeste,FIOCRUZ/ASTRAZENECA,1875,1773,102
Brejinho,240180,RN,Nordeste,PFIZER/BIONTECH,365,364,1
Brejinho,260250,PE,Nordeste,FIOCRUZ/ASTRAZENECA,1600,1432,168
Brejinho,260250,PE,Nordeste,BUTANTAN/SINOVAC,1479,744,735
Brejinho,260250,PE,Nordeste,PFIZER/BIONTECH,142,142,0
Brejinho De Nazaré,170370,TO,Norte,FIOCRUZ/ASTRAZENECA,1024,982,42
Brejinho De Nazaré,170370,TO,Norte,BUTANTAN/SINOVAC,1008,534,474
Brejo,210210,MA,Nordeste,FIOCRUZ/ASTRAZENECA,13485,10954,2531
Brejo,210210,MA,Nordeste,BUTANTAN/SINOVAC,5038,2609,2429
Brejo Alegre,350775,SP,Sudeste,BUTANTAN/SINOVAC,877,495,382
Brejo Alegre,350775,SP,Sudeste,FIOCRUZ/ASTRAZENECA,711,625,86
Brejo Alegre,350775,SP,Sudeste,PFIZER/BIONTECH,75,75,0
Brejo Da Madre De Deus,260260,PE,Nordeste,FIOCRUZ/ASTRAZENECA,7204,6594,610
Brejo Da Madre De Deus,260260,PE,Nordeste,BUTANTAN/SINOVAC,6966,3707,3259
Brejo Da Madre De Deus,260260,PE,Nordeste,PFIZER/BIONTECH,705,705,0
Brejo De Areia,210215,MA,Nordeste,FIOCRUZ/ASTRAZENECA,1377,1307,70
Brejo De Areia,210215,MA,Nordeste,BUTANTAN/SINOVAC,868,488,380
Brejo Do Cruz,250280,PB,Nordeste,BUTANTAN/SINOVAC,3144,1584,1560
Brejo Do Cruz,250280,PB,Nordeste,FIOCRUZ/ASTRAZENECA,2936,2708,228
Brejo Do Cruz,250280,PB,Nordeste,PFIZER/BIONTECH,254,253,1
Brejo Do Piauí,220198,PI,Nordeste,BUTANTAN/SINOVAC,741,402,339
Brejo Do Piauí,220198,PI,Nordeste,FIOCRUZ/ASTRAZENECA,462,417,45
Brejo Do Piauí,220198,PI,Nordeste,PFIZER/BIONTECH,35,35,0
Brejo Dos Santos,250290,PB,Nordeste,BUTANTAN/SINOVAC,1736,902,834
Brejo Dos Santos,250290,PB,Nordeste,FIOCRUZ/ASTRAZENECA,1345,1203,142
Brejo Dos Santos,250290,PB,Nordeste,PFIZER/BIONTECH,113,113,0
Brejo Grande,280070,SE,Nordeste,BUTANTAN/SINOVAC,382,250,132
Brejo Grande,280070,SE,Nordeste,FIOCRUZ/ASTRAZENECA,186,186,0
Brejo Grande Do Araguaia,150175,PA,Norte,FIOCRUZ/ASTRAZENECA,1249,1138,111
Brejo Grande Do Araguaia,150175,PA,Norte,BUTANTAN/SINOVAC,445,239,206
Brejo Santo,230250,CE,Nordeste,BUTANTAN/SINOVAC,7620,4174,3446
Brejo Santo,230250,CE,Nordeste,FIOCRUZ/ASTRAZENECA,3680,3158,522
Brejões,290430,BA,Nordeste,BUTANTAN/SINOVAC,1431,1174,257
Brejões,290430,BA,Nordeste,FIOCRUZ/ASTRAZENECA,837,790,47
Brejolândia,290440,BA,Nordeste,BUTANTAN/SINOVAC,1629,874,755
Brejolândia,290440,BA,Nordeste,FIOCRUZ/ASTRAZENECA,909,818,91
Brejolândia,290440,BA,Nordeste,PFIZER/BIONTECH,17,17,0
Breu Branco,150178,PA,Norte,FIOCRUZ/ASTRAZENECA,5327,4879,448
Breu Branco,150178,PA,Norte,BUTANTAN/SINOVAC,3198,1803,1395
Breves,150180,PA,Norte,FIOCRUZ/ASTRAZENECA,25820,21395,4425
Breves,150180,PA,Norte,BUTANTAN/SINOVAC,4633,2531,2102
Britânia,520380,GO,Centro-Oeste,FIOCRUZ/ASTRAZENECA,1304,1196,108
Britânia,520380,GO,Centro-Oeste,BUTANTAN/SINOVAC,1298,661,637
Brochier,430265,RS,Sul,BUTANTAN/SINOVAC,2082,992,1090
Brochier,430265,RS,Sul,FIOCRUZ/ASTRAZENECA,1545,1352,193
Brochier,430265,RS,Sul,PFIZER/BIONTECH,80,80,0
Brodowski,350780,SP,Sudeste,BUTANTAN/SINOVAC,5703,3153,2550
Brodowski,350780,SP,Sudeste,FIOCRUZ/ASTRAZENECA,5264,4935,329
Brodowski,350780,SP,Sudeste,PFIZER/BIONTECH,369,369,0
Brotas,350790,SP,Sudeste,FIOCRUZ/ASTRAZENECA,5814,5358,456
Brotas,350790,SP,Sudeste,BUTANTAN/SINOVAC,5520,3183,2337
Brotas,350790,SP,Sudeste,PFIZER/BIONTECH,592,592,0
Brotas De Macaúbas,290450,BA,Nordeste,FIOCRUZ/ASTRAZENECA,2742,2557,185
Brotas De Macaúbas,290450,BA,Nordeste,BUTANTAN/SINOVAC,2524,1308,1216
Brotas De Macaúbas,290450,BA,Nordeste,PFIZER/BIONTECH,137,137,0
Brumadinho,310900,MG,Sudeste,BUTANTAN/SINOVAC,8860,4668,4192
Brumadinho,310900,MG,Sudeste,FIOCRUZ/ASTRAZENECA,8270,7354,916
Brumadinho,310900,MG,Sudeste,PFIZER/BIONTECH,732,729,3
Brumado,290460,BA,Nordeste,BUTANTAN/SINOVAC,13038,6715,6323
Brumado,290460,BA,Nordeste,FIOCRUZ/ASTRAZENECA,12149,11102,1047
Brumado,290460,BA,Nordeste,PFIZER/BIONTECH,271,271,0
Brunópolis,420287,SC,Sul,BUTANTAN/SINOVAC,765,397,368
Brunópolis,420287,SC,Sul,FIOCRUZ/ASTRAZENECA,680,631,49
Brunópolis,420287,SC,Sul,PFIZER/BIONTECH,54,54,0
Brusque,420290,SC,Sul,BUTANTAN/SINOVAC,26581,13778,12803
Brusque,420290,SC,Sul,FIOCRUZ/ASTRAZENECA,19840,18921,919
Brusque,420290,SC,Sul,PFIZER/BIONTECH,6860,6860,0
Bueno Brandão,310910,MG,Sudeste,BUTANTAN/SINOVAC,2811,1415,1396
Bueno Brandão,310910,MG,Sudeste,FIOCRUZ/ASTRAZENECA,2477,2251,226
Bueno Brandão,310910,MG,Sudeste,PFIZER/BIONTECH,232,232,0
Buenópolis,310920,MG,Sudeste,FIOCRUZ/ASTRAZENECA,2664,2483,181
Buenópolis,310920,MG,Sudeste,BUTANTAN/SINOVAC,2180,1142,1038
Buenópolis,310920,MG,Sudeste,PFIZER/BIONTECH,132,132,0
Buenos Aires,260270,PE,Nordeste,FIOCRUZ/ASTRAZENECA,2787,2594,193
Buenos Aires,260270,PE,Nordeste,BUTANTAN/SINOVAC,2222,1188,1034
Buenos Aires,260270,PE,Nordeste,PFIZER/BIONTECH,202,202,0
Buerarema,290470,BA,Nordeste,BUTANTAN/SINOVAC,4895,2547,2348
Buerarema,290470,BA,Nordeste,FIOCRUZ/ASTRAZENECA,4686,4103,583
Buerarema,290470,BA,Nordeste,PFIZER/BIONTECH,231,230,1
Bugre,310925,MG,Sudeste,FIOCRUZ/ASTRAZENECA,1192,1086,106
Bugre,310925,MG,Sudeste,BUTANTAN/SINOVAC,940,507,433
Bugre,310925,MG,Sudeste,PFIZER/BIONTECH,18,18,0
Buíque,260280,PE,Nordeste,FIOCRUZ/ASTRAZENECA,11635,10811,824
Buíque,260280,PE,Nordeste,BUTANTAN/SINOVAC,11525,5980,5545
Buíque,260280,PE,Nordeste,PFIZER/BIONTECH,637,637,0
Bujari,120013,AC,Norte,FIOCRUZ/ASTRAZENECA,2853,2520,333
Bujari,120013,AC,Norte,BUTANTAN/SINOVAC,904,466,438
Bujari,120013,AC,Norte,PFIZER/BIONTECH,128,128,0
Bujaru,150190,PA,Norte,FIOCRUZ/ASTRAZENECA,4322,3630,692
Bujaru,150190,PA,Norte,BUTANTAN/SINOVAC,1955,1013,942
Buri,350800,SP,Sudeste,FIOCRUZ/ASTRAZENECA,3862,3540,322
Buri,350800,SP,Sudeste,BUTANTAN/SINOVAC,3576,1869,1707
Buri,350800,SP,Sudeste,PFIZER/BIONTECH,302,302,0
Buritama,350810,SP,Sudeste,FIOCRUZ/ASTRAZENECA,4678,4394,284
Buritama,350810,SP,Sudeste,BUTANTAN/SINOVAC,4362,2406,1956
Buritama,350810,SP,Sudeste,PFIZER/BIONTECH,584,583,1
Buriti,210220,MA,Nordeste,FIOCRUZ/ASTRAZENECA,5186,4912,274
Buriti,210220,MA,Nordeste,BUTANTAN/SINOVAC,4235,2275,1960
Buriti Alegre,520390,GO,Centro-Oeste,FIOCRUZ/ASTRAZENECA,2660,2514,146
Buriti Alegre,520390,GO,Centro-Oeste,BUTANTAN/SINOVAC,2033,1023,1010
Buriti Alegre,520390,GO,Centro-Oeste,PFIZER/BIONTECH,135,135,0
Buriti Bravo,210230,MA,Nordeste,FIOCRUZ/ASTRAZENECA,4771,4513,258
Buriti Bravo,210230,MA,Nordeste,BUTANTAN/SINOVAC,3902,2189,1713
Buriti De Goiás,520393,GO,Centro-Oeste,FIOCRUZ/ASTRAZENECA,788,744,44
Buriti De Goiás,520393,GO,Centro-Oeste,BUTANTAN/SINOVAC,577,293,284
Buriti De Goiás,520393,GO,Centro-Oeste,PFIZER/BIONTECH,30,30,0
Buriti Do Tocantins,170380,TO,Norte,BUTANTAN/SINOVAC,1657,819,838
Buriti Do Tocantins,170380,TO,Norte,FIOCRUZ/ASTRAZENECA,1032,960,72
Buriti Dos Lopes,220200,PI,Nordeste,BUTANTAN/SINOVAC,3714,2257,1457
Buriti Dos Lopes,220200,PI,Nordeste,FIOCRUZ/ASTRAZENECA,2812,2600,212
Buriti Dos Montes,220202,PI,Nordeste,BUTANTAN/SINOVAC,1290,732,558
Buriti Dos Montes,220202,PI,Nordeste,FIOCRUZ/ASTRAZENECA,181,180,1
Buriticupu,210232,MA,Nordeste,FIOCRUZ/ASTRAZENECA,8138,7561,577
Buriticupu,210232,MA,Nordeste,BUTANTAN/SINOVAC,6900,3580,3320
Buritinópolis,520396,GO,Centro-Oeste,FIOCRUZ/ASTRAZENECA,909,838,71
Buritinópolis,520396,GO,Centro-Oeste,BUTANTAN/SINOVAC,436,212,224
Buritirama,290475,BA,Nordeste,FIOCRUZ/ASTRAZENECA,4119,3978,141
Buritirama,290475,BA,Nordeste,BUTANTAN/SINOVAC,3084,1578,1506
Buritirama,290475,BA,Nordeste,PFIZER/BIONTECH,51,51,0
Buritirana,210235,MA,Nordeste,FIOCRUZ/ASTRAZENECA,2261,2066,195
Buritirana,210235,MA,Nordeste,BUTANTAN/SINOVAC,2199,1139,1060
Buritis,110045,RO,Norte,BUTANTAN/SINOVAC,6129,3165,2964
Buritis,110045,RO,Norte,FIOCRUZ/ASTRAZENECA,3198,2989,209
Buritis,110045,RO,Norte,PFIZER/BIONTECH,186,186,0
Buritis,310930,MG,Sudeste,BUTANTAN/SINOVAC,4619,2604,2015
Buritis,310930,MG,Sudeste,FIOCRUZ/ASTRAZENECA,2144,1837,307
Buritis,310930,MG,Sudeste,PFIZER/BIONTECH,20,20,0
Buritizal,350820,SP,Sudeste,BUTANTAN/SINOVAC,1295,706,589
Buritizal,350820,SP,Sudeste,FIOCRUZ/ASTRAZENECA,1150,1034,116
Buritizal,350820,SP,Sudeste,PFIZER/BIONTECH,56,56,0
Buritizeiro,310940,MG,Sudeste,FIOCRUZ/ASTRAZENECA,3803,3623,180
Buritizeiro,310940,MG,Sudeste,BUTANTAN/SINOVAC,3746,1933,1813
Buritizeiro,310940,MG,Sudeste,PFIZER/BIONTECH,385,385,0
Butiá,430270,RS,Sul,FIOCRUZ/ASTRAZENECA,5796,5439,357
Butiá,430270,RS,Sul,BUTANTAN/SINOVAC,4621,2364,2257
Butiá,430270,RS,Sul,PFIZER/BIONTECH,657,657,0
Caapiranga,130083,AM,Norte,FIOCRUZ/ASTRAZENECA,3540,3100,440
Caapiranga,130083,AM,Norte,BUTANTAN/SINOVAC,1150,666,484
Caaporã,250300,PB,Nordeste,FIOCRUZ/ASTRAZENECA,2716,2585,131
Caaporã,250300,PB,Nordeste,BUTANTAN/SINOVAC,2522,1305,1217
Caaporã,250300,PB,Nordeste,PFIZER/BIONTECH,125,125,0
Caarapó,500240,MS,Centro-Oeste,BUTANTAN/SINOVAC,11675,5987,5688
Caarapó,500240,MS,Centro-Oeste,FIOCRUZ/ASTRAZENECA,5595,5187,408
Caarapó,500240,MS,Centro-Oeste,PFIZER/BIONTECH,900,900,0
Caatiba,290480,BA,Nordeste,FIOCRUZ/ASTRAZENECA,1584,1504,80
Caatiba,290480,BA,Nordeste,BUTANTAN/SINOVAC,1518,796,722
Caatiba,290480,BA,Nordeste,PFIZER/BIONTECH,69,69,0
Cabaceiras,250310,PB,Nordeste,BUTANTAN/SINOVAC,1447,741,706
Cabaceiras,250310,PB,Nordeste,FIOCRUZ/ASTRAZENECA,1156,1040,116
Cabaceiras,250310,PB,Nordeste,PFIZER/BIONTECH,119,119,0
Cabaceiras Do Paraguaçu,290485,BA,Nordeste,FIOCRUZ/ASTRAZENECA,2995,2825,170
Cabaceiras Do Paraguaçu,290485,BA,Nordeste,BUTANTAN/SINOVAC,2725,1393,1332
Cabaceiras Do Paraguaçu,290485,BA,Nordeste,PFIZER/BIONTECH,343,343,0
Cabeceira Grande,310945,MG,Sudeste,BUTANTAN/SINOVAC,1301,658,643
Cabeceira Grande,310945,MG,Sudeste,FIOCRUZ/ASTRAZENECA,1198,1126,72
Cabeceira Grande,310945,MG,Sudeste,PFIZER/BIONTECH,60,60,0
Cabeceiras,520400,GO,Centro-Oeste,FIOCRUZ/ASTRAZENECA,2153,1892,261
Cabeceiras,520400,GO,Centro-Oeste,BUTANTAN/SINOVAC,787,407,380
Cabeceiras,520400,GO,Centro-Oeste,PFIZER/BIONTECH,115,115,0
Cabeceiras Do Piauí,220205,PI,Nordeste,FIOCRUZ/ASTRAZENECA,1678,1547,131
Cabeceiras Do Piauí,220205,PI,Nordeste,BUTANTAN/SINOVAC,1539,794,745
Cabedelo,250320,PB,Nordeste,BUTANTAN/SINOVAC,12834,6715,6119
Cabedelo,250320,PB,Nordeste,FIOCRUZ/ASTRAZENECA,12297,11266,1031
Cabedelo,250320,PB,Nordeste,PFIZER/BIONTECH,3560,3559,1
Cabixi,110003,RO,Norte,BUTANTAN/SINOVAC,1642,916,726
Cabixi,110003,RO,Norte,FIOCRUZ/ASTRAZENECA,1281,1232,49
Cabixi,110003,RO,Norte,PFIZER/BIONTECH,120,120,0
Cabo De Santo Agostinho,260290,PE,Nordeste,FIOCRUZ/ASTRAZENECA,52199,49408,2791
Cabo De Santo Agostinho,260290,PE,Nordeste,BUTANTAN/SINOVAC,30217,15750,14467
Cabo De Santo Agostinho,260290,PE,Nordeste,PFIZER/BIONTECH,3494,3484,10
Cabo Frio,330070,RJ,Sudeste,BUTANTAN/SINOVAC,42939,22280,20659
Cabo Frio,330070,RJ,Sudeste,FIOCRUZ/ASTRAZENECA,40985,37471,3514
Cabo Frio,330070,RJ,Sudeste,PFIZER/BIONTECH,7408,7400,8
Cabo Verde,310950,MG,Sudeste,FIOCRUZ/ASTRAZENECA,3442,3222,220
Cabo Verde,310950,MG,Sudeste,BUTANTAN/SINOVAC,2473,1279,1194
Cabo Verde,310950,MG,Sudeste,PFIZER/BIONTECH,184,184,0
Cabrália Paulista,350830,SP,Sudeste,BUTANTAN/SINOVAC,1088,573,515
Cabrália Paulista,350830,SP,Sudeste,FIOCRUZ/ASTRAZENECA,941,875,66
Cabrália Paulista,350830,SP,Sudeste,PFIZER/BIONTECH,97,97,0
Cabreúva,350840,SP,Sudeste,BUTANTAN/SINOVAC,7452,4263,3189
Cabreúva,350840,SP,Sudeste,FIOCRUZ/ASTRAZENECA,6415,6064,351
Cabreúva,350840,SP,Sudeste,PFIZER/BIONTECH,1127,1121,6
Cabrobó,260300,PE,Nordeste,BUTANTAN/SINOVAC,10339,5387,4952
Cabrobó,260300,PE,Nordeste,FIOCRUZ/ASTRAZENECA,8931,8416,515
Cabrobó,260300,PE,Nordeste,PFIZER/BIONTECH,292,292,0
Caçador,420300,SC,Sul,FIOCRUZ/ASTRAZENECA,13855,13084,771
Caçador,420300,SC,Sul,BUTANTAN/SINOVAC,11817,6692,5125
Caçador,420300,SC,Sul,PFIZER/BIONTECH,1586,1584,2
Caçapava,350850,SP,Sudeste,BUTANTAN/SINOVAC,21295,11356,9939
Caçapava,350850,SP,Sudeste,FIOCRUZ/ASTRAZENECA,17393,15711,1682
Caçapava,350850,SP,Sudeste,PFIZER/BIONTECH,488,483,5
Caçapava Do Sul,430280,RS,Sul,FIOCRUZ/ASTRAZENECA,9607,8554,1053
Caçapava Do Sul,430280,RS,Sul,BUTANTAN/SINOVAC,9601,4895,4706
Caçapava Do Sul,430280,RS,Sul,PFIZER/BIONTECH,1208,1208,0
Cacaulândia,110060,RO,Norte,BUTANTAN/SINOVAC,1158,615,543
Cacaulândia,110060,RO,Norte,FIOCRUZ/ASTRAZENECA,813,775,38
Cacequi,430290,RS,Sul,FIOCRUZ/ASTRAZENECA,3723,3569,154
Cacequi,430290,RS,Sul,BUTANTAN/SINOVAC,2712,1353,1359
Cacequi,430290,RS,Sul,PFIZER/BIONTECH,335,334,1
Cáceres,510250,MT,Centro-Oeste,FIOCRUZ/ASTRAZENECA,18529,18156,373
Cáceres,510250,MT,Centro-Oeste,BUTANTAN/SINOVAC,15047,8218,6829
Cáceres,510250,MT,Centro-Oeste,PFIZER/BIONTECH,152,152,0
Cachoeira,290490,BA,Nordeste,FIOCRUZ/ASTRAZENECA,8909,7464,1445
Cachoeira,290490,BA,Nordeste,BUTANTAN/SINOVAC,5195,2718,2477
Cachoeira,290490,BA,Nordeste,PFIZER/BIONTECH,558,557,1
Cachoeira Alta,520410,GO,Centro-Oeste,FIOCRUZ/ASTRAZENECA,3062,2866,196
Cachoeira Alta,520410,GO,Centro-Oeste,BUTANTAN/SINOVAC,1994,1026,968
Cachoeira Da Prata,310960,MG,Sudeste,BUTANTAN/SINOVAC,1035,524,511
Cachoeira Da Prata,310960,MG,Sudeste,FIOCRUZ/ASTRAZENECA,923,814,109
Cachoeira Da Prata,310960,MG,Sudeste,PFIZER/BIONTECH,89,89,0
Cachoeira De Goiás,520420,GO,Centro-Oeste,FIOCRUZ/ASTRAZENECA,607,564,43
Cachoeira De Goiás,520420,GO,Centro-Oeste,BUTANTAN/SINOVAC,315,174,141
Cachoeira De Goiás,520420,GO,Centro-Oeste,PFIZER/BIONTECH,1,1,0
Cachoeira De Minas,310970,MG,Sudeste,BUTANTAN/SINOVAC,2732,1375,1357
Cachoeira De Minas,310970,MG,Sudeste,FIOCRUZ/ASTRAZENECA,2571,2314,257
Cachoeira De Minas,310970,MG,Sudeste,PFIZER/BIONTECH,45,45,0
Cachoeira De Pajeú,310270,MG,Sudeste,BUTANTAN/SINOVAC,1933,1009,924
Cachoeira De Pajeú,310270,MG,Sudeste,FIOCRUZ/ASTRAZENECA,1533,1385,148
Cachoeira De Pajeú,310270,MG,Sudeste,PFIZER/BIONTECH,137,137,0
Cachoeira Do Arari,150200,PA,Norte,FIOCRUZ/ASTRAZENECA,3685,3469,216
Cachoeira Do Arari,150200,PA,Norte,BUTANTAN/SINOVAC,1107,585,522
Cachoeira Do Piriá,150195,PA,Norte,BUTANTAN/SINOVAC,3067,1779,1288
Cachoeira Do Piriá,150195,PA,Norte,FIOCRUZ/ASTRAZENECA,3009,2663,346
Cachoeira Do Sul,430300,RS,Sul,BUTANTAN/SINOVAC,25923,13386,12537
Cachoeira Do Sul,430300,RS,Sul,FIOCRUZ/ASTRAZENECA,22099,19007,3092
Cachoeira Do Sul,430300,RS,Sul,PFIZER/BIONTECH,3291,3281,10
Cachoeira Dos Índios,250330,PB,Nordeste,BUTANTAN/SINOVAC,2439,1230,1209
Cachoeira Dos Índios,250330,PB,Nordeste,FIOCRUZ/ASTRAZENECA,1833,1659,174
Cachoeira Dos Índios,250330,PB,Nordeste,PFIZER/BIONTECH,132,131,1
Cachoeira Dourada,310980,MG,Sudeste,BUTANTAN/SINOVAC,696,331,365
Cachoeira Dourada,310980,MG,Sudeste,FIOCRUZ/ASTRAZENECA,440,375,65
Cachoeira Dourada,520425,GO,Centro-Oeste,FIOCRUZ/ASTRAZENECA,2369,2212,157
Cachoeira Dourada,520425,GO,Centro-Oeste,BUTANTAN/SINOVAC,1958,1000,958
Cachoeira Grande,210237,MA,Nordeste,FIOCRUZ/ASTRAZENECA,2537,2446,91
Cachoeira Grande,210237,MA,Nordeste,BUTANTAN/SINOVAC,1060,580,480
Cachoeira Paulista,350860,SP,Sudeste,BUTANTAN/SINOVAC,8080,4364,3716
Cachoeira Paulista,350860,SP,Sudeste,FIOCRUZ/ASTRAZENECA,5904,5274,630
Cachoeira Paulista,350860,SP,Sudeste,PFIZER/BIONTECH,602,601,1
Cachoeiras De Macacu,330080,RJ,Sudeste,BUTANTAN/SINOVAC,12570,6573,5997
Cachoeiras De Macacu,330080,RJ,Sudeste,FIOCRUZ/ASTRAZENECA,9818,8879,939
Cachoeiras De Macacu,330080,RJ,Sudeste,PFIZER/BIONTECH,49,49,0
Cachoeirinha,170382,TO,Norte,BUTANTAN/SINOVAC,404,207,197
Cachoeirinha,170382,TO,Norte,FIOCRUZ/ASTRAZENECA,273,262,11
Cachoeirinha,260310,PE,Nordeste,FIOCRUZ/ASTRAZENECA,3720,3368,352
Cachoeirinha,260310,PE,Nordeste,BUTANTAN/SINOVAC,3637,1990,1647
Cachoeirinha,260310,PE,Nordeste,PFIZER/BIONTECH,198,197,1
Cachoeirinha,430310,RS,Sul,BUTANTAN/SINOVAC,33606,17418,16188
Cachoeirinha,430310,RS,Sul,FIOCRUZ/ASTRAZENECA,29109,27290,1819
Cachoeirinha,430310,RS,Sul,PFIZER/BIONTECH,2156,1895,261
Cachoeiro De Itapemirim,320120,ES,Sudeste,FIOCRUZ/ASTRAZENECA,52022,47678,4344
Cachoeiro De Itapemirim,320120,ES,Sudeste,BUTANTAN/SINOVAC,47283,24299,22984
Cachoeiro De Itapemirim,320120,ES,Sudeste,PFIZER/BIONTECH,4509,4500,9
Cacimba De Areia,250340,PB,Nordeste,BUTANTAN/SINOVAC,858,439,419
Cacimba De Areia,250340,PB,Nordeste,FIOCRUZ/ASTRAZENECA,502,462,40
Cacimba De Dentro,250350,PB,Nordeste,BUTANTAN/SINOVAC,4221,2142,2079
Cacimba De Dentro,250350,PB,Nordeste,FIOCRUZ/ASTRAZENECA,3058,2744,314
Cacimba De Dentro,250350,PB,Nordeste,PFIZER/BIONTECH,278,278,0
Cacimbas,250355,PB,Nordeste,FIOCRUZ/ASTRAZENECA,1591,1497,94
Cacimbas,250355,PB,Nordeste,BUTANTAN/SINOVAC,1156,599,557
Cacimbas,250355,PB,Nordeste,PFIZER/BIONTECH,84,84,0
Cacimbinhas,270120,AL,Nordeste,FIOCRUZ/ASTRAZENECA,2684,2339,345
Cacimbinhas,270120,AL,Nordeste,BUTANTAN/SINOVAC,1959,1047,912
Cacique Doble,430320,RS,Sul,BUTANTAN/SINOVAC,3109,1401,1708
Cacique Doble,430320,RS,Sul,FIOCRUZ/ASTRAZENECA,2191,1910,281
Cacique Doble,430320,RS,Sul,PFIZER/BIONTECH,205,205,0
Cacoal,110004,RO,Norte,BUTANTAN/SINOVAC,21643,12717,8926
Cacoal,110004,RO,Norte,FIOCRUZ/ASTRAZENECA,20684,19435,1249
Cacoal,110004,RO,Norte,PFIZER/BIONTECH,2511,2510,1
Caconde,350870,SP,Sudeste,BUTANTAN/SINOVAC,4487,2338,2149
Caconde,350870,SP,Sudeste,FIOCRUZ/ASTRAZENECA,3928,3473,455
Caconde,350870,SP,Sudeste,PFIZER/BIONTECH,226,226,0
Caçu,520430,GO,Centro-Oeste,FIOCRUZ/ASTRAZENECA,3308,3021,287
Caçu,520430,GO,Centro-Oeste,BUTANTAN/SINOVAC,3129,1574,1555
Caçu,520430,GO,Centro-Oeste,PFIZER/BIONTECH,214,214,0
Caculé,290500,BA,Nordeste,FIOCRUZ/ASTRAZENECA,6689,6091,598
Caculé,290500,BA,Nordeste,BUTANTAN/SINOVAC,6373,3475,2898
Caculé,290500,BA,Nordeste,PFIZER/BIONTECH,491,491,0
Caém,290510,BA,Nordeste,FIOCRUZ/ASTRAZENECA,1841,1657,184
Caém,290510,BA,Nordeste,BUTANTAN/SINOVAC,1427,765,662
Caém,290510,BA,Nordeste,PFIZER/BIONTECH,11,11,0
Caetanópolis,310990,MG,Sudeste,BUTANTAN/SINOVAC,2364,1206,1158
Caetanópolis,310990,MG,Sudeste,FIOCRUZ/ASTRAZENECA,2212,1993,219
Caetanópolis,310990,MG,Sudeste,PFIZER/BIONTECH,162,161,1
Caetanos,290515,BA,Nordeste,BUTANTAN/SINOVAC,2770,1545,1225
Caetanos,290515,BA,Nordeste,FIOCRUZ/ASTRAZENECA,2301,2064,237
Caetanos,290515,BA,Nordeste,PFIZER/BIONTECH,78,76,2
Caeté,311000,MG,Sudeste,BUTANTAN/SINOVAC,8857,4703,4154
Caeté,311000,MG,Sudeste,FIOCRUZ/ASTRAZENECA,7527,6907,620
Caeté,311000,MG,Sudeste,PFIZER/BIONTECH,431,431,0
Caetés,260320,PE,Nordeste,FIOCRUZ/ASTRAZENECA,5629,5219,410
Caetés,260320,PE,Nordeste,BUTANTAN/SINOVAC,5249,2901,2348
Caetés,260320,PE,Nordeste,PFIZER/BIONTECH,217,217,0
Caetité,290520,BA,Nordeste,BUTANTAN/SINOVAC,8060,4609,3451
Caetité,290520,BA,Nordeste,FIOCRUZ/ASTRAZENECA,5348,4718,630
Caetité,290520,BA,Nordeste,PFIZER/BIONTECH,57,57,0
Cafarnaum,290530,BA,Nordeste,FIOCRUZ/ASTRAZENECA,4175,3652,523
Cafarnaum,290530,BA,Nordeste,BUTANTAN/SINOVAC,2926,1521,1405
Cafarnaum,290530,BA,Nordeste,PFIZER/BIONTECH,424,424,0
Cafeara,410340,PR,Sul,FIOCRUZ/ASTRAZENECA,828,768,60
Cafeara,410340,PR,Sul,BUTANTAN/SINOVAC,673,354,319
Cafeara,410340,PR,Sul,PFIZER/BIONTECH,18,18,0
Cafelândia,350880,SP,Sudeste,FIOCRUZ/ASTRAZENECA,4838,4413,425
Cafelândia,350880,SP,Sudeste,BUTANTAN/SINOVAC,4768,2698,2070
Cafelândia,350880,SP,Sudeste,PFIZER/BIONTECH,460,459,1
Cafelândia,410345,PR,Sul,FIOCRUZ/ASTRAZENECA,4011,3719,292
Cafelândia,410345,PR,Sul,BUTANTAN/SINOVAC,2678,1430,1248
Cafelândia,410345,PR,Sul,PFIZER/BIONTECH,426,426,0
Cafezal Do Sul,410347,PR,Sul,FIOCRUZ/ASTRAZENECA,1162,1062,100
Cafezal Do Sul,410347,PR,Sul,BUTANTAN/SINOVAC,1070,571,499
Cafezal Do Sul,410347,PR,Sul,PFIZER/BIONTECH,16,16,0
Caiabu,350890,SP,Sudeste,BUTANTAN/SINOVAC,1450,812,638
Caiabu,350890,SP,Sudeste,FIOCRUZ/ASTRAZENECA,1438,1321,117
Caiabu,350890,SP,Sudeste,PFIZER/BIONTECH,122,122,0
Caiana,311010,MG,Sudeste,FIOCRUZ/ASTRAZENECA,1077,1017,60
Caiana,311010,MG,Sudeste,BUTANTAN/SINOVAC,943,493,450
Caiana,311010,MG,Sudeste,PFIZER/BIONTECH,46,46,0
Caiapônia,520440,GO,Centro-Oeste,FIOCRUZ/ASTRAZENECA,4384,4152,232
Caiapônia,520440,GO,Centro-Oeste,BUTANTAN/SINOVAC,3626,1874,1752
Caiapônia,520440,GO,Centro-Oeste,PFIZER/BIONTECH,299,299,0
Caibaté,430330,RS,Sul,BUTANTAN/SINOVAC,1746,881,865
Caibaté,430330,RS,Sul,FIOCRUZ/ASTRAZENECA,1603,1403,200
Caibaté,430330,RS,Sul,PFIZER/BIONTECH,213,213,0
Caibi,420310,SC,Sul,BUTANTAN/SINOVAC,1834,971,863
Caibi,420310,SC,Sul,FIOCRUZ/ASTRAZENECA,1599,1484,115
Caibi,420310,SC,Sul,PFIZER/BIONTECH,90,90,0
Caiçara,250360,PB,Nordeste,BUTANTAN/SINOVAC,1507,791,716
Caiçara,250360,PB,Nordeste,FIOCRUZ/ASTRAZENECA,1181,1093,88
Caiçara,250360,PB,Nordeste,PFIZER/BIONTECH,183,183,0
Caiçara,430340,RS,Sul,BUTANTAN/SINOVAC,1691,851,840
Caiçara,430340,RS,Sul,FIOCRUZ/ASTRAZENECA,1483,1351,132
Caiçara,430340,RS,Sul,PFIZER/BIONTECH,138,138,0
Caiçara Do Norte,240185,RN,Nordeste,FIOCRUZ/ASTRAZENECA,1024,970,54
Caiçara Do Norte,240185,RN,Nordeste,BUTANTAN/SINOVAC,964,486,478
Caiçara Do Norte,240185,RN,Nordeste,PFIZER/BIONTECH,61,61,0
Caiçara Do Rio Do Vento,240190,RN,Nordeste,BUTANTAN/SINOVAC,807,406,401
Caiçara Do Rio Do Vento,240190,RN,Nordeste,FIOCRUZ/ASTRAZENECA,625,593,32
Caiçara Do Rio Do Vento,240190,RN,Nordeste,PFIZER/BIONTECH,100,100,0
Caicó,240200,RN,Nordeste,FIOCRUZ/ASTRAZENECA,16221,14746,1475
Caicó,240200,RN,Nordeste,BUTANTAN/SINOVAC,15109,7756,7353
Caicó,240200,RN,Nordeste,PFIZER/BIONTECH,2558,2555,3
Caieiras,350900,SP,Sudeste,FIOCRUZ/ASTRAZENECA,19098,18026,1072
Caieiras,350900,SP,Sudeste,BUTANTAN/SINOVAC,17440,9965,7475
Caieiras,350900,SP,Sudeste,PFIZER/BIONTECH,1399,1398,1
Cairu,290540,BA,Nordeste,FIOCRUZ/ASTRAZENECA,6228,5655,573
Cairu,290540,BA,Nordeste,BUTANTAN/SINOVAC,1874,983,891
Cairu,290540,BA,Nordeste,PFIZER/BIONTECH,122,122,0
Caiuá,350910,SP,Sudeste,BUTANTAN/SINOVAC,2206,1150,1056
Caiuá,350910,SP,Sudeste,FIOCRUZ/ASTRAZENECA,1499,1394,105
Caiuá,350910,SP,Sudeste,PFIZER/BIONTECH,48,48,0
Cajamar,350920,SP,Sudeste,FIOCRUZ/ASTRAZENECA,15515,14761,754
Cajamar,350920,SP,Sudeste,BUTANTAN/SINOVAC,12881,7267,5614
Cajamar,350920,SP,Sudeste,PFIZER/BIONTECH,1645,1644,1
Cajapió,210240,MA,Nordeste,FIOCRUZ/ASTRAZENECA,2922,2323,599
Cajapió,210240,MA,Nordeste,BUTANTAN/SINOVAC,1665,856,809
Cajari,210250,MA,Nordeste,FIOCRUZ/ASTRAZENECA,7438,6581,857
Cajari,210250,MA,Nordeste,BUTANTAN/SINOVAC,2027,1102,925
Cajati,350925,SP,Sudeste,BUTANTAN/SINOVAC,7871,4171,3700
Cajati,350925,SP,Sudeste,FIOCRUZ/ASTRAZENECA,6629,6196,433
Cajati,350925,SP,Sudeste,PFIZER/BIONTECH,426,425,1
Cajazeiras,250370,PB,Nordeste,BUTANTAN/SINOVAC,15664,8128,7536
Cajazeiras,250370,PB,Nordeste,FIOCRUZ/ASTRAZENECA,11423,10300,1123
Cajazeiras,250370,PB,Nordeste,PFIZER/BIONTECH,1709,1706,3
Cajazeiras Do Piauí,220207,PI,Nordeste,BUTANTAN/SINOVAC,736,381,355
Cajazeiras Do Piauí,220207,PI,Nordeste,FIOCRUZ/ASTRAZENECA,644,594,50
Cajazeirinhas,250375,PB,Nordeste,BUTANTAN/SINOVAC,849,443,406
Cajazeirinhas,250375,PB,Nordeste,FIOCRUZ/ASTRAZENECA,792,746,46
Cajazeirinhas,250375,PB,Nordeste,PFIZER/BIONTECH,32,32,0
Cajobi,350930,SP,Sudeste,BUTANTAN/SINOVAC,3182,1703,1479
Cajobi,350930,SP,Sudeste,FIOCRUZ/ASTRAZENECA,2677,2530,147
Cajobi,350930,SP,Sudeste,PFIZER/BIONTECH,142,142,0
Cajueiro,270130,AL,Nordeste,FIOCRUZ/ASTRAZENECA,3186,2921,265
Cajueiro,270130,AL,Nordeste,BUTANTAN/SINOVAC,2405,1278,1127
Cajueiro Da Praia,220208,PI,Nordeste,FIOCRUZ/ASTRAZENECA,994,967,27
Cajueiro Da Praia,220208,PI,Nordeste,BUTANTAN/SINOVAC,928,515,413
Cajuri,311020,MG,Sudeste,BUTANTAN/SINOVAC,1684,880,804
Cajuri,311020,MG,Sudeste,FIOCRUZ/ASTRAZENECA,895,803,92
Cajuru,350940,SP,Sudeste,FIOCRUZ/ASTRAZENECA,5958,5418,540
Cajuru,350940,SP,Sudeste,BUTANTAN/SINOVAC,5862,3237,2625
Cajuru,350940,SP,Sudeste,PFIZER/BIONTECH,371,371,0
Calçado,260330,PE,Nordeste,FIOCRUZ/ASTRAZENECA,2224,2004,220
Calçado,260330,PE,Nordeste,BUTANTAN/SINOVAC,1878,972,906
Calçado,260330,PE,Nordeste,PFIZER/BIONTECH,257,257,0
Calçoene,160020,AP,Norte,BUTANTAN/SINOVAC,1177,591,586
Calçoene,160020,AP,Norte,FIOCRUZ/ASTRAZENECA,1152,1111,41
Calçoene,160020,AP,Norte,PFIZER/BIONTECH,72,72,0
Caldas,311030,MG,Sudeste,BUTANTAN/SINOVAC,3954,2000,1954
Caldas,311030,MG,Sudeste,FIOCRUZ/ASTRAZENECA,3007,2771,236
Caldas,311030,MG,Sudeste,PFIZER/BIONTECH,50,50,0
Caldas Brandão,250380,PB,Nordeste,BUTANTAN/SINOVAC,1332,669,663
Caldas Brandão,250380,PB,Nordeste,FIOCRUZ/ASTRAZENECA,1201,1099,102
Caldas Brandão,250380,PB,Nordeste,PFIZER/BIONTECH,120,120,0
Caldas Novas,520450,GO,Centro-Oeste,FIOCRUZ/ASTRAZENECA,25068,23538,1530
Caldas Novas,520450,GO,Centro-Oeste,BUTANTAN/SINOVAC,12209,6301,5908
Caldas Novas,520450,GO,Centro-Oeste,PFIZER/BIONTECH,1105,1103,2
Caldazinha,520455,GO,Centro-Oeste,FIOCRUZ/ASTRAZENECA,1133,1069,64
Caldazinha,520455,GO,Centro-Oeste,BUTANTAN/SINOVAC,853,472,381
Caldeirão Grande,290550,BA,Nordeste,FIOCRUZ/ASTRAZENECA,3237,2795,442
Caldeirão Grande,290550,BA,Nordeste,BUTANTAN/SINOVAC,2629,1412,1217
Caldeirão Grande,290550,BA,Nordeste,PFIZER/BIONTECH,327,327,0
Caldeirão Grande Do Piauí,220209,PI,Nordeste,BUTANTAN/SINOVAC,919,470,449
Caldeirão Grande Do Piauí,220209,PI,Nordeste,FIOCRUZ/ASTRAZENECA,864,795,69
Caldeirão Grande Do Piauí,220209,PI,Nordeste,PFIZER/BIONTECH,143,143,0
Califórnia,410350,PR,Sul,FIOCRUZ/ASTRAZENECA,2951,2807,144
Califórnia,410350,PR,Sul,BUTANTAN/SINOVAC,2220,1126,1094
Calmon,420315,SC,Sul,FIOCRUZ/ASTRAZENECA,535,497,38
Calmon,420315,SC,Sul,BUTANTAN/SINOVAC,449,225,224
Calumbi,260340,PE,Nordeste,FIOCRUZ/ASTRAZENECA,1424,1314,110
Calumbi,260340,PE,Nordeste,BUTANTAN/SINOVAC,1247,636,611
Calumbi,260340,PE,Nordeste,PFIZER/BIONTECH,220,220,0
Camacan,290560,BA,Nordeste,FIOCRUZ/ASTRAZENECA,4420,4112,308
Camacan,290560,BA,Nordeste,BUTANTAN/SINOVAC,3297,2340,957
Camacan,290560,BA,Nordeste,PFIZER/BIONTECH,400,400,0
Camaçari,290570,BA,Nordeste,FIOCRUZ/ASTRAZENECA,33740,29223,4517
Camaçari,290570,BA,Nordeste,BUTANTAN/SINOVAC,29857,15814,14043
Camaçari,290570,BA,Nordeste,PFIZER/BIONTECH,9372,9358,14
Camacho,311040,MG,Sudeste,BUTANTAN/SINOVAC,771,386,385
Camacho,311040,MG,Sudeste,FIOCRUZ/ASTRAZENECA,705,627,78
Camacho,311040,MG,Sudeste,PFIZER/BIONTECH,100,100,0
Camalaú,250390,PB,Nordeste,BUTANTAN/SINOVAC,1373,696,677
Camalaú,250390,PB,Nordeste,FIOCRUZ/ASTRAZENECA,1175,1045,130
Camalaú,250390,PB,Nordeste,PFIZER/BIONTECH,65,65,0
Camamu,290580,BA,Nordeste,FIOCRUZ/ASTRAZENECA,5989,5799,190
Camamu,290580,BA,Nordeste,BUTANTAN/SINOVAC,4887,3016,1871
Camamu,290580,BA,Nordeste,PFIZER/BIONTECH,65,65,0
Camanducaia,311050,MG,Sudeste,BUTANTAN/SINOVAC,4318,2222,2096
Camanducaia,311050,MG,Sudeste,FIOCRUZ/ASTRAZENECA,2805,2688,117
Camapuã,500260,MS,Centro-Oeste,BUTANTAN/SINOVAC,3418,1739,1679
Camapuã,500260,MS,Centro-Oeste,FIOCRUZ/ASTRAZENECA,2670,2455,215
Camapuã,500260,MS,Centro-Oeste,PFIZER/BIONTECH,298,298,0
Camaquã,430350,RS,Sul,BUTANTAN/SINOVAC,17806,9016,8790
Camaquã,430350,RS,Sul,FIOCRUZ/ASTRAZENECA,15390,14091,1299
Camaquã,430350,RS,Sul,PFIZER/BIONTECH,1014,1014,0
Camaragibe,260345,PE,Nordeste,FIOCRUZ/ASTRAZENECA,25202,23824,1378
Camaragibe,260345,PE,Nordeste,BUTANTAN/SINOVAC,24396,12897,11499
Camaragibe,260345,PE,Nordeste,PFIZER/BIONTECH,648,646,2
Camargo,430355,RS,Sul,BUTANTAN/SINOVAC,904,484,420
Camargo,430355,RS,Sul,FIOCRUZ/ASTRAZENECA,762,638,124
Camargo,430355,RS,Sul,PFIZER/BIONTECH,116,116,0
Cambará,410360,PR,Sul,FIOCRUZ/ASTRAZENECA,5985,5651,334
Cambará,410360,PR,Sul,BUTANTAN/SINOVAC,5651,2965,2686
Cambará Do Sul,430360,RS,Sul,BUTANTAN/SINOVAC,2033,942,1091
Cambará Do Sul,430360,RS,Sul,FIOCRUZ/ASTRAZENECA,1615,1514,101
Cambará Do Sul,430360,RS,Sul,PFIZER/BIONTECH,157,157,0
Cambé,410370,PR,Sul,FIOCRUZ/ASTRAZENECA,24680,23034,1646
Cambé,410370,PR,Sul,BUTANTAN/SINOVAC,20456,10608,9848
Cambé,410370,PR,Sul,PFIZER/BIONTECH,1356,1356,0
Cambira,410380,PR,Sul,FIOCRUZ/ASTRAZENECA,2109,2057,52
Cambira,410380,PR,Sul,BUTANTAN/SINOVAC,1755,899,856
Cambira,410380,PR,Sul,PFIZER/BIONTECH,105,105,0
Camboriú,420320,SC,Sul,BUTANTAN/SINOVAC,12243,6546,5697
Camboriú,420320,SC,Sul,FIOCRUZ/ASTRAZENECA,10089,9653,436
Camboriú,420320,SC,Sul,PFIZER/BIONTECH,1383,1383,0
Cambuci,330090,RJ,Sudeste,BUTANTAN/SINOVAC,3891,2057,1834
Cambuci,330090,RJ,Sudeste,FIOCRUZ/ASTRAZENECA,2912,2680,232
Cambuí,311060,MG,Sudeste,BUTANTAN/SINOVAC,6603,3443,3160
Cambuí,311060,MG,Sudeste,FIOCRUZ/ASTRAZENECA,6009,5597,412
Cambuí,311060,MG,Sudeste,PFIZER/BIONTECH,324,324,0
Cambuquira,311070,MG,Sudeste,FIOCRUZ/ASTRAZENECA,3473,3097,376
Cambuquira,311070,MG,Sudeste,BUTANTAN/SINOVAC,3223,1628,1595
Cambuquira,311070,MG,Sudeste,PFIZER/BIONTECH,174,173,1
Cametá,150210,PA,Norte,FIOCRUZ/ASTRAZENECA,29889,25960,3929
Cametá,150210,PA,Norte,BUTANTAN/SINOVAC,12678,7120,5558
Camocim,230260,CE,Nordeste,BUTANTAN/SINOVAC,2835,2238,597
Camocim,230260,CE,Nordeste,FIOCRUZ/ASTRAZENECA,1527,1514,13
Camocim,230260,CE,Nordeste,PFIZER/BIONTECH,2,2,0
Camocim De São Félix,260350,PE,Nordeste,FIOCRUZ/ASTRAZENECA,3134,2836,298
Camocim De São Félix,260350,PE,Nordeste,BUTANTAN/SINOVAC,2650,1363,1287
Camocim De São Félix,260350,PE,Nordeste,PFIZER/BIONTECH,379,379,0
Campanário,311080,MG,Sudeste,BUTANTAN/SINOVAC,1064,545,519
Campanário,311080,MG,Sudeste,FIOCRUZ/ASTRAZENECA,577,526,51
Campanário,311080,MG,Sudeste,PFIZER/BIONTECH,52,52,0
Campanha,311090,MG,Sudeste,FIOCRUZ/ASTRAZENECA,4485,4144,341
Campanha,311090,MG,Sudeste,BUTANTAN/SINOVAC,3836,2002,1834
Campanha,311090,MG,Sudeste,PFIZER/BIONTECH,251,250,1
Campestre,270135,AL,Nordeste,FIOCRUZ/ASTRAZENECA,1124,994,130
Campestre,270135,AL,Nordeste,BUTANTAN/SINOVAC,985,527,458
Campestre,311100,MG,Sudeste,BUTANTAN/SINOVAC,4615,2336,2279
Campestre,311100,MG,Sudeste,FIOCRUZ/ASTRAZENECA,3671,3390,281
Campestre,311100,MG,Sudeste,PFIZER/BIONTECH,165,165,0
Campestre Da Serra,430367,RS,Sul,FIOCRUZ/ASTRAZENECA,1049,928,121
Campestre Da Serra,430367,RS,Sul,BUTANTAN/SINOVAC,993,505,488
Campestre Da Serra,430367,RS,Sul,PFIZER/BIONTECH,120,120,0
Campestre De Goiás,520460,GO,Centro-Oeste,BUTANTAN/SINOVAC,959,523,436
Campestre De Goiás,520460,GO,Centro-Oeste,FIOCRUZ/ASTRAZENECA,821,770,51
Campestre De Goiás,520460,GO,Centro-Oeste,PFIZER/BIONTECH,93,93,0
Campestre Do Maranhão,210255,MA,Nordeste,FIOCRUZ/ASTRAZENECA,2353,2226,127
Campestre Do Maranhão,210255,MA,Nordeste,BUTANTAN/SINOVAC,1855,1032,823
Campina Da Lagoa,410390,PR,Sul,FIOCRUZ/ASTRAZENECA,4874,4603,271
Campina Da Lagoa,410390,PR,Sul,BUTANTAN/SINOVAC,3173,1654,1519
Campina Da Lagoa,410390,PR,Sul,PFIZER/BIONTECH,186,186,0
Campina Das Missões,430370,RS,Sul,BUTANTAN/SINOVAC,2184,1098,1086
Campina Das Missões,430370,RS,Sul,FIOCRUZ/ASTRAZENECA,1766,1539,227
Campina Das Missões,430370,RS,Sul,PFIZER/BIONTECH,222,222,0
Campina Do Monte Alegre,350945,SP,Sudeste,BUTANTAN/SINOVAC,2539,1428,1111
Campina Do Monte Alegre,350945,SP,Sudeste,FIOCRUZ/ASTRAZENECA,2115,1933,182
Campina Do Monte Alegre,350945,SP,Sudeste,PFIZER/BIONTECH,146,146,0
Campina Do Simão,410395,PR,Sul,FIOCRUZ/ASTRAZENECA,1114,999,115
Campina Do Simão,410395,PR,Sul,BUTANTAN/SINOVAC,648,374,274
Campina Grande,250400,PB,Nordeste,BUTANTAN/SINOVAC,83510,46172,37338
Campina Grande,250400,PB,Nordeste,FIOCRUZ/ASTRAZENECA,60922,55899,5023
Campina Grande,250400,PB,Nordeste,PFIZER/BIONTECH,17355,17349,6
Campina Grande Do Sul,410400,PR,Sul,BUTANTAN/SINOVAC,10338,5356,4982
Campina Grande Do Sul,410400,PR,Sul,FIOCRUZ/ASTRAZENECA,8970,8789,181
Campina Grande Do Sul,410400,PR,Sul,PFIZER/BIONTECH,800,800,0
Campina Verde,311110,MG,Sudeste,BUTANTAN/SINOVAC,3427,2104,1323
Campina Verde,311110,MG,Sudeste,FIOCRUZ/ASTRAZENECA,1180,1046,134
Campinaçu,520465,GO,Centro-Oeste,FIOCRUZ/ASTRAZENECA,947,864,83
Campinaçu,520465,GO,Centro-Oeste,BUTANTAN/SINOVAC,609,318,291
Campinápolis,510260,MT,Centro-Oeste,BUTANTAN/SINOVAC,7937,4153,3784
Campinápolis,510260,MT,Centro-Oeste,FIOCRUZ/ASTRAZENECA,1214,1064,150
Campinápolis,510260,MT,Centro-Oeste,PFIZER/BIONTECH,364,364,0
Campinas,350950,SP,Sudeste,FIOCRUZ/ASTRAZENECA,338574,311190,27384
Campinas,350950,SP,Sudeste,BUTANTAN/SINOVAC,284596,147462,137134
Campinas,350950,SP,Sudeste,PFIZER/BIONTECH,17400,17369,31
Campinas Do Piauí,220210,PI,Nordeste,FIOCRUZ/ASTRAZENECA,2312,2238,74
Campinas Do Piauí,220210,PI,Nordeste,BUTANTAN/SINOVAC,900,474,426
Campinas Do Sul,430380,RS,Sul,BUTANTAN/SINOVAC,1946,980,966
Campinas Do Sul,430380,RS,Sul,FIOCRUZ/ASTRAZENECA,1559,1344,215
Campinas Do Sul,430380,RS,Sul,PFIZER/BIONTECH,210,210,0
Campinorte,520470,GO,Centro-Oeste,FIOCRUZ/ASTRAZENECA,3429,3256,173
Campinorte,520470,GO,Centro-Oeste,BUTANTAN/SINOVAC,1794,912,882
Campinorte,520470,GO,Centro-Oeste,PFIZER/BIONTECH,154,154,0
Campo Alegre,270140,AL,Nordeste,FIOCRUZ/ASTRAZENECA,7257,6805,452
Campo Alegre,270140,AL,Nordeste,BUTANTAN/SINOVAC,6083,3489,2594
Campo Alegre,420330,SC,Sul,FIOCRUZ/ASTRAZENECA,2743,2519,224
Campo Alegre,420330,SC,Sul,BUTANTAN/SINOVAC,2192,1167,1025
Campo Alegre,420330,SC,Sul,PFIZER/BIONTECH,135,135,0
Campo Alegre De Goiás,520480,GO,Centro-Oeste,FIOCRUZ/ASTRAZENECA,1901,1697,204
Campo Alegre De Goiás,520480,GO,Centro-Oeste,BUTANTAN/SINOVAC,844,421,423
Campo Alegre De Goiás,520480,GO,Centro-Oeste,PFIZER/BIONTECH,112,112,0
Campo Alegre De Lourdes,290590,BA,Nordeste,BUTANTAN/SINOVAC,4819,2497,2322
Campo Alegre De Lourdes,290590,BA,Nordeste,FIOCRUZ/ASTRAZENECA,4745,4263,482
Campo Alegre Do Fidalgo,220211,PI,Nordeste,FIOCRUZ/ASTRAZENECA,1333,1178,155
Campo Alegre Do Fidalgo,220211,PI,Nordeste,BUTANTAN/SINOVAC,834,429,405
Campo Alegre Do Fidalgo,220211,PI,Nordeste,PFIZER/BIONTECH,118,118,0
Campo Azul,311115,MG,Sudeste,BUTANTAN/SINOVAC,1355,791,564
Campo Azul,311115,MG,Sudeste,FIOCRUZ/ASTRAZENECA,954,853,101
Campo Azul,311115,MG,Sudeste,PFIZER/BIONTECH,49,49,0
Campo Belo,311120,MG,Sudeste,BUTANTAN/SINOVAC,12429,6346,6083
Campo Belo,311120,MG,Sudeste,FIOCRUZ/ASTRAZENECA,10093,9564,529
Campo Belo,311120,MG,Sudeste,PFIZER/BIONTECH,293,293,0
Campo Belo Do Sul,420340,SC,Sul,FIOCRUZ/ASTRAZENECA,2210,2038,172
Campo Belo Do Sul,420340,SC,Sul,BUTANTAN/SINOVAC,1497,798,699
Campo Belo Do Sul,420340,SC,Sul,PFIZER/BIONTECH,52,52,0
Campo Bom,430390,RS,Sul,FIOCRUZ/ASTRAZENECA,17193,15798,1395
Campo Bom,430390,RS,Sul,BUTANTAN/SINOVAC,13708,6925,6783
Campo Bom,430390,RS,Sul,PFIZER/BIONTECH,2417,2412,5
Campo Bonito,410405,PR,Sul,FIOCRUZ/ASTRAZENECA,932,866,66
Campo Bonito,410405,PR,Sul,BUTANTAN/SINOVAC,789,403,386
Campo Bonito,410405,PR,Sul,PFIZER/BIONTECH,22,22,0
Campo Do Brito,280100,SE,Nordeste,BUTANTAN/SINOVAC,4055,2070,1985
Campo Do Brito,280100,SE,Nordeste,FIOCRUZ/ASTRAZENECA,2850,2844,6
Campo Do Brito,280100,SE,Nordeste,PFIZER/BIONTECH,59,59,0
Campo Do Meio,311130,MG,Sudeste,FIOCRUZ/ASTRAZENECA,3723,3641,82
Campo Do Meio,311130,MG,Sudeste,BUTANTAN/SINOVAC,2469,1290,1179
Campo Do Meio,311130,MG,Sudeste,PFIZER/BIONTECH,271,271,0
Campo Do Tenente,410410,PR,Sul,FIOCRUZ/ASTRAZENECA,1467,1442,25
Campo Do Tenente,410410,PR,Sul,BUTANTAN/SINOVAC,963,522,441
Campo Erê,420350,SC,Sul,FIOCRUZ/ASTRAZENECA,2556,2342,214
Campo Erê,420350,SC,Sul,BUTANTAN/SINOVAC,2066,1138,928
Campo Erê,420350,SC,Sul,PFIZER/BIONTECH,92,92,0
Campo Florido,311140,MG,Sudeste,FIOCRUZ/ASTRAZENECA,1418,1308,110
Campo Florido,311140,MG,Sudeste,BUTANTAN/SINOVAC,1312,678,634
Campo Florido,311140,MG,Sudeste,PFIZER/BIONTECH,263,263,0
Campo Formoso,290600,BA,Nordeste,FIOCRUZ/ASTRAZENECA,16466,16157,309
Campo Formoso,290600,BA,Nordeste,BUTANTAN/SINOVAC,11383,5959,5424
Campo Grande,270150,AL,Nordeste,BUTANTAN/SINOVAC,1346,758,588
Campo Grande,270150,AL,Nordeste,FIOCRUZ/ASTRAZENECA,1306,1205,101
Campo Grande,500270,MS,Centro-Oeste,FIOCRUZ/ASTRAZENECA,242656,199561,43095
Campo Grande,500270,MS,Centro-Oeste,BUTANTAN/SINOVAC,242511,126715,115796
Campo Grande,500270,MS,Centro-Oeste,PFIZER/BIONTECH,32994,32994,0
Campo Grande Do Piauí,220213,PI,Nordeste,BUTANTAN/SINOVAC,938,480,458
Campo Grande Do Piauí,220213,PI,Nordeste,FIOCRUZ/ASTRAZENECA,861,839,22
Campo Largo,410420,PR,Sul,FIOCRUZ/ASTRAZENECA,23491,22118,1373
Campo Largo,410420,PR,Sul,BUTANTAN/SINOVAC,22719,11794,10925
Campo Largo,410420,PR,Sul,PFIZER/BIONTECH,4540,4537,3
Campo Largo Do Piauí,220217,PI,Nordeste,FIOCRUZ/ASTRAZENECA,2010,1762,248
Campo Largo Do Piauí,220217,PI,Nordeste,BUTANTAN/SINOVAC,1113,593,520
Campo Limpo De Goiás,520485,GO,Centro-Oeste,FIOCRUZ/ASTRAZENECA,1435,1364,71
Campo Limpo De Goiás,520485,GO,Centro-Oeste,BUTANTAN/SINOVAC,1096,554,542
Campo Limpo Paulista,350960,SP,Sudeste,FIOCRUZ/ASTRAZENECA,15486,14661,825
Campo Limpo Paulista,350960,SP,Sudeste,BUTANTAN/SINOVAC,13289,7284,6005
Campo Limpo Paulista,350960,SP,Sudeste,PFIZER/BIONTECH,1552,1548,4
Campo Magro,410425,PR,Sul,FIOCRUZ/ASTRAZENECA,5104,4841,263
Campo Magro,410425,PR,Sul,BUTANTAN/SINOVAC,3830,1998,1832
Campo Magro,410425,PR,Sul,PFIZER/BIONTECH,690,690,0
Campo Maior,220220,PI,Nordeste,FIOCRUZ/ASTRAZENECA,10569,9539,1030
Campo Maior,220220,PI,Nordeste,BUTANTAN/SINOVAC,9463,4980,4483
Campo Maior,220220,PI,Nordeste,PFIZER/BIONTECH,1490,1490,0
Campo Mourão,410430,PR,Sul,FIOCRUZ/ASTRAZENECA,23558,21756,1802
Campo Mourão,410430,PR,Sul,BUTANTAN/SINOVAC,19443,9950,9493
Campo Mourão,410430,PR,Sul,PFIZER/BIONTECH,5394,5391,3
Campo Novo,430400,RS,Sul,BUTANTAN/SINOVAC,1389,698,691
Campo Novo,430400,RS,Sul,FIOCRUZ/ASTRAZENECA,1106,984,122
Campo Novo,430400,RS,Sul,PFIZER/BIONTECH,84,84,0
Campo Novo De Rondônia,110070,RO,Norte,FIOCRUZ/ASTRAZENECA,2048,1993,55
Campo Novo De Rondônia,110070,RO,Norte,BUTANTAN/SINOVAC,1648,837,811
Campo Novo Do Parecis,510263,MT,Centro-Oeste,FIOCRUZ/ASTRAZENECA,3716,3331,385
Campo Novo Do Parecis,510263,MT,Centro-Oeste,BUTANTAN/SINOVAC,3067,1581,1486
Campo Novo Do Parecis,510263,MT,Centro-Oeste,PFIZER/BIONTECH,388,388,0
Campo Redondo,240210,RN,Nordeste,BUTANTAN/SINOVAC,1025,519,506
Campo Redondo,240210,RN,Nordeste,FIOCRUZ/ASTRAZENECA,330,285,45
Campo Redondo,240210,RN,Nordeste,PFIZER/BIONTECH,24,24,0
Campo Verde,510267,MT,Centro-Oeste,FIOCRUZ/ASTRAZENECA,7185,6784,401
Campo Verde,510267,MT,Centro-Oeste,BUTANTAN/SINOVAC,6113,3140,2973
Campo Verde,510267,MT,Centro-Oeste,PFIZER/BIONTECH,458,456,2
Campos Altos,311150,MG,Sudeste,BUTANTAN/SINOVAC,2292,1162,1130
Campos Altos,311150,MG,Sudeste,FIOCRUZ/ASTRAZENECA,1793,1598,195
Campos Belos,520490,GO,Centro-Oeste,FIOCRUZ/ASTRAZENECA,5728,4706,1022
Campos Belos,520490,GO,Centro-Oeste,BUTANTAN/SINOVAC,1342,708,634
Campos Belos,520490,GO,Centro-Oeste,PFIZER/BIONTECH,1284,1281,3
Campos Borges,430410,RS,Sul,FIOCRUZ/ASTRAZENECA,1133,982,151
Campos Borges,430410,RS,Sul,BUTANTAN/SINOVAC,1061,540,521
Campos Borges,430410,RS,Sul,PFIZER/BIONTECH,126,126,0
Campos De Júlio,510268,MT,Centro-Oeste,FIOCRUZ/ASTRAZENECA,1157,1074,83
Campos De Júlio,510268,MT,Centro-Oeste,BUTANTAN/SINOVAC,707,370,337
Campos De Júlio,510268,MT,Centro-Oeste,PFIZER/BIONTECH,101,101,0
Campos Do Jordão,350970,SP,Sudeste,BUTANTAN/SINOVAC,9818,5054,4764
Campos Do Jordão,350970,SP,Sudeste,FIOCRUZ/ASTRAZENECA,9637,8773,864
Campos Do Jordão,350970,SP,Sudeste,PFIZER/BIONTECH,1110,1110,0
Campos Dos Goytacazes,330100,RJ,Sudeste,BUTANTAN/SINOVAC,95125,55863,39262
Campos Dos Goytacazes,330100,RJ,Sudeste,FIOCRUZ/ASTRAZENECA,72282,63194,9088
Campos Dos Goytacazes,330100,RJ,Sudeste,PFIZER/BIONTECH,7459,7441,18
Campos Gerais,311160,MG,Sudeste,FIOCRUZ/ASTRAZENECA,6663,6247,416
Campos Gerais,311160,MG,Sudeste,BUTANTAN/SINOVAC,5939,3025,2914
Campos Gerais,311160,MG,Sudeste,PFIZER/BIONTECH,204,204,0
Campos Lindos,170384,TO,Norte,BUTANTAN/SINOVAC,1079,655,424
Campos Lindos,170384,TO,Norte,FIOCRUZ/ASTRAZENECA,827,791,36
Campos Novos,420360,SC,Sul,FIOCRUZ/ASTRAZENECA,7625,6926,699
Campos Novos,420360,SC,Sul,BUTANTAN/SINOVAC,7015,3782,3233
Campos Novos Paulista,350980,SP,Sudeste,BUTANTAN/SINOVAC,2049,1190,859
Campos Novos Paulista,350980,SP,Sudeste,FIOCRUZ/ASTRAZENECA,1423,1297,126
Campos Novos Paulista,350980,SP,Sudeste,PFIZER/BIONTECH,126,126,0
Campos Sales,230270,CE,Nordeste,BUTANTAN/SINOVAC,4989,2725,2264
Campos Sales,230270,CE,Nordeste,FIOCRUZ/ASTRAZENECA,3863,3529,334
Campos Verdes,520495,GO,Centro-Oeste,FIOCRUZ/ASTRAZENECA,1162,1141,21
Campos Verdes,520495,GO,Centro-Oeste,BUTANTAN/SINOVAC,575,290,285
Camutanga,260360,PE,Nordeste,FIOCRUZ/ASTRAZENECA,1981,1837,144
Camutanga,260360,PE,Nordeste,BUTANTAN/SINOVAC,1398,732,666
Camutanga,260360,PE,Nordeste,PFIZER/BIONTECH,168,168,0
Cana Verde,311190,MG,Sudeste,BUTANTAN/SINOVAC,1711,885,826
Cana Verde,311190,MG,Sudeste,FIOCRUZ/ASTRAZENECA,1326,1203,123
Cana Verde,311190,MG,Sudeste,PFIZER/BIONTECH,147,147,0
Canaã,311170,MG,Sudeste,BUTANTAN/SINOVAC,2122,1086,1036
Canaã,311170,MG,Sudeste,FIOCRUZ/ASTRAZENECA,1160,1035,125
Canaã,311170,MG,Sudeste,PFIZER/BIONTECH,29,29,0
Canaã Dos Carajás,150215,PA,Norte,FIOCRUZ/ASTRAZENECA,8209,7427,782
Canaã Dos Carajás,150215,PA,Norte,BUTANTAN/SINOVAC,1704,943,761
Canabrava Do Norte,510269,MT,Centro-Oeste,BUTANTAN/SINOVAC,850,432,418
Canabrava Do Norte,510269,MT,Centro-Oeste,FIOCRUZ/ASTRAZENECA,303,272,31
Canabrava Do Norte,510269,MT,Centro-Oeste,PFIZER/BIONTECH,42,42,0
Cananéia,350990,SP,Sudeste,BUTANTAN/SINOVAC,3158,1787,1371
Cananéia,350990,SP,Sudeste,FIOCRUZ/ASTRAZENECA,2259,2092,167
Cananéia,350990,SP,Sudeste,PFIZER/BIONTECH,222,222,0
Canapi,270160,AL,Nordeste,FIOCRUZ/ASTRAZENECA,3519,3207,312
Canapi,270160,AL,Nordeste,BUTANTAN/SINOVAC,2961,1503,1458
Canápolis,290610,BA,Nordeste,FIOCRUZ/ASTRAZENECA,1942,1778,164
Canápolis,290610,BA,Nordeste,BUTANTAN/SINOVAC,1939,1063,876
Canápolis,290610,BA,Nordeste,PFIZER/BIONTECH,26,26,0
Canápolis,311180,MG,Sudeste,FIOCRUZ/ASTRAZENECA,2411,2254,157
Canápolis,311180,MG,Sudeste,BUTANTAN/SINOVAC,2306,1185,1121
Canápolis,311180,MG,Sudeste,PFIZER/BIONTECH,486,485,1
Canarana,290620,BA,Nordeste,FIOCRUZ/ASTRAZENECA,7547,6512,1035
Canarana,290620,BA,Nordeste,BUTANTAN/SINOVAC,4411,2263,2148
Canarana,290620,BA,Nordeste,PFIZER/BIONTECH,285,285,0
Canarana,510270,MT,Centro-Oeste,FIOCRUZ/ASTRAZENECA,3146,2916,230
Canarana,510270,MT,Centro-Oeste,BUTANTAN/SINOVAC,2779,1397,1382
Canarana,510270,MT,Centro-Oeste,PFIZER/BIONTECH,99,99,0
Canas,350995,SP,Sudeste,BUTANTAN/SINOVAC,900,526,374
Canas,350995,SP,Sudeste,FIOCRUZ/ASTRAZENECA,695,641,54
Canas,350995,SP,Sudeste,PFIZER/BIONTECH,98,98,0
Canavieira,220225,PI,Nordeste,BUTANTAN/SINOVAC,753,410,343
Canavieira,220225,PI,Nordeste,FIOCRUZ/ASTRAZENECA,741,639,102
Canavieira,220225,PI,Nordeste,PFIZER/BIONTECH,55,55,0
Canavieiras,290630,BA,Nordeste,BUTANTAN/SINOVAC,5688,3056,2632
Canavieiras,290630,BA,Nordeste,FIOCRUZ/ASTRAZENECA,4945,4569,376
Canavieiras,290630,BA,Nordeste,PFIZER/BIONTECH,78,78,0
Candeal,290640,BA,Nordeste,BUTANTAN/SINOVAC,2000,1011,989
Candeal,290640,BA,Nordeste,FIOCRUZ/ASTRAZENECA,1873,1739,134
Candeal,290640,BA,Nordeste,PFIZER/BIONTECH,136,136,0
Candeias,290650,BA,Nordeste,FIOCRUZ/ASTRAZENECA,15653,14082,1571
Candeias,290650,BA,Nordeste,BUTANTAN/SINOVAC,12019,6383,5636
Candeias,290650,BA,Nordeste,PFIZER/BIONTECH,3822,3808,14
Candeias,311200,MG,Sudeste,BUTANTAN/SINOVAC,3710,1899,1811
Candeias,311200,MG,Sudeste,FIOCRUZ/ASTRAZENECA,3662,3351,311
Candeias,311200,MG,Sudeste,PFIZER/BIONTECH,303,303,0
Candeias Do Jamari,110080,RO,Norte,FIOCRUZ/ASTRAZENECA,3867,3708,159
Candeias Do Jamari,110080,RO,Norte,BUTANTAN/SINOVAC,3648,1998,1650
Candeias Do Jamari,110080,RO,Norte,PFIZER/BIONTECH,129,129,0
Candelária,430420,RS,Sul,FIOCRUZ/ASTRAZENECA,8069,7456,613
Candelária,430420,RS,Sul,BUTANTAN/SINOVAC,7694,4124,3570
Candelária,430420,RS,Sul,PFIZER/BIONTECH,1042,1042,0
Candiba,290660,BA,Nordeste,FIOCRUZ/ASTRAZENECA,3669,3404,265
Candiba,290660,BA,Nordeste,BUTANTAN/SINOVAC,3219,1625,1594
Candiba,290660,BA,Nordeste,PFIZER/BIONTECH,220,220,0
Cândido De Abreu,410440,PR,Sul,FIOCRUZ/ASTRAZENECA,3513,3310,203
Cândido De Abreu,410440,PR,Sul,BUTANTAN/SINOVAC,3383,1793,1590
Cândido De Abreu,410440,PR,Sul,PFIZER/BIONTECH,403,402,1
Cândido Godói,430430,RS,Sul,BUTANTAN/SINOVAC,2099,1055,1044
Cândido Godói,430430,RS,Sul,FIOCRUZ/ASTRAZENECA,1887,1674,213
Cândido Godói,430430,RS,Sul,PFIZER/BIONTECH,234,234,0
Cândido Mendes,210260,MA,Nordeste,FIOCRUZ/ASTRAZENECA,5580,3907,1673
Cândido Mendes,210260,MA,Nordeste,BUTANTAN/SINOVAC,2292,1235,1057
Cândido Mota,351000,SP,Sudeste,FIOCRUZ/ASTRAZENECA,8082,7568,514
Cândido Mota,351000,SP,Sudeste,BUTANTAN/SINOVAC,8044,4402,3642
Cândido Mota,351000,SP,Sudeste,PFIZER/BIONTECH,1104,1104,0
Cândido Rodrigues,351010,SP,Sudeste,BUTANTAN/SINOVAC,1165,637,528
Cândido Rodrigues,351010,SP,Sudeste,FIOCRUZ/ASTRAZENECA,763,685,78
Cândido Rodrigues,351010,SP,Sudeste,PFIZER/BIONTECH,65,65,0
Cândido Sales,290670,BA,Nordeste,FIOCRUZ/ASTRAZENECA,4832,4500,332
Cândido Sales,290670,BA,Nordeste,BUTANTAN/SINOVAC,4772,2487,2285
Cândido Sales,290670,BA,Nordeste,PFIZER/BIONTECH,377,376,1
Candiota,430435,RS,Sul,FIOCRUZ/ASTRAZENECA,2394,2130,264
Candiota,430435,RS,Sul,BUTANTAN/SINOVAC,1726,926,800
Candiota,430435,RS,Sul,PFIZER/BIONTECH,377,376,1
Candói,410442,PR,Sul,FIOCRUZ/ASTRAZENECA,3965,3727,238
Candói,410442,PR,Sul,BUTANTAN/SINOVAC,2756,1491,1265
Candói,410442,PR,Sul,PFIZER/BIONTECH,204,204,0
Canela,430440,RS,Sul,FIOCRUZ/ASTRAZENECA,10401,9455,946
Canela,430440,RS,Sul,BUTANTAN/SINOVAC,7853,4037,3816
Canela,430440,RS,Sul,PFIZER/BIONTECH,1284,1283,1
Canelinha,420370,SC,Sul,FIOCRUZ/ASTRAZENECA,2470,2195,275
Canelinha,420370,SC,Sul,BUTANTAN/SINOVAC,1566,939,627
Canelinha,420370,SC,Sul,PFIZER/BIONTECH,235,235,0
Canguaretama,240220,RN,Nordeste,FIOCRUZ/ASTRAZENECA,5766,5343,423
Canguaretama,240220,RN,Nordeste,BUTANTAN/SINOVAC,4743,2532,2211
Canguaretama,240220,RN,Nordeste,PFIZER/BIONTECH,459,459,0
Canguçu,430450,RS,Sul,FIOCRUZ/ASTRAZENECA,15296,13762,1534
Canguçu,430450,RS,Sul,BUTANTAN/SINOVAC,15232,7758,7474
Canguçu,430450,RS,Sul,PFIZER/BIONTECH,1997,1995,2
Canhoba,280110,SE,Nordeste,BUTANTAN/SINOVAC,811,441,370
Canhoba,280110,SE,Nordeste,FIOCRUZ/ASTRAZENECA,671,622,49
Canhotinho,260370,PE,Nordeste,FIOCRUZ/ASTRAZENECA,4978,4593,385
Canhotinho,260370,PE,Nordeste,BUTANTAN/SINOVAC,4066,2185,1881
Canhotinho,260370,PE,Nordeste,PFIZER/BIONTECH,520,520,0
Canindé,230280,CE,Nordeste,BUTANTAN/SINOVAC,13433,6892,6541
Canindé,230280,CE,Nordeste,FIOCRUZ/ASTRAZENECA,5423,4825,598
Canindé De São Francisco,280120,SE,Nordeste,FIOCRUZ/ASTRAZENECA,3814,3814,0
Canindé De São Francisco,280120,SE,Nordeste,BUTANTAN/SINOVAC,3624,1932,1692
Canindé De São Francisco,280120,SE,Nordeste,PFIZER/BIONTECH,456,456,0
Canitar,351015,SP,Sudeste,FIOCRUZ/ASTRAZENECA,1185,1134,51
Canitar,351015,SP,Sudeste,BUTANTAN/SINOVAC,1017,599,418
Canitar,351015,SP,Sudeste,PFIZER/BIONTECH,78,78,0
Canoas,430460,RS,Sul,BUTANTAN/SINOVAC,83716,43011,40705
Canoas,430460,RS,Sul,FIOCRUZ/ASTRAZENECA,79560,74068,5492
Canoas,430460,RS,Sul,PFIZER/BIONTECH,9922,9918,4
Canoinhas,420380,SC,Sul,FIOCRUZ/ASTRAZENECA,12066,11209,857
Canoinhas,420380,SC,Sul,BUTANTAN/SINOVAC,5000,2477,2523
Canoinhas,420380,SC,Sul,PFIZER/BIONTECH,690,685,5
Cansanção,290680,BA,Nordeste,FIOCRUZ/ASTRAZENECA,7443,6310,1133
Cansanção,290680,BA,Nordeste,BUTANTAN/SINOVAC,6602,3414,3188
Cansanção,290680,BA,Nordeste,PFIZER/BIONTECH,1211,1210,1
Cantá,140017,RR,Norte,BUTANTAN/SINOVAC,4933,2852,2081
Cantá,140017,RR,Norte,FIOCRUZ/ASTRAZENECA,2341,2291,50
Cantagalo,311205,MG,Sudeste,BUTANTAN/SINOVAC,985,502,483
Cantagalo,311205,MG,Sudeste,FIOCRUZ/ASTRAZENECA,916,823,93
Cantagalo,311205,MG,Sudeste,PFIZER/BIONTECH,37,37,0
Cantagalo,330110,RJ,Sudeste,FIOCRUZ/ASTRAZENECA,5267,4794,473
Cantagalo,330110,RJ,Sudeste,BUTANTAN/SINOVAC,4799,2504,2295
Cantagalo,330110,RJ,Sudeste,PFIZER/BIONTECH,1172,1170,2
Cantagalo,410445,PR,Sul,FIOCRUZ/ASTRAZENECA,3247,3115,132
Cantagalo,410445,PR,Sul,BUTANTAN/SINOVAC,2155,1100,1055
Cantagalo,410445,PR,Sul,PFIZER/BIONTECH,160,160,0
Cantanhede,210270,MA,Nordeste,FIOCRUZ/ASTRAZENECA,3102,2892,210
Cantanhede,210270,MA,Nordeste,BUTANTAN/SINOVAC,2471,1285,1186
Canto Do Buriti,220230,PI,Nordeste,BUTANTAN/SINOVAC,3302,1849,1453
Canto Do Buriti,220230,PI,Nordeste,FIOCRUZ/ASTRAZENECA,2629,2495,134
Canto Do Buriti,220230,PI,Nordeste,PFIZER/BIONTECH,65,65,0
Canudos,290682,BA,Nordeste,FIOCRUZ/ASTRAZENECA,2750,2479,271
Canudos,290682,BA,Nordeste,BUTANTAN/SINOVAC,2426,1247,1179
Canudos,290682,BA,Nordeste,PFIZER/BIONTECH,48,48,0
Canudos Do Vale,430461,RS,Sul,BUTANTAN/SINOVAC,592,314,278
Canudos Do Vale,430461,RS,Sul,FIOCRUZ/ASTRAZENECA,436,390,46
Canudos Do Vale,430461,RS,Sul,PFIZER/BIONTECH,58,58,0
Canutama,130090,AM,Norte,BUTANTAN/SINOVAC,2103,1224,879
Canutama,130090,AM,Norte,FIOCRUZ/ASTRAZENECA,1684,1474,210
Capanema,150220,PA,Norte,FIOCRUZ/ASTRAZENECA,10477,9298,1179
Capanema,150220,PA,Norte,BUTANTAN/SINOVAC,8415,4447,3968
Capanema,410450,PR,Sul,BUTANTAN/SINOVAC,5255,2537,2718
Capanema,410450,PR,Sul,FIOCRUZ/ASTRAZENECA,4709,4439,270
Capão Alto,420325,SC,Sul,FIOCRUZ/ASTRAZENECA,662,607,55
Capão Alto,420325,SC,Sul,BUTANTAN/SINOVAC,603,328,275
Capão Bonito,351020,SP,Sudeste,FIOCRUZ/ASTRAZENECA,9960,9333,627
Capão Bonito,351020,SP,Sudeste,BUTANTAN/SINOVAC,9114,5101,4013
Capão Bonito,351020,SP,Sudeste,PFIZER/BIONTECH,981,980,1
Capão Bonito Do Sul,430462,RS,Sul,BUTANTAN/SINOVAC,593,351,242
Capão Bonito Do Sul,430462,RS,Sul,FIOCRUZ/ASTRAZENECA,436,382,54
Capão Bonito Do Sul,430462,RS,Sul,PFIZER/BIONTECH,80,80,0
Capão Da Canoa,430463,RS,Sul,FIOCRUZ/ASTRAZENECA,14046,13066,980
Capão Da Canoa,430463,RS,Sul,BUTANTAN/SINOVAC,12773,6751,6022
Capão Da Canoa,430463,RS,Sul,PFIZER/BIONTECH,2158,2152,6
Capão Do Cipó,430465,RS,Sul,FIOCRUZ/ASTRAZENECA,914,816,98
Capão Do Cipó,430465,RS,Sul,BUTANTAN/SINOVAC,679,343,336
Capão Do Cipó,430465,RS,Sul,PFIZER/BIONTECH,151,151,0
Capão Do Leão,430466,RS,Sul,FIOCRUZ/ASTRAZENECA,5989,5697,292
Capão Do Leão,430466,RS,Sul,BUTANTAN/SINOVAC,5160,2605,2555
Capão Do Leão,430466,RS,Sul,PFIZER/BIONTECH,864,864,0
Caparaó,311210,MG,Sudeste,BUTANTAN/SINOVAC,1236,681,555
Caparaó,311210,MG,Sudeste,FIOCRUZ/ASTRAZENECA,904,830,74
Caparaó,311210,MG,Sudeste,PFIZER/BIONTECH,86,86,0
Capela,270170,AL,Nordeste,BUTANTAN/SINOVAC,2503,1331,1172
Capela,270170,AL,Nordeste,FIOCRUZ/ASTRAZENECA,2247,2068,179
Capela,270170,AL,Nordeste,PFIZER/BIONTECH,116,116,0
Capela,280130,SE,Nordeste,FIOCRUZ/ASTRAZENECA,5063,4984,79
Capela,280130,SE,Nordeste,BUTANTAN/SINOVAC,3337,1748,1589
Capela,280130,SE,Nordeste,PFIZER/BIONTECH,155,155,0
Capela De Santana,430468,RS,Sul,FIOCRUZ/ASTRAZENECA,2633,2500,133
Capela De Santana,430468,RS,Sul,BUTANTAN/SINOVAC,2218,1173,1045
Capela De Santana,430468,RS,Sul,PFIZER/BIONTECH,111,111,0
Capela Do Alto,351030,SP,Sudeste,FIOCRUZ/ASTRAZENECA,4416,4243,173
Capela Do Alto,351030,SP,Sudeste,BUTANTAN/SINOVAC,4096,2376,1720
Capela Do Alto,351030,SP,Sudeste,PFIZER/BIONTECH,525,524,1
Capela Do Alto Alegre,290685,BA,Nordeste,BUTANTAN/SINOVAC,3186,1662,1524
Capela Do Alto Alegre,290685,BA,Nordeste,FIOCRUZ/ASTRAZENECA,2841,2494,347
Capela Do Alto Alegre,290685,BA,Nordeste,PFIZER/BIONTECH,158,158,0
Capela Nova,311220,MG,Sudeste,BUTANTAN/SINOVAC,1153,589,564
Capela Nova,311220,MG,Sudeste,FIOCRUZ/ASTRAZENECA,1118,895,223
Capelinha,311230,MG,Sudeste,FIOCRUZ/ASTRAZENECA,6736,6185,551
Capelinha,311230,MG,Sudeste,BUTANTAN/SINOVAC,5735,2999,2736
Capelinha,311230,MG,Sudeste,PFIZER/BIONTECH,831,831,0
Capetinga,311240,MG,Sudeste,BUTANTAN/SINOVAC,1764,912,852
Capetinga,311240,MG,Sudeste,FIOCRUZ/ASTRAZENECA,1131,1123,8
Capetinga,311240,MG,Sudeste,PFIZER/BIONTECH,2,2,0
Capim,250403,PB,Nordeste,BUTANTAN/SINOVAC,1057,535,522
Capim,250403,PB,Nordeste,FIOCRUZ/ASTRAZENECA,890,819,71
Capim,250403,PB,Nordeste,PFIZER/BIONTECH,29,29,0
Capim Branco,311250,MG,Sudeste,FIOCRUZ/ASTRAZENECA,2231,2065,166
Capim Branco,311250,MG,Sudeste,BUTANTAN/SINOVAC,1963,1047,916
Capim Branco,311250,MG,Sudeste,PFIZER/BIONTECH,148,148,0
Capim Grosso,290687,BA,Nordeste,FIOCRUZ/ASTRAZENECA,7788,6986,802
Capim Grosso,290687,BA,Nordeste,BUTANTAN/SINOVAC,7368,4161,3207
Capim Grosso,290687,BA,Nordeste,PFIZER/BIONTECH,713,702,11
Capinópolis,311260,MG,Sudeste,BUTANTAN/SINOVAC,3934,2052,1882
Capinópolis,311260,MG,Sudeste,FIOCRUZ/ASTRAZENECA,3395,3143,252
Capinópolis,311260,MG,Sudeste,PFIZER/BIONTECH,339,339,0
Capinzal,420390,SC,Sul,FIOCRUZ/ASTRAZENECA,4627,4300,327
Capinzal,420390,SC,Sul,BUTANTAN/SINOVAC,4159,2118,2041
Capinzal,420390,SC,Sul,PFIZER/BIONTECH,349,349,0
Capinzal Do Norte,210275,MA,Nordeste,FIOCRUZ/ASTRAZENECA,3324,3107,217
Capinzal Do Norte,210275,MA,Nordeste,BUTANTAN/SINOVAC,2047,1107,940
Capistrano,230290,CE,Nordeste,BUTANTAN/SINOVAC,2438,1381,1057
Capistrano,230290,CE,Nordeste,FIOCRUZ/ASTRAZENECA,922,828,94
Capitão,430469,RS,Sul,BUTANTAN/SINOVAC,790,395,395
Capitão,430469,RS,Sul,FIOCRUZ/ASTRAZENECA,765,687,78
Capitão,430469,RS,Sul,PFIZER/BIONTECH,168,168,0
Capitão Andrade,311265,MG,Sudeste,FIOCRUZ/ASTRAZENECA,1449,1349,100
Capitão Andrade,311265,MG,Sudeste,BUTANTAN/SINOVAC,1358,710,648
Capitão Andrade,311265,MG,Sudeste,PFIZER/BIONTECH,105,105,0
Capitão De Campos,220240,PI,Nordeste,FIOCRUZ/ASTRAZENECA,2190,2067,123
Capitão De Campos,220240,PI,Nordeste,BUTANTAN/SINOVAC,2054,1072,982
Capitão De Campos,220240,PI,Nordeste,PFIZER/BIONTECH,220,220,0
Capitão Enéas,311270,MG,Sudeste,BUTANTAN/SINOVAC,1952,1035,917
Capitão Enéas,311270,MG,Sudeste,FIOCRUZ/ASTRAZENECA,1058,1001,57
Capitão Gervásio Oliveira,220245,PI,Nordeste,FIOCRUZ/ASTRAZENECA,726,670,56
Capitão Gervásio Oliveira,220245,PI,Nordeste,BUTANTAN/SINOVAC,700,359,341
Capitão Leônidas Marques,410460,PR,Sul,FIOCRUZ/ASTRAZENECA,3557,3351,206
Capitão Leônidas Marques,410460,PR,Sul,BUTANTAN/SINOVAC,3335,1733,1602
Capitão Leônidas Marques,410460,PR,Sul,PFIZER/BIONTECH,440,440,0
Capitão Poço,150230,PA,Norte,FIOCRUZ/ASTRAZENECA,12050,10370,1680
Capitão Poço,150230,PA,Norte,BUTANTAN/SINOVAC,7610,3856,3754
Capitólio,311280,MG,Sudeste,BUTANTAN/SINOVAC,2132,1081,1051
Capitólio,311280,MG,Sudeste,FIOCRUZ/ASTRAZENECA,1578,1404,174
Capitólio,311280,MG,Sudeste,PFIZER/BIONTECH,39,39,0
Capivari,351040,SP,Sudeste,FIOCRUZ/ASTRAZENECA,12285,11221,1064
Capivari,351040,SP,Sudeste,BUTANTAN/SINOVAC,10566,5715,4851
Capivari,351040,SP,Sudeste,PFIZER/BIONTECH,718,718,0
Capivari De Baixo,420395,SC,Sul,FIOCRUZ/ASTRAZENECA,5469,4975,494
Capivari De Baixo,420395,SC,Sul,BUTANTAN/SINOVAC,3043,1589,1454
Capivari De Baixo,420395,SC,Sul,PFIZER/BIONTECH,169,169,0
Capivari Do Sul,430467,RS,Sul,FIOCRUZ/ASTRAZENECA,1294,1205,89
Capivari Do Sul,430467,RS,Sul,BUTANTAN/SINOVAC,996,506,490
Capivari Do Sul,430467,RS,Sul,PFIZER/BIONTECH,179,179,0
Capixaba,120017,AC,Norte,BUTANTAN/SINOVAC,1685,878,807
Capixaba,120017,AC,Norte,FIOCRUZ/ASTRAZENECA,1587,1411,176
Capoeiras,260380,PE,Nordeste,FIOCRUZ/ASTRAZENECA,4897,4556,341
Capoeiras,260380,PE,Nordeste,BUTANTAN/SINOVAC,3793,1994,1799
Capoeiras,260380,PE,Nordeste,PFIZER/BIONTECH,199,198,1
Caputira,311290,MG,Sudeste,BUTANTAN/SINOVAC,2439,1253,1186
Caputira,311290,MG,Sudeste,FIOCRUZ/ASTRAZENECA,1385,1241,144
Caputira,311290,MG,Sudeste,PFIZER/BIONTECH,46,46,0
Caraá,430471,RS,Sul,BUTANTAN/SINOVAC,3047,1659,1388
Caraá,430471,RS,Sul,FIOCRUZ/ASTRAZENECA,2100,1955,145
Caraá,430471,RS,Sul,PFIZER/BIONTECH,315,315,0
Caracaraí,140020,RR,Norte,FIOCRUZ/ASTRAZENECA,3286,3260,26
Caracaraí,140020,RR,Norte,BUTANTAN/SINOVAC,3103,1640,1463
Caracol,220250,PI,Nordeste,FIOCRUZ/ASTRAZENECA,2006,1882,124
Caracol,220250,PI,Nordeste,BUTANTAN/SINOVAC,1441,749,692
Caracol,220250,PI,Nordeste,PFIZER/BIONTECH,240,240,0
Caracol,500280,MS,Centro-Oeste,FIOCRUZ/ASTRAZENECA,1391,1253,138
Caracol,500280,MS,Centro-Oeste,BUTANTAN/SINOVAC,1205,627,578
Caracol,500280,MS,Centro-Oeste,PFIZER/BIONTECH,206,206,0
Caraguatatuba,351050,SP,Sudeste,FIOCRUZ/ASTRAZENECA,31048,29194,1854
Caraguatatuba,351050,SP,Sudeste,BUTANTAN/SINOVAC,26325,15234,11091
Caraguatatuba,351050,SP,Sudeste,PFIZER/BIONTECH,2285,2284,1
Caraí,311300,MG,Sudeste,BUTANTAN/SINOVAC,5310,2801,2509
Caraí,311300,MG,Sudeste,FIOCRUZ/ASTRAZENECA,2556,2354,202
Caraí,311300,MG,Sudeste,PFIZER/BIONTECH,265,265,0
Caraíbas,290689,BA,Nordeste,BUTANTAN/SINOVAC,2536,1398,1138
Caraíbas,290689,BA,Nordeste,FIOCRUZ/ASTRAZENECA,1844,1654,190
Caraíbas,290689,BA,Nordeste,PFIZER/BIONTECH,134,134,0
Carambeí,410465,PR,Sul,FIOCRUZ/ASTRAZENECA,4537,4335,202
Carambeí,410465,PR,Sul,BUTANTAN/SINOVAC,3062,1601,1461
Carambeí,410465,PR,Sul,PFIZER/BIONTECH,257,257,0
Caranaíba,311310,MG,Sudeste,BUTANTAN/SINOVAC,794,402,392
Caranaíba,311310,MG,Sudeste,FIOCRUZ/ASTRAZENECA,633,537,96
Carandaí,311320,MG,Sudeste,FIOCRUZ/ASTRAZENECA,5558,4947,611
Carandaí,311320,MG,Sudeste,BUTANTAN/SINOVAC,4679,2405,2274
Carandaí,311320,MG,Sudeste,PFIZER/BIONTECH,527,527,0
Carangola,311330,MG,Sudeste,BUTANTAN/SINOVAC,9663,4947,4716
Carangola,311330,MG,Sudeste,FIOCRUZ/ASTRAZENECA,6455,5960,495
Carangola,311330,MG,Sudeste,PFIZER/BIONTECH,490,488,2
Carapebus,330093,RJ,Sudeste,BUTANTAN/SINOVAC,3062,1623,1439
Carapebus,330093,RJ,Sudeste,FIOCRUZ/ASTRAZENECA,1217,1144,73
Carapicuíba,351060,SP,Sudeste,BUTANTAN/SINOVAC,25710,15011,10699
Carapicuíba,351060,SP,Sudeste,FIOCRUZ/ASTRAZENECA,22909,21583,1326
Carapicuíba,351060,SP,Sudeste,PFIZER/BIONTECH,3002,3000,2
Caratinga,311340,MG,Sudeste,BUTANTAN/SINOVAC,15506,8056,7450
Caratinga,311340,MG,Sudeste,FIOCRUZ/ASTRAZENECA,10920,9759,1161
Caratinga,311340,MG,Sudeste,PFIZER/BIONTECH,942,940,2
Carauari,130100,AM,Norte,FIOCRUZ/ASTRAZENECA,4688,3741,947
Carauari,130100,AM,Norte,BUTANTAN/SINOVAC,2447,1383,1064
Caraúbas,240230,RN,Nordeste,FIOCRUZ/ASTRAZENECA,5095,4669,426
Caraúbas,240230,RN,Nordeste,BUTANTAN/SINOVAC,4377,2245,2132
Caraúbas,240230,RN,Nordeste,PFIZER/BIONTECH,575,575,0
Caraúbas,250407,PB,Nordeste,BUTANTAN/SINOVAC,1171,601,570
Caraúbas,250407,PB,Nordeste,FIOCRUZ/ASTRAZENECA,741,660,81
Caraúbas,250407,PB,Nordeste,PFIZER/BIONTECH,77,77,0
Caraúbas Do Piauí,220253,PI,Nordeste,BUTANTAN/SINOVAC,831,458,373
Caraúbas Do Piauí,220253,PI,Nordeste,FIOCRUZ/ASTRAZENECA,636,577,59
Caravelas,290690,BA,Nordeste,FIOCRUZ/ASTRAZENECA,4595,4234,361
Caravelas,290690,BA,Nordeste,BUTANTAN/SINOVAC,4135,2170,1965
Caravelas,290690,BA,Nordeste,PFIZER/BIONTECH,157,157,0
Carazinho,430470,RS,Sul,FIOCRUZ/ASTRAZENECA,19447,16994,2453
Carazinho,430470,RS,Sul,BUTANTAN/SINOVAC,16141,8138,8003
Carazinho,430470,RS,Sul,PFIZER/BIONTECH,2301,2298,3
Carbonita,311350,MG,Sudeste,BUTANTAN/SINOVAC,1777,903,874
Carbonita,311350,MG,Sudeste,FIOCRUZ/ASTRAZENECA,1603,1487,116
Carbonita,311350,MG,Sudeste,PFIZER/BIONTECH,260,260,0
Cardeal Da Silva,290700,BA,Nordeste,FIOCRUZ/ASTRAZENECA,1757,1613,144
Cardeal Da Silva,290700,BA,Nordeste,BUTANTAN/SINOVAC,1548,813,735
Cardeal Da Silva,290700,BA,Nordeste,PFIZER/BIONTECH,95,94,1
Cardoso,351070,SP,Sudeste,BUTANTAN/SINOVAC,3534,1889,1645
Cardoso,351070,SP,Sudeste,FIOCRUZ/ASTRAZENECA,2832,2541,291
Cardoso,351070,SP,Sudeste,PFIZER/BIONTECH,130,130,0
Cardoso Moreira,330115,RJ,Sudeste,BUTANTAN/SINOVAC,2958,1752,1206
Cardoso Moreira,330115,RJ,Sudeste,FIOCRUZ/ASTRAZENECA,2416,2047,369
Careaçu,311360,MG,Sudeste,BUTANTAN/SINOVAC,1616,847,769
Careaçu,311360,MG,Sudeste,FIOCRUZ/ASTRAZENECA,1537,1407,130
Careaçu,311360,MG,Sudeste,PFIZER/BIONTECH,137,136,1
Careiro,130110,AM,Norte,FIOCRUZ/ASTRAZENECA,9426,7846,1580
Careiro,130110,AM,Norte,BUTANTAN/SINOVAC,4262,2356,1906
Careiro Da Várzea,130115,AM,Norte,FIOCRUZ/ASTRAZENECA,7231,6131,1100
Careiro Da Várzea,130115,AM,Norte,BUTANTAN/SINOVAC,1559,887,672
Cariacica,320130,ES,Sudeste,FIOCRUZ/ASTRAZENECA,97212,87258,9954
Cariacica,320130,ES,Sudeste,BUTANTAN/SINOVAC,62261,30634,31627
Cariacica,320130,ES,Sudeste,PFIZER/BIONTECH,13125,13121,4
Caridade,230300,CE,Nordeste,BUTANTAN/SINOVAC,2900,1527,1373
Caridade,230300,CE,Nordeste,FIOCRUZ/ASTRAZENECA,1233,961,272
Caridade Do Piauí,220255,PI,Nordeste,FIOCRUZ/ASTRAZENECA,752,567,185
Caridade Do Piauí,220255,PI,Nordeste,BUTANTAN/SINOVAC,635,319,316
Carinhanha,290710,BA,Nordeste,FIOCRUZ/ASTRAZENECA,7310,6611,699
Carinhanha,290710,BA,Nordeste,BUTANTAN/SINOVAC,3990,2122,1868
Carinhanha,290710,BA,Nordeste,PFIZER/BIONTECH,428,428,0
Carira,280140,SE,Nordeste,BUTANTAN/SINOVAC,5201,2698,2503
Carira,280140,SE,Nordeste,FIOCRUZ/ASTRAZENECA,3471,3465,6
Carira,280140,SE,Nordeste,PFIZER/BIONTECH,218,218,0
Cariré,230310,CE,Nordeste,BUTANTAN/SINOVAC,3393,2112,1281
Cariré,230310,CE,Nordeste,FIOCRUZ/ASTRAZENECA,997,911,86
Cariri Do Tocantins,170386,TO,Norte,FIOCRUZ/ASTRAZENECA,795,754,41
Cariri Do Tocantins,170386,TO,Norte,BUTANTAN/SINOVAC,779,404,375
Caririaçu,230320,CE,Nordeste,BUTANTAN/SINOVAC,6056,3199,2857
Caririaçu,230320,CE,Nordeste,FIOCRUZ/ASTRAZENECA,2393,1999,394
Cariús,230330,CE,Nordeste,BUTANTAN/SINOVAC,4020,2062,1958
Cariús,230330,CE,Nordeste,FIOCRUZ/ASTRAZENECA,1728,1290,438
Carlinda,510279,MT,Centro-Oeste,BUTANTAN/SINOVAC,2129,1081,1048
Carlinda,510279,MT,Centro-Oeste,FIOCRUZ/ASTRAZENECA,1594,1472,122
Carlinda,510279,MT,Centro-Oeste,PFIZER/BIONTECH,145,145,0
Carlópolis,410470,PR,Sul,FIOCRUZ/ASTRAZENECA,3691,3510,181
Carlópolis,410470,PR,Sul,BUTANTAN/SINOVAC,3281,1690,1591
Carlópolis,410470,PR,Sul,PFIZER/BIONTECH,175,175,0
Carlos Barbosa,430480,RS,Sul,FIOCRUZ/ASTRAZENECA,7122,6363,759
Carlos Barbosa,430480,RS,Sul,BUTANTAN/SINOVAC,6303,3226,3077
Carlos Barbosa,430480,RS,Sul,PFIZER/BIONTECH,867,867,0
Carlos Chagas,311370,MG,Sudeste,BUTANTAN/SINOVAC,4127,2135,1992
Carlos Chagas,311370,MG,Sudeste,FIOCRUZ/ASTRAZENECA,3716,3504,212
Carlos Chagas,311370,MG,Sudeste,PFIZER/BIONTECH,584,583,1
Carlos Gomes,430485,RS,Sul,BUTANTAN/SINOVAC,513,253,260
Carlos Gomes,430485,RS,Sul,FIOCRUZ/ASTRAZENECA,379,328,51
Carlos Gomes,430485,RS,Sul,PFIZER/BIONTECH,70,70,0
Carmésia,311380,MG,Sudeste,BUTANTAN/SINOVAC,1075,542,533
Carmésia,311380,MG,Sudeste,FIOCRUZ/ASTRAZENECA,790,729,61
Carmésia,311380,MG,Sudeste,PFIZER/BIONTECH,50,50,0
Carmo,330120,RJ,Sudeste,BUTANTAN/SINOVAC,7656,4464,3192
Carmo,330120,RJ,Sudeste,FIOCRUZ/ASTRAZENECA,6320,5840,480
Carmo,330120,RJ,Sudeste,PFIZER/BIONTECH,121,121,0
Carmo Da Cachoeira,311390,MG,Sudeste,FIOCRUZ/ASTRAZENECA,2709,2502,207
Carmo Da Cachoeira,311390,MG,Sudeste,BUTANTAN/SINOVAC,2252,1169,1083
Carmo Da Cachoeira,311390,MG,Sudeste,PFIZER/BIONTECH,194,194,0
Carmo Da Mata,311400,MG,Sudeste,BUTANTAN/SINOVAC,2668,1359,1309
Carmo Da Mata,311400,MG,Sudeste,FIOCRUZ/ASTRAZENECA,2546,2317,229
Carmo Da Mata,311400,MG,Sudeste,PFIZER/BIONTECH,88,88,0
Carmo De Minas,311410,MG,Sudeste,FIOCRUZ/ASTRAZENECA,3363,3100,263
Carmo De Minas,311410,MG,Sudeste,BUTANTAN/SINOVAC,2478,1264,1214
Carmo De Minas,311410,MG,Sudeste,PFIZER/BIONTECH,102,102,0
Carmo Do Cajuru,311420,MG,Sudeste,FIOCRUZ/ASTRAZENECA,3873,3663,210
Carmo Do Cajuru,311420,MG,Sudeste,BUTANTAN/SINOVAC,3311,1764,1547
Carmo Do Cajuru,311420,MG,Sudeste,PFIZER/BIONTECH,203,202,1
Carmo Do Paranaíba,311430,MG,Sudeste,FIOCRUZ/ASTRAZENECA,8180,6847,1333
Carmo Do Paranaíba,311430,MG,Sudeste,BUTANTAN/SINOVAC,8134,4132,4002
Carmo Do Paranaíba,311430,MG,Sudeste,PFIZER/BIONTECH,692,692,0
Carmo Do Rio Claro,311440,MG,Sudeste,FIOCRUZ/ASTRAZENECA,4665,4344,321
Carmo Do Rio Claro,311440,MG,Sudeste,BUTANTAN/SINOVAC,4635,2333,2302
Carmo Do Rio Claro,311440,MG,Sudeste,PFIZER/BIONTECH,346,346,0
Carmo Do Rio Verde,520500,GO,Centro-Oeste,BUTANTAN/SINOVAC,1334,672,662
Carmo Do Rio Verde,520500,GO,Centro-Oeste,FIOCRUZ/ASTRAZENECA,1325,1203,122
Carmolândia,170388,TO,Norte,BUTANTAN/SINOVAC,479,251,228
Carmolândia,170388,TO,Norte,FIOCRUZ/ASTRAZENECA,370,360,10
Carmópolis,280150,SE,Nordeste,BUTANTAN/SINOVAC,959,496,463
Carmópolis,280150,SE,Nordeste,FIOCRUZ/ASTRAZENECA,736,728,8
Carmópolis De Minas,311450,MG,Sudeste,BUTANTAN/SINOVAC,3840,1989,1851
Carmópolis De Minas,311450,MG,Sudeste,FIOCRUZ/ASTRAZENECA,3257,2988,269
Carmópolis De Minas,311450,MG,Sudeste,PFIZER/BIONTECH,168,168,0
Carnaíba,260390,PE,Nordeste,FIOCRUZ/ASTRAZENECA,5126,4639,487
Carnaíba,260390,PE,Nordeste,BUTANTAN/SINOVAC,3348,1656,1692
Carnaíba,260390,PE,Nordeste,PFIZER/BIONTECH,479,477,2
Carnaúba Dos Dantas,240240,RN,Nordeste,BUTANTAN/SINOVAC,1868,981,887
Carnaúba Dos Dantas,240240,RN,Nordeste,FIOCRUZ/ASTRAZENECA,1488,1366,122
Carnaúba Dos Dantas,240240,RN,Nordeste,PFIZER/BIONTECH,102,102,0
Carnaubais,240250,RN,Nordeste,BUTANTAN/SINOVAC,2231,1111,1120
Carnaubais,240250,RN,Nordeste,FIOCRUZ/ASTRAZENECA,1523,1352,171
Carnaubais,240250,RN,Nordeste,PFIZER/BIONTECH,76,76,0
Carnaubal,230340,CE,Nordeste,BUTANTAN/SINOVAC,2374,1475,899
Carnaubal,230340,CE,Nordeste,FIOCRUZ/ASTRAZENECA,872,738,134
Carnaubeira Da Penha,260392,PE,Nordeste,BUTANTAN/SINOVAC,10177,5206,4971
Carnaubeira Da Penha,260392,PE,Nordeste,FIOCRUZ/ASTRAZENECA,1691,1568,123
Carnaubeira Da Penha,260392,PE,Nordeste,PFIZER/BIONTECH,232,232,0
Carneirinho,311455,MG,Sudeste,FIOCRUZ/ASTRAZENECA,2662,2395,267
Carneirinho,311455,MG,Sudeste,BUTANTAN/SINOVAC,2443,1233,1210
Carneirinho,311455,MG,Sudeste,PFIZER/BIONTECH,108,108,0
Carneiros,270180,AL,Nordeste,FIOCRUZ/ASTRAZENECA,1706,1563,143
Carneiros,270180,AL,Nordeste,BUTANTAN/SINOVAC,1152,577,575
Caroebe,140023,RR,Norte,BUTANTAN/SINOVAC,1983,1060,923
Caroebe,140023,RR,Norte,FIOCRUZ/ASTRAZENECA,703,690,13
Carolina,210280,MA,Nordeste,FIOCRUZ/ASTRAZENECA,4422,4091,331
Carolina,210280,MA,Nordeste,BUTANTAN/SINOVAC,3737,1966,1771
Carpina,260400,PE,Nordeste,FIOCRUZ/ASTRAZENECA,14592,13497,1095
Carpina,260400,PE,Nordeste,BUTANTAN/SINOVAC,10797,5656,5141
Carpina,260400,PE,Nordeste,PFIZER/BIONTECH,1759,1759,0
Carrancas,311460,MG,Sudeste,FIOCRUZ/ASTRAZENECA,1171,1080,91
Carrancas,311460,MG,Sudeste,BUTANTAN/SINOVAC,1082,541,541
Carrancas,311460,MG,Sudeste,PFIZER/BIONTECH,23,23,0
Carrapateira,250410,PB,Nordeste,BUTANTAN/SINOVAC,597,306,291
Carrapateira,250410,PB,Nordeste,FIOCRUZ/ASTRAZENECA,439,408,31
Carrapateira,250410,PB,Nordeste,PFIZER/BIONTECH,48,48,0
Carrasco Bonito,170389,TO,Norte,BUTANTAN/SINOVAC,648,332,316
Carrasco Bonito,170389,TO,Norte,FIOCRUZ/ASTRAZENECA,596,558,38
Caruaru,260410,PE,Nordeste,FIOCRUZ/ASTRAZENECA,65761,61330,4431
Caruaru,260410,PE,Nordeste,BUTANTAN/SINOVAC,62759,32278,30481
Caruaru,260410,PE,Nordeste,PFIZER/BIONTECH,12804,12777,27
Carutapera,210290,MA,Nordeste,FIOCRUZ/ASTRAZENECA,3435,3168,267
Carutapera,210290,MA,Nordeste,BUTANTAN/SINOVAC,2896,1557,1339
Carvalhópolis,311470,MG,Sudeste,BUTANTAN/SINOVAC,1091,547,544
Carvalhópolis,311470,MG,Sudeste,FIOCRUZ/ASTRAZENECA,927,829,98
Carvalhópolis,311470,MG,Sudeste,PFIZER/BIONTECH,40,40,0
Carvalhos,311480,MG,Sudeste,FIOCRUZ/ASTRAZENECA,1399,1305,94
Carvalhos,311480,MG,Sudeste,BUTANTAN/SINOVAC,1225,627,598
Carvalhos,311480,MG,Sudeste,PFIZER/BIONTECH,5,5,0
Casa Branca,351080,SP,Sudeste,BUTANTAN/SINOVAC,7240,3908,3332
Casa Branca,351080,SP,Sudeste,FIOCRUZ/ASTRAZENECA,5422,4942,480
Casa Branca,351080,SP,Sudeste,PFIZER/BIONTECH,322,322,0
Casa Grande,311490,MG,Sudeste,BUTANTAN/SINOVAC,597,313,284
Casa Grande,311490,MG,Sudeste,FIOCRUZ/ASTRAZENECA,591,461,130
Casa Grande,311490,MG,Sudeste,PFIZER/BIONTECH,54,54,0
Casa Nova,290720,BA,Nordeste,FIOCRUZ/ASTRAZENECA,12181,11292,889
Casa Nova,290720,BA,Nordeste,BUTANTAN/SINOVAC,11866,6261,5605
Casa Nova,290720,BA,Nordeste,PFIZER/BIONTECH,275,274,1
Casca,430490,RS,Sul,FIOCRUZ/ASTRAZENECA,3156,2727,429
Casca,430490,RS,Sul,BUTANTAN/SINOVAC,2623,1335,1288
Casca,430490,RS,Sul,PFIZER/BIONTECH,307,307,0
Cascalho Rico,311500,MG,Sudeste,BUTANTAN/SINOVAC,861,453,408
Cascalho Rico,311500,MG,Sudeste,FIOCRUZ/ASTRAZENECA,767,684,83
Cascalho Rico,311500,MG,Sudeste,PFIZER/BIONTECH,54,54,0
Cascavel,230350,CE,Nordeste,FIOCRUZ/ASTRAZENECA,5535,5352,183
Cascavel,230350,CE,Nordeste,BUTANTAN/SINOVAC,2102,1355,747
Cascavel,230350,CE,Nordeste,PFIZER/BIONTECH,663,663,0
Cascavel,410480,PR,Sul,FIOCRUZ/ASTRAZENECA,82614,73895,8719
Cascavel,410480,PR,Sul,BUTANTAN/SINOVAC,64485,32605,31880
Cascavel,410480,PR,Sul,PFIZER/BIONTECH,18529,18520,9
Caseara,170390,TO,Norte,BUTANTAN/SINOVAC,798,418,380
Caseara,170390,TO,Norte,FIOCRUZ/ASTRAZENECA,636,618,18
Caseiros,430495,RS,Sul,BUTANTAN/SINOVAC,907,455,452
Caseiros,430495,RS,Sul,FIOCRUZ/ASTRAZENECA,836,776,60
Caseiros,430495,RS,Sul,PFIZER/BIONTECH,150,150,0
Casimiro De Abreu,330130,RJ,Sudeste,BUTANTAN/SINOVAC,10123,5670,4453
Casimiro De Abreu,330130,RJ,Sudeste,FIOCRUZ/ASTRAZENECA,6040,5496,544
Casimiro De Abreu,330130,RJ,Sudeste,PFIZER/BIONTECH,826,823,3
Casinhas,260415,PE,Nordeste,FIOCRUZ/ASTRAZENECA,3387,3148,239
Casinhas,260415,PE,Nordeste,BUTANTAN/SINOVAC,2379,1320,1059
Casinhas,260415,PE,Nordeste,PFIZER/BIONTECH,277,277,0
Casserengue,250415,PB,Nordeste,BUTANTAN/SINOVAC,1861,1034,827
Casserengue,250415,PB,Nordeste,FIOCRUZ/ASTRAZENECA,885,759,126
Casserengue,250415,PB,Nordeste,PFIZER/BIONTECH,30,30,0
Cássia,311510,MG,Sudeste,BUTANTAN/SINOVAC,4336,2231,2105
Cássia,311510,MG,Sudeste,FIOCRUZ/ASTRAZENECA,3836,3536,300
Cássia,311510,MG,Sudeste,PFIZER/BIONTECH,499,499,0
Cássia Dos Coqueiros,351090,SP,Sudeste,BUTANTAN/SINOVAC,1570,852,718
Cássia Dos Coqueiros,351090,SP,Sudeste,FIOCRUZ/ASTRAZENECA,1296,1195,101
Cássia Dos Coqueiros,351090,SP,Sudeste,PFIZER/BIONTECH,74,74,0
Cassilândia,500290,MS,Centro-Oeste,FIOCRUZ/ASTRAZENECA,7390,6499,891
Cassilândia,500290,MS,Centro-Oeste,BUTANTAN/SINOVAC,6961,3712,3249
Cassilândia,500290,MS,Centro-Oeste,PFIZER/BIONTECH,764,762,2
Castanhal,150240,PA,Norte,FIOCRUZ/ASTRAZENECA,23205,21105,2100
Castanhal,150240,PA,Norte,BUTANTAN/SINOVAC,22466,13066,9400
Castanheira,510285,MT,Centro-Oeste,FIOCRUZ/ASTRAZENECA,1821,1712,109
Castanheira,510285,MT,Centro-Oeste,BUTANTAN/SINOVAC,1270,645,625
Castanheiras,110090,RO,Norte,BUTANTAN/SINOVAC,893,466,427
Castanheiras,110090,RO,Norte,FIOCRUZ/ASTRAZENECA,841,809,32
Castanheiras,110090,RO,Norte,PFIZER/BIONTECH,102,102,0
Castelândia,520505,GO,Centro-Oeste,FIOCRUZ/ASTRAZENECA,878,820,58
Castelândia,520505,GO,Centro-Oeste,BUTANTAN/SINOVAC,729,402,327
Castelo,320140,ES,Sudeste,BUTANTAN/SINOVAC,10221,5229,4992
Castelo,320140,ES,Sudeste,FIOCRUZ/ASTRAZENECA,8249,7785,464
Castelo,320140,ES,Sudeste,PFIZER/BIONTECH,1203,1203,0
Castelo Do Piauí,220260,PI,Nordeste,FIOCRUZ/ASTRAZENECA,3926,3650,276
Castelo Do Piauí,220260,PI,Nordeste,BUTANTAN/SINOVAC,3609,1868,1741
Castelo Do Piauí,220260,PI,Nordeste,PFIZER/BIONTECH,114,114,0
Castilho,351100,SP,Sudeste,BUTANTAN/SINOVAC,5712,3118,2594
Castilho,351100,SP,Sudeste,FIOCRUZ/ASTRAZENECA,4753,4428,325
Castilho,351100,SP,Sudeste,PFIZER/BIONTECH,513,513,0
Castro,410490,PR,Sul,FIOCRUZ/ASTRAZENECA,13793,12811,982
Castro,410490,PR,Sul,BUTANTAN/SINOVAC,10866,5670,5196
Castro,410490,PR,Sul,PFIZER/BIONTECH,3201,3198,3
Castro Alves,290730,BA,Nordeste,FIOCRUZ/ASTRAZENECA,5288,4941,347
Castro Alves,290730,BA,Nordeste,BUTANTAN/SINOVAC,4576,2352,2224
Castro Alves,290730,BA,Nordeste,PFIZER/BIONTECH,735,734,1
Cataguases,311530,MG,Sudeste,BUTANTAN/SINOVAC,16604,8492,8112
Cataguases,311530,MG,Sudeste,FIOCRUZ/ASTRAZENECA,13747,12815,932
Cataguases,311530,MG,Sudeste,PFIZER/BIONTECH,1151,1150,1
Catalão,520510,GO,Centro-Oeste,FIOCRUZ/ASTRAZENECA,27685,25311,2374
Catalão,520510,GO,Centro-Oeste,BUTANTAN/SINOVAC,13897,7499,6398
Catalão,520510,GO,Centro-Oeste,PFIZER/BIONTECH,3535,3524,11
Catanduva,351110,SP,Sudeste,BUTANTAN/SINOVAC,35093,19847,15246
Catanduva,351110,SP,Sudeste,FIOCRUZ/ASTRAZENECA,30324,26884,3440
Catanduva,351110,SP,Sudeste,PFIZER/BIONTECH,2384,2380,4
Catanduvas,410500,PR,Sul,FIOCRUZ/ASTRAZENECA,2483,2362,121
Catanduvas,410500,PR,Sul,BUTANTAN/SINOVAC,1802,954,848
Catanduvas,410500,PR,Sul,PFIZER/BIONTECH,121,121,0
Catanduvas,420400,SC,Sul,FIOCRUZ/ASTRAZENECA,2743,2589,154
Catanduvas,420400,SC,Sul,BUTANTAN/SINOVAC,1944,998,946
Catanduvas,420400,SC,Sul,PFIZER/BIONTECH,149,149,0
Catarina,230360,CE,Nordeste,BUTANTAN/SINOVAC,3501,1872,1629
Catarina,230360,CE,Nordeste,FIOCRUZ/ASTRAZENECA,1170,943,227
Catarina,230360,CE,Nordeste,PFIZER/BIONTECH,2,2,0
Catas Altas,311535,MG,Sudeste,FIOCRUZ/ASTRAZENECA,1581,1409,172
Catas Altas,311535,MG,Sudeste,BUTANTAN/SINOVAC,1301,657,644
Catas Altas,311535,MG,Sudeste,PFIZER/BIONTECH,55,55,0
Catas Altas Da Noruega,311540,MG,Sudeste,FIOCRUZ/ASTRAZENECA,936,752,184
Catas Altas Da Noruega,311540,MG,Sudeste,BUTANTAN/SINOVAC,850,472,378
Catas Altas Da Noruega,311540,MG,Sudeste,PFIZER/BIONTECH,58,58,0
Catende,260420,PE,Nordeste,BUTANTAN/SINOVAC,5175,2741,2434
Catende,260420,PE,Nordeste,FIOCRUZ/ASTRAZENECA,3926,3620,306
Catende,260420,PE,Nordeste,PFIZER/BIONTECH,294,291,3
Catiguá,351120,SP,Sudeste,FIOCRUZ/ASTRAZENECA,1966,1819,147
Catiguá,351120,SP,Sudeste,BUTANTAN/SINOVAC,1895,1067,828
Catiguá,351120,SP,Sudeste,PFIZER/BIONTECH,180,180,0
Catingueira,250420,PB,Nordeste,BUTANTAN/SINOVAC,1087,560,527
Catingueira,250420,PB,Nordeste,FIOCRUZ/ASTRAZENECA,823,762,61
Catingueira,250420,PB,Nordeste,PFIZER/BIONTECH,111,111,0
Catolândia,290740,BA,Nordeste,BUTANTAN/SINOVAC,1656,863,793
Catolândia,290740,BA,Nordeste,FIOCRUZ/ASTRAZENECA,1612,1318,294
Catolândia,290740,BA,Nordeste,PFIZER/BIONTECH,34,34,0
Catolé Do Rocha,250430,PB,Nordeste,BUTANTAN/SINOVAC,6834,3427,3407
Catolé Do Rocha,250430,PB,Nordeste,FIOCRUZ/ASTRAZENECA,5770,5237,533
Catolé Do Rocha,250430,PB,Nordeste,PFIZER/BIONTECH,442,442,0
Catu,290750,BA,Nordeste,FIOCRUZ/ASTRAZENECA,9039,8426,613
Catu,290750,BA,Nordeste,BUTANTAN/SINOVAC,8388,4216,4172
Catu,290750,BA,Nordeste,PFIZER/BIONTECH,808,808,0
Catuípe,430500,RS,Sul,BUTANTAN/SINOVAC,2942,1491,1451
Catuípe,430500,RS,Sul,FIOCRUZ/ASTRAZENECA,2640,2293,347
Catuípe,430500,RS,Sul,PFIZER/BIONTECH,346,346,0
Catuji,311545,MG,Sudeste,BUTANTAN/SINOVAC,1005,516,489
Catuji,311545,MG,Sudeste,FIOCRUZ/ASTRAZENECA,944,939,5
Catuji,311545,MG,Sudeste,PFIZER/BIONTECH,10,10,0
Catunda,230365,CE,Nordeste,FIOCRUZ/ASTRAZENECA,2168,1934,234
Catunda,230365,CE,Nordeste,BUTANTAN/SINOVAC,2149,1077,1072
Catunda,230365,CE,Nordeste,PFIZER/BIONTECH,22,22,0
Caturaí,520520,GO,Centro-Oeste,FIOCRUZ/ASTRAZENECA,1341,1275,66
Caturaí,520520,GO,Centro-Oeste,BUTANTAN/SINOVAC,1189,708,481
Caturaí,520520,GO,Centro-Oeste,PFIZER/BIONTECH,71,71,0
Caturama,290755,BA,Nordeste,FIOCRUZ/ASTRAZENECA,3881,3551,330
Caturama,290755,BA,Nordeste,BUTANTAN/SINOVAC,2733,1344,1389
Caturama,290755,BA,Nordeste,PFIZER/BIONTECH,30,30,0
Caturité,250435,PB,Nordeste,BUTANTAN/SINOVAC,1170,590,580
Caturité,250435,PB,Nordeste,FIOCRUZ/ASTRAZENECA,653,613,40
Caturité,250435,PB,Nordeste,PFIZER/BIONTECH,34,34,0
Catuti,311547,MG,Sudeste,FIOCRUZ/ASTRAZENECA,1139,1086,53
Catuti,311547,MG,Sudeste,BUTANTAN/SINOVAC,1039,529,510
Catuti,311547,MG,Sudeste,PFIZER/BIONTECH,35,35,0
Caucaia,230370,CE,Nordeste,BUTANTAN/SINOVAC,54342,30858,23484
Caucaia,230370,CE,Nordeste,FIOCRUZ/ASTRAZENECA,12768,11709,1059
Cavalcante,520530,GO,Centro-Oeste,BUTANTAN/SINOVAC,5814,2998,2816
Cavalcante,520530,GO,Centro-Oeste,FIOCRUZ/ASTRAZENECA,3010,2707,303
Cavalcante,520530,GO,Centro-Oeste,PFIZER/BIONTECH,18,18,0
Caxambu,311550,MG,Sudeste,BUTANTAN/SINOVAC,5503,2778,2725
Caxambu,311550,MG,Sudeste,FIOCRUZ/ASTRAZENECA,5360,4805,555
Caxambu,311550,MG,Sudeste,PFIZER/BIONTECH,202,202,0
Caxambu Do Sul,420410,SC,Sul,BUTANTAN/SINOVAC,1274,658,616
Caxambu Do Sul,420410,SC,Sul,FIOCRUZ/ASTRAZENECA,1235,1140,95
Caxambu Do Sul,420410,SC,Sul,PFIZER/BIONTECH,70,70,0
Caxias,210300,MA,Nordeste,FIOCRUZ/ASTRAZENECA,42324,39973,2351
Caxias,210300,MA,Nordeste,BUTANTAN/SINOVAC,30108,16071,14037
Caxias,210300,MA,Nordeste,PFIZER/BIONTECH,4958,4954,4
Caxias Do Sul,430510,RS,Sul,FIOCRUZ/ASTRAZENECA,131486,119645,11841
Caxias Do Sul,430510,RS,Sul,BUTANTAN/SINOVAC,104650,52724,51926
Caxias Do Sul,430510,RS,Sul,PFIZER/BIONTECH,12897,12882,15
Caxingó,220265,PI,Nordeste,BUTANTAN/SINOVAC,618,341,277
Caxingó,220265,PI,Nordeste,FIOCRUZ/ASTRAZENECA,560,535,25
Ceará-Mirim,240260,RN,Nordeste,FIOCRUZ/ASTRAZENECA,14659,13534,1125
Ceará-Mirim,240260,RN,Nordeste,BUTANTAN/SINOVAC,11284,5802,5482
Ceará-Mirim,240260,RN,Nordeste,PFIZER/BIONTECH,886,885,1
Cedral,210310,MA,Nordeste,FIOCRUZ/ASTRAZENECA,4536,3736,800
Cedral,210310,MA,Nordeste,BUTANTAN/SINOVAC,1688,871,817
Cedral,351130,SP,Sudeste,BUTANTAN/SINOVAC,3023,1746,1277
Cedral,351130,SP,Sudeste,FIOCRUZ/ASTRAZENECA,2626,2335,291
Cedral,351130,SP,Sudeste,PFIZER/BIONTECH,273,272,1
Cedro,230380,CE,Nordeste,BUTANTAN/SINOVAC,5667,3018,2649
Cedro,230380,CE,Nordeste,FIOCRUZ/ASTRAZENECA,2818,2346,472
Cedro,230380,CE,Nordeste,PFIZER/BIONTECH,1,1,0
Cedro,260430,PE,Nordeste,FIOCRUZ/ASTRAZENECA,2135,1929,206
Cedro,260430,PE,Nordeste,BUTANTAN/SINOVAC,2001,1014,987
Cedro,260430,PE,Nordeste,PFIZER/BIONTECH,330,330,0
Cedro De São João,280160,SE,Nordeste,BUTANTAN/SINOVAC,1461,758,703
Cedro De São João,280160,SE,Nordeste,FIOCRUZ/ASTRAZENECA,1136,1122,14
Cedro De São João,280160,SE,Nordeste,PFIZER/BIONTECH,153,153,0
Cedro Do Abaeté,311560,MG,Sudeste,BUTANTAN/SINOVAC,482,253,229
Cedro Do Abaeté,311560,MG,Sudeste,FIOCRUZ/ASTRAZENECA,399,358,41
Cedro Do Abaeté,311560,MG,Sudeste,PFIZER/BIONTECH,40,40,0
Celso Ramos,420415,SC,Sul,BUTANTAN/SINOVAC,779,403,376
Celso Ramos,420415,SC,Sul,FIOCRUZ/ASTRAZENECA,768,744,24
Celso Ramos,420415,SC,Sul,PFIZER/BIONTECH,66,66,0
Centenário,170410,TO,Norte,FIOCRUZ/ASTRAZENECA,519,487,32
Centenário,170410,TO,Norte,BUTANTAN/SINOVAC,516,271,245
Centenário,430511,RS,Sul,BUTANTAN/SINOVAC,1088,542,546
Centenário,430511,RS,Sul,FIOCRUZ/ASTRAZENECA,986,903,83
Centenário,430511,RS,Sul,PFIZER/BIONTECH,31,31,0
Centenário Do Sul,410510,PR,Sul,FIOCRUZ/ASTRAZENECA,3228,3032,196
Centenário Do Sul,410510,PR,Sul,BUTANTAN/SINOVAC,2441,1273,1168
Centenário Do Sul,410510,PR,Sul,PFIZER/BIONTECH,138,138,0
Central,290760,BA,Nordeste,FIOCRUZ/ASTRAZENECA,5745,4860,885
Central,290760,BA,Nordeste,BUTANTAN/SINOVAC,3592,1838,1754
Central,290760,BA,Nordeste,PFIZER/BIONTECH,165,162,3
Central De Minas,311570,MG,Sudeste,BUTANTAN/SINOVAC,1404,821,583
Central De Minas,311570,MG,Sudeste,FIOCRUZ/ASTRAZENECA,961,868,93
Central De Minas,311570,MG,Sudeste,PFIZER/BIONTECH,31,30,1
Central Do Maranhão,210312,MA,Nordeste,FIOCRUZ/ASTRAZENECA,2256,2161,95
Central Do Maranhão,210312,MA,Nordeste,BUTANTAN/SINOVAC,1156,608,548
Centralina,311580,MG,Sudeste,BUTANTAN/SINOVAC,2205,1114,1091
Centralina,311580,MG,Sudeste,FIOCRUZ/ASTRAZENECA,1811,1640,171
Centralina,311580,MG,Sudeste,PFIZER/BIONTECH,188,188,0
Centro Do Guilherme,210315,MA,Nordeste,FIOCRUZ/ASTRAZENECA,1540,1469,71
Centro Do Guilherme,210315,MA,Nordeste,BUTANTAN/SINOVAC,1292,761,531
Centro Novo Do Maranhão,210317,MA,Nordeste,FIOCRUZ/ASTRAZENECA,3028,2882,146
Centro Novo Do Maranhão,210317,MA,Nordeste,BUTANTAN/SINOVAC,2323,1266,1057
Cerejeiras,110005,RO,Norte,BUTANTAN/SINOVAC,3305,1689,1616
Cerejeiras,110005,RO,Norte,FIOCRUZ/ASTRAZENECA,3006,2860,146
Cerejeiras,110005,RO,Norte,PFIZER/BIONTECH,335,334,1
Ceres,520540,GO,Centro-Oeste,FIOCRUZ/ASTRAZENECA,4693,4578,115
Ceres,520540,GO,Centro-Oeste,BUTANTAN/SINOVAC,3404,2269,1135
Ceres,520540,GO,Centro-Oeste,PFIZER/BIONTECH,1010,1010,0
Cerqueira César,351140,SP,Sudeste,BUTANTAN/SINOVAC,5632,3254,2378
Cerqueira César,351140,SP,Sudeste,FIOCRUZ/ASTRAZENECA,4574,4295,279
Cerqueira César,351140,SP,Sudeste,PFIZER/BIONTECH,849,849,0
Cerquilho,351150,SP,Sudeste,FIOCRUZ/ASTRAZENECA,11551,10802,749
Cerquilho,351150,SP,Sudeste,BUTANTAN/SINOVAC,8031,4436,3595
Cerquilho,351150,SP,Sudeste,PFIZER/BIONTECH,393,393,0
Cerrito,430512,RS,Sul,BUTANTAN/SINOVAC,2134,1090,1044
Cerrito,430512,RS,Sul,FIOCRUZ/ASTRAZENECA,1988,1697,291
Cerrito,430512,RS,Sul,PFIZER/BIONTECH,101,101,0
Cerro Azul,410520,PR,Sul,FIOCRUZ/ASTRAZENECA,3874,3727,147
Cerro Azul,410520,PR,Sul,BUTANTAN/SINOVAC,3102,1590,1512
Cerro Azul,410520,PR,Sul,PFIZER/BIONTECH,80,80,0
Cerro Branco,430513,RS,Sul,BUTANTAN/SINOVAC,1430,718,712
Cerro Branco,430513,RS,Sul,FIOCRUZ/ASTRAZENECA,984,882,102
Cerro Branco,430513,RS,Sul,PFIZER/BIONTECH,129,129,0
Cerro Corá,240270,RN,Nordeste,BUTANTAN/SINOVAC,2087,1019,1068
Cerro Corá,240270,RN,Nordeste,FIOCRUZ/ASTRAZENECA,1886,1721,165
Cerro Corá,240270,RN,Nordeste,PFIZER/BIONTECH,186,184,2
Cerro Grande,430515,RS,Sul,BUTANTAN/SINOVAC,721,372,349
Cerro Grande,430515,RS,Sul,FIOCRUZ/ASTRAZENECA,658,602,56
Cerro Grande,430515,RS,Sul,PFIZER/BIONTECH,104,104,0
Cerro Grande Do Sul,430517,RS,Sul,FIOCRUZ/ASTRAZENECA,2571,2437,134
Cerro Grande Do Sul,430517,RS,Sul,BUTANTAN/SINOVAC,2211,1113,1098
Cerro Grande Do Sul,430517,RS,Sul,PFIZER/BIONTECH,167,167,0
Cerro Largo,430520,RS,Sul,BUTANTAN/SINOVAC,4100,2065,2035
Cerro Largo,430520,RS,Sul,FIOCRUZ/ASTRAZENECA,3574,3134,440
Cerro Largo,430520,RS,Sul,PFIZER/BIONTECH,598,596,2
Cerro Negro,420417,SC,Sul,FIOCRUZ/ASTRAZENECA,1221,1155,66
Cerro Negro,420417,SC,Sul,BUTANTAN/SINOVAC,1042,550,492
Cesário Lange,351160,SP,Sudeste,FIOCRUZ/ASTRAZENECA,3831,3619,212
Cesário Lange,351160,SP,Sudeste,BUTANTAN/SINOVAC,3674,2075,1599
Cesário Lange,351160,SP,Sudeste,PFIZER/BIONTECH,397,397,0
Céu Azul,410530,PR,Sul,FIOCRUZ/ASTRAZENECA,2613,2470,143
Céu Azul,410530,PR,Sul,BUTANTAN/SINOVAC,2426,1274,1152
Céu Azul,410530,PR,Sul,PFIZER/BIONTECH,159,159,0
Cezarina,520545,GO,Centro-Oeste,FIOCRUZ/ASTRAZENECA,1700,1617,83
Cezarina,520545,GO,Centro-Oeste,BUTANTAN/SINOVAC,1342,694,648
Chã De Alegria,260440,PE,Nordeste,BUTANTAN/SINOVAC,2524,1336,1188
Chã De Alegria,260440,PE,Nordeste,FIOCRUZ/ASTRAZENECA,2084,1874,210
Chã De Alegria,260440,PE,Nordeste,PFIZER/BIONTECH,99,99,0
Chã Grande,260450,PE,Nordeste,FIOCRUZ/ASTRAZENECA,4434,4111,323
Chã Grande,260450,PE,Nordeste,BUTANTAN/SINOVAC,3500,1778,1722
Chã Grande,260450,PE,Nordeste,PFIZER/BIONTECH,370,370,0
Chã Preta,270190,AL,Nordeste,FIOCRUZ/ASTRAZENECA,1307,1132,175
Chã Preta,270190,AL,Nordeste,BUTANTAN/SINOVAC,1131,559,572
Chã Preta,270190,AL,Nordeste,PFIZER/BIONTECH,104,104,0
Chácara,311590,MG,Sudeste,FIOCRUZ/ASTRAZENECA,1404,1316,88
Chácara,311590,MG,Sudeste,BUTANTAN/SINOVAC,882,474,408
Chácara,311590,MG,Sudeste,PFIZER/BIONTECH,102,102,0
Chalé,311600,MG,Sudeste,FIOCRUZ/ASTRAZENECA,1797,1535,262
Chalé,311600,MG,Sudeste,BUTANTAN/SINOVAC,1295,654,641
Chalé,311600,MG,Sudeste,PFIZER/BIONTECH,116,116,0
Chapada,430530,RS,Sul,BUTANTAN/SINOVAC,3015,1519,1496
Chapada,430530,RS,Sul,FIOCRUZ/ASTRAZENECA,2531,2294,237
Chapada,430530,RS,Sul,PFIZER/BIONTECH,366,366,0
Chapada Da Natividade,170510,TO,Norte,FIOCRUZ/ASTRAZENECA,767,732,35
Chapada Da Natividade,170510,TO,Norte,BUTANTAN/SINOVAC,695,364,331
Chapada De Areia,170460,TO,Norte,BUTANTAN/SINOVAC,416,213,203
Chapada De Areia,170460,TO,Norte,FIOCRUZ/ASTRAZENECA,330,309,21
Chapada Do Norte,311610,MG,Sudeste,FIOCRUZ/ASTRAZENECA,3736,3558,178
Chapada Do Norte,311610,MG,Sudeste,BUTANTAN/SINOVAC,2096,1058,1038
Chapada Do Norte,311610,MG,Sudeste,PFIZER/BIONTECH,168,168,0
Chapada Dos Guimarães,510300,MT,Centro-Oeste,BUTANTAN/SINOVAC,4566,2349,2217
Chapada Dos Guimarães,510300,MT,Centro-Oeste,FIOCRUZ/ASTRAZENECA,4102,3862,240
Chapada Dos Guimarães,510300,MT,Centro-Oeste,PFIZER/BIONTECH,170,170,0
Chapada Gaúcha,311615,MG,Sudeste,BUTANTAN/SINOVAC,2701,1363,1338
Chapada Gaúcha,311615,MG,Sudeste,FIOCRUZ/ASTRAZENECA,1520,1360,160
Chapada Gaúcha,311615,MG,Sudeste,PFIZER/BIONTECH,28,28,0
Chapadão Do Céu,520547,GO,Centro-Oeste,FIOCRUZ/ASTRAZENECA,1591,1510,81
Chapadão Do Céu,520547,GO,Centro-Oeste,BUTANTAN/SINOVAC,876,450,426
Chapadão Do Céu,520547,GO,Centro-Oeste,PFIZER/BIONTECH,90,90,0
Chapadão Do Lageado,420419,SC,Sul,FIOCRUZ/ASTRAZENECA,690,650,40
Chapadão Do Lageado,420419,SC,Sul,BUTANTAN/SINOVAC,560,284,276
Chapadão Do Lageado,420419,SC,Sul,PFIZER/BIONTECH,60,60,0
Chapadão Do Sul,500295,MS,Centro-Oeste,FIOCRUZ/ASTRAZENECA,4972,4620,352
Chapadão Do Sul,500295,MS,Centro-Oeste,BUTANTAN/SINOVAC,3165,1594,1571
Chapadão Do Sul,500295,MS,Centro-Oeste,PFIZER/BIONTECH,845,845,0
Chapadinha,210320,MA,Nordeste,FIOCRUZ/ASTRAZENECA,13168,12465,703
Chapadinha,210320,MA,Nordeste,BUTANTAN/SINOVAC,8975,4580,4395
Chapadinha,210320,MA,Nordeste,PFIZER/BIONTECH,1714,1714,0
Chapecó,420420,SC,Sul,FIOCRUZ/ASTRAZENECA,59359,54762,4597
Chapecó,420420,SC,Sul,BUTANTAN/SINOVAC,47703,25674,22029
Chapecó,420420,SC,Sul,PFIZER/BIONTECH,5987,5982,5
Charqueada,351170,SP,Sudeste,FIOCRUZ/ASTRAZENECA,3935,3747,188
Charqueada,351170,SP,Sudeste,BUTANTAN/SINOVAC,3290,1780,1510
Charqueada,351170,SP,Sudeste,PFIZER/BIONTECH,136,136,0
Charqueadas,430535,RS,Sul,BUTANTAN/SINOVAC,9366,4824,4542
Charqueadas,430535,RS,Sul,FIOCRUZ/ASTRAZENECA,8695,7945,750
Charqueadas,430535,RS,Sul,PFIZER/BIONTECH,572,572,0
Charrua,430537,RS,Sul,BUTANTAN/SINOVAC,2506,1243,1263
Charrua,430537,RS,Sul,FIOCRUZ/ASTRAZENECA,714,616,98
Charrua,430537,RS,Sul,PFIZER/BIONTECH,102,102,0
Chaval,230390,CE,Nordeste,BUTANTAN/SINOVAC,2129,1160,969
Chaval,230390,CE,Nordeste,FIOCRUZ/ASTRAZENECA,911,765,146
Chaval,230390,CE,Nordeste,PFIZER/BIONTECH,10,10,0
Chavantes,355720,SP,Sudeste,BUTANTAN/SINOVAC,2760,1432,1328
Chavantes,355720,SP,Sudeste,FIOCRUZ/ASTRAZENECA,1900,1809,91
Chavantes,355720,SP,Sudeste,PFIZER/BIONTECH,40,40,0
Chaves,150250,PA,Norte,FIOCRUZ/ASTRAZENECA,3585,3443,142
Chaves,150250,PA,Norte,BUTANTAN/SINOVAC,825,442,383
Chiador,311620,MG,Sudeste,BUTANTAN/SINOVAC,815,411,404
Chiador,311620,MG,Sudeste,FIOCRUZ/ASTRAZENECA,790,713,77
Chiador,311620,MG,Sudeste,PFIZER/BIONTECH,22,22,0
Chiapetta,430540,RS,Sul,BUTANTAN/SINOVAC,1238,633,605
Chiapetta,430540,RS,Sul,FIOCRUZ/ASTRAZENECA,1129,982,147
Chiapetta,430540,RS,Sul,PFIZER/BIONTECH,166,166,0
Chopinzinho,410540,PR,Sul,BUTANTAN/SINOVAC,4914,2522,2392
Chopinzinho,410540,PR,Sul,FIOCRUZ/ASTRAZENECA,4636,4288,348
Chopinzinho,410540,PR,Sul,PFIZER/BIONTECH,255,255,0
Choró,230393,CE,Nordeste,BUTANTAN/SINOVAC,2127,1171,956
Choró,230393,CE,Nordeste,FIOCRUZ/ASTRAZENECA,436,417,19
Chorozinho,230395,CE,Nordeste,BUTANTAN/SINOVAC,2841,1521,1320
Chorozinho,230395,CE,Nordeste,FIOCRUZ/ASTRAZENECA,1127,940,187
Chorrochó,290770,BA,Nordeste,FIOCRUZ/ASTRAZENECA,1776,1549,227
Chorrochó,290770,BA,Nordeste,BUTANTAN/SINOVAC,1723,955,768
Chorrochó,290770,BA,Nordeste,PFIZER/BIONTECH,239,239,0
Chuí,430543,RS,Sul,BUTANTAN/SINOVAC,1377,695,682
Chuí,430543,RS,Sul,FIOCRUZ/ASTRAZENECA,546,461,85
Chuí,430543,RS,Sul,PFIZER/BIONTECH,53,53,0
Chupinguaia,110092,RO,Norte,BUTANTAN/SINOVAC,1198,646,552
Chupinguaia,110092,RO,Norte,FIOCRUZ/ASTRAZENECA,1189,1079,110
Chupinguaia,110092,RO,Norte,PFIZER/BIONTECH,13,13,0
Chuvisca,430544,RS,Sul,BUTANTAN/SINOVAC,1127,691,436
Chuvisca,430544,RS,Sul,FIOCRUZ/ASTRAZENECA,703,645,58
Chuvisca,430544,RS,Sul,PFIZER/BIONTECH,24,24,0
Cianorte,410550,PR,Sul,FIOCRUZ/ASTRAZENECA,19451,18314,1137
Cianorte,410550,PR,Sul,BUTANTAN/SINOVAC,15616,8151,7465
Cianorte,410550,PR,Sul,PFIZER/BIONTECH,2073,2073,0
Cícero Dantas,290780,BA,Nordeste,BUTANTAN/SINOVAC,7504,4133,3371
Cícero Dantas,290780,BA,Nordeste,FIOCRUZ/ASTRAZENECA,6823,6495,328
Cícero Dantas,290780,BA,Nordeste,PFIZER/BIONTECH,587,587,0
Cidade Gaúcha,410560,PR,Sul,FIOCRUZ/ASTRAZENECA,3335,3165,170
Cidade Gaúcha,410560,PR,Sul,BUTANTAN/SINOVAC,2275,1160,1115
Cidade Gaúcha,410560,PR,Sul,PFIZER/BIONTECH,147,147,0
Cidade Ocidental,520549,GO,Centro-Oeste,FIOCRUZ/ASTRAZENECA,11988,11226,762
Cidade Ocidental,520549,GO,Centro-Oeste,BUTANTAN/SINOVAC,11732,6117,5615
Cidade Ocidental,520549,GO,Centro-Oeste,PFIZER/BIONTECH,9,4,5
Cidelândia,210325,MA,Nordeste,FIOCRUZ/ASTRAZENECA,2322,2172,150
Cidelândia,210325,MA,Nordeste,BUTANTAN/SINOVAC,1948,993,955
Cidreira,430545,RS,Sul,BUTANTAN/SINOVAC,5965,3155,2810
Cidreira,430545,RS,Sul,FIOCRUZ/ASTRAZENECA,5258,4911,347
Cidreira,430545,RS,Sul,PFIZER/BIONTECH,573,571,2
Cipó,290790,BA,Nordeste,FIOCRUZ/ASTRAZENECA,4807,4190,617
Cipó,290790,BA,Nordeste,BUTANTAN/SINOVAC,4389,2418,1971
Cipó,290790,BA,Nordeste,PFIZER/BIONTECH,390,389,1
Cipotânea,311630,MG,Sudeste,BUTANTAN/SINOVAC,1737,868,869
Cipotânea,311630,MG,Sudeste,FIOCRUZ/ASTRAZENECA,1619,1476,143
Cipotânea,311630,MG,Sudeste,PFIZER/BIONTECH,62,62,0
Ciríaco,430550,RS,Sul,BUTANTAN/SINOVAC,1600,808,792
Ciríaco,430550,RS,Sul,FIOCRUZ/ASTRAZENECA,1271,1161,110
Ciríaco,430550,RS,Sul,PFIZER/BIONTECH,161,161,0
Claraval,311640,MG,Sudeste,BUTANTAN/SINOVAC,965,493,472
Claraval,311640,MG,Sudeste,FIOCRUZ/ASTRAZENECA,692,686,6
Claraval,311640,MG,Sudeste,PFIZER/BIONTECH,39,39,0
Claro Dos Poções,311650,MG,Sudeste,FIOCRUZ/ASTRAZENECA,1877,1767,110
Claro Dos Poções,311650,MG,Sudeste,BUTANTAN/SINOVAC,1839,946,893
Claro Dos Poções,311650,MG,Sudeste,PFIZER/BIONTECH,140,140,0
Cláudia,510305,MT,Centro-Oeste,FIOCRUZ/ASTRAZENECA,2327,2236,91
Cláudia,510305,MT,Centro-Oeste,BUTANTAN/SINOVAC,1460,757,703
Cláudia,510305,MT,Centro-Oeste,PFIZER/BIONTECH,37,37,0
Cláudio,311660,MG,Sudeste,FIOCRUZ/ASTRAZENECA,5595,5121,474
Cláudio,311660,MG,Sudeste,BUTANTAN/SINOVAC,4977,2530,2447
Cláudio,311660,MG,Sudeste,PFIZER/BIONTECH,356,355,1
Clementina,351190,SP,Sudeste,BUTANTAN/SINOVAC,1855,976,879
Clementina,351190,SP,Sudeste,FIOCRUZ/ASTRAZENECA,1761,1638,123
Clementina,351190,SP,Sudeste,PFIZER/BIONTECH,142,142,0
Clevelândia,410570,PR,Sul,FIOCRUZ/ASTRAZENECA,3627,3400,227
Clevelândia,410570,PR,Sul,BUTANTAN/SINOVAC,3461,1763,1698
Clevelândia,410570,PR,Sul,PFIZER/BIONTECH,482,482,0
Coaraci,290800,BA,Nordeste,BUTANTAN/SINOVAC,4893,2570,2323
Coaraci,290800,BA,Nordeste,FIOCRUZ/ASTRAZENECA,4597,4219,378
Coaraci,290800,BA,Nordeste,PFIZER/BIONTECH,209,209,0
Coari,130120,AM,Norte,FIOCRUZ/ASTRAZENECA,12909,10619,2290
Coari,130120,AM,Norte,BUTANTAN/SINOVAC,7260,4292,2968
Cocal,220270,PI,Nordeste,BUTANTAN/SINOVAC,3608,1945,1663
Cocal,220270,PI,Nordeste,FIOCRUZ/ASTRAZENECA,2947,2750,197
Cocal De Telha,220271,PI,Nordeste,BUTANTAN/SINOVAC,1072,545,527
Cocal De Telha,220271,PI,Nordeste,FIOCRUZ/ASTRAZENECA,855,772,83
Cocal De Telha,220271,PI,Nordeste,PFIZER/BIONTECH,58,58,0
Cocal Do Sul,420425,SC,Sul,BUTANTAN/SINOVAC,2711,1546,1165
Cocal Do Sul,420425,SC,Sul,FIOCRUZ/ASTRAZENECA,2305,2148,157
Cocal Dos Alves,220272,PI,Nordeste,FIOCRUZ/ASTRAZENECA,1388,1291,97
Cocal Dos Alves,220272,PI,Nordeste,BUTANTAN/SINOVAC,1018,538,480
Cocal Dos Alves,220272,PI,Nordeste,PFIZER/BIONTECH,117,117,0
Cocalinho,510310,MT,Centro-Oeste,BUTANTAN/SINOVAC,1137,583,554
Cocalinho,510310,MT,Centro-Oeste,FIOCRUZ/ASTRAZENECA,1110,1053,57
Cocalinho,510310,MT,Centro-Oeste,PFIZER/BIONTECH,76,76,0
Cocalzinho De Goiás,520551,GO,Centro-Oeste,FIOCRUZ/ASTRAZENECA,4130,3855,275
Cocalzinho De Goiás,520551,GO,Centro-Oeste,BUTANTAN/SINOVAC,2984,1563,1421
Cocalzinho De Goiás,520551,GO,Centro-Oeste,PFIZER/BIONTECH,177,177,0
Cocos,290810,BA,Nordeste,BUTANTAN/SINOVAC,3857,1994,1863
Cocos,290810,BA,Nordeste,FIOCRUZ/ASTRAZENECA,3589,3272,317
Cocos,290810,BA,Nordeste,PFIZER/BIONTECH,490,490,0
Codajás,130130,AM,Norte,BUTANTAN/SINOVAC,2835,1641,1194
Codajás,130130,AM,Norte,FIOCRUZ/ASTRAZENECA,2079,1585,494
Codó,210330,MA,Nordeste,FIOCRUZ/ASTRAZENECA,25753,24373,1380
Codó,210330,MA,Nordeste,BUTANTAN/SINOVAC,17823,9961,7862
Codó,210330,MA,Nordeste,PFIZER/BIONTECH,776,776,0
Coelho Neto,210340,MA,Nordeste,BUTANTAN/SINOVAC,9750,5420,4330
Coelho Neto,210340,MA,Nordeste,FIOCRUZ/ASTRAZENECA,9032,8507,525
Coimbra,311670,MG,Sudeste,FIOCRUZ/ASTRAZENECA,1753,1628,125
Coimbra,311670,MG,Sudeste,BUTANTAN/SINOVAC,1507,815,692
Coimbra,311670,MG,Sudeste,PFIZER/BIONTECH,150,150,0
Coité Do Nóia,270200,AL,Nordeste,FIOCRUZ/ASTRAZENECA,2434,2027,407
Coité Do Nóia,270200,AL,Nordeste,BUTANTAN/SINOVAC,2090,1069,1021
Coivaras,220273,PI,Nordeste,BUTANTAN/SINOVAC,964,503,461
Coivaras,220273,PI,Nordeste,FIOCRUZ/ASTRAZENECA,732,706,26
Coivaras,220273,PI,Nordeste,PFIZER/BIONTECH,78,78,0
Colares,150260,PA,Norte,FIOCRUZ/ASTRAZENECA,2552,2007,545
Colares,150260,PA,Norte,BUTANTAN/SINOVAC,1350,807,543
Colatina,320150,ES,Sudeste,BUTANTAN/SINOVAC,31343,17025,14318
Colatina,320150,ES,Sudeste,FIOCRUZ/ASTRAZENECA,31336,28513,2823
Colatina,320150,ES,Sudeste,PFIZER/BIONTECH,2394,2378,16
Colíder,510320,MT,Centro-Oeste,BUTANTAN/SINOVAC,8706,4578,4128
Colíder,510320,MT,Centro-Oeste,FIOCRUZ/ASTRAZENECA,6357,5584,773
Colíder,510320,MT,Centro-Oeste,PFIZER/BIONTECH,45,45,0
Colina,351200,SP,Sudeste,BUTANTAN/SINOVAC,4922,2767,2155
Colina,351200,SP,Sudeste,FIOCRUZ/ASTRAZENECA,4460,4002,458
Colina,351200,SP,Sudeste,PFIZER/BIONTECH,307,307,0
Colinas,210350,MA,Nordeste,FIOCRUZ/ASTRAZENECA,7106,6689,417
Colinas,210350,MA,Nordeste,BUTANTAN/SINOVAC,5234,2751,2483
Colinas,430558,RS,Sul,BUTANTAN/SINOVAC,1021,518,503
Colinas,430558,RS,Sul,FIOCRUZ/ASTRAZENECA,740,624,116
Colinas,430558,RS,Sul,PFIZER/BIONTECH,70,70,0
Colinas Do Sul,520552,GO,Centro-Oeste,FIOCRUZ/ASTRAZENECA,1008,924,84
Colinas Do Sul,520552,GO,Centro-Oeste,BUTANTAN/SINOVAC,582,299,283
Colinas Do Sul,520552,GO,Centro-Oeste,PFIZER/BIONTECH,39,39,0
Colinas Do Tocantins,170550,TO,Norte,BUTANTAN/SINOVAC,6029,3440,2589
Colinas Do Tocantins,170550,TO,Norte,FIOCRUZ/ASTRAZENECA,5544,5309,235
Colméia,171670,TO,Norte,BUTANTAN/SINOVAC,1525,791,734
Colméia,171670,TO,Norte,FIOCRUZ/ASTRAZENECA,1353,1291,62
Colniza,510325,MT,Centro-Oeste,BUTANTAN/SINOVAC,3355,1770,1585
Colniza,510325,MT,Centro-Oeste,FIOCRUZ/ASTRAZENECA,2007,1973,34
Colniza,510325,MT,Centro-Oeste,PFIZER/BIONTECH,109,109,0
Colômbia,351210,SP,Sudeste,BUTANTAN/SINOVAC,1794,965,829
Colômbia,351210,SP,Sudeste,FIOCRUZ/ASTRAZENECA,1635,1502,133
Colômbia,351210,SP,Sudeste,PFIZER/BIONTECH,133,133,0
Colombo,410580,PR,Sul,FIOCRUZ/ASTRAZENECA,42834,40647,2187
Colombo,410580,PR,Sul,BUTANTAN/SINOVAC,27988,14649,13339
Colombo,410580,PR,Sul,PFIZER/BIONTECH,7764,7741,23
Colônia Do Gurguéia,220275,PI,Nordeste,FIOCRUZ/ASTRAZENECA,1524,1423,101
Colônia Do Gurguéia,220275,PI,Nordeste,BUTANTAN/SINOVAC,1077,558,519
Colônia Do Gurguéia,220275,PI,Nordeste,PFIZER/BIONTECH,109,109,0
Colônia Do Piauí,220277,PI,Nordeste,FIOCRUZ/ASTRAZENECA,1954,1902,52
Colônia Do Piauí,220277,PI,Nordeste,BUTANTAN/SINOVAC,1691,854,837
Colônia Leopoldina,270210,AL,Nordeste,FIOCRUZ/ASTRAZENECA,2639,2411,228
Colônia Leopoldina,270210,AL,Nordeste,BUTANTAN/SINOVAC,2516,1306,1210
Colorado,410590,PR,Sul,BUTANTAN/SINOVAC,5422,2827,2595
Colorado,410590,PR,Sul,FIOCRUZ/ASTRAZENECA,4512,4221,291
Colorado,430560,RS,Sul,FIOCRUZ/ASTRAZENECA,1300,1205,95
Colorado,430560,RS,Sul,BUTANTAN/SINOVAC,1201,604,597
Colorado,430560,RS,Sul,PFIZER/BIONTECH,126,126,0
Colorado Do Oeste,110006,RO,Norte,BUTANTAN/SINOVAC,3579,1943,1636
Colorado Do Oeste,110006,RO,Norte,FIOCRUZ/ASTRAZENECA,3545,3501,44
Colorado Do Oeste,110006,RO,Norte,PFIZER/BIONTECH,334,334,0
Coluna,311680,MG,Sudeste,FIOCRUZ/ASTRAZENECA,2310,1863,447
Coluna,311680,MG,Sudeste,BUTANTAN/SINOVAC,1855,963,892
Coluna,311680,MG,Sudeste,PFIZER/BIONTECH,181,181,0
Combinado,170555,TO,Norte,BUTANTAN/SINOVAC,864,436,428
Combinado,170555,TO,Norte,FIOCRUZ/ASTRAZENECA,859,822,37
Comendador Gomes,311690,MG,Sudeste,FIOCRUZ/ASTRAZENECA,727,669,58
Comendador Gomes,311690,MG,Sudeste,BUTANTAN/SINOVAC,638,323,315
Comendador Gomes,311690,MG,Sudeste,PFIZER/BIONTECH,13,13,0
Comendador Levy Gasparian,330095,RJ,Sudeste,FIOCRUZ/ASTRAZENECA,2070,1834,236
Comendador Levy Gasparian,330095,RJ,Sudeste,BUTANTAN/SINOVAC,1978,874,1104
Comercinho,311700,MG,Sudeste,BUTANTAN/SINOVAC,1757,899,858
Comercinho,311700,MG,Sudeste,FIOCRUZ/ASTRAZENECA,1513,1362,151
Comercinho,311700,MG,Sudeste,PFIZER/BIONTECH,98,98,0
Comodoro,510330,MT,Centro-Oeste,FIOCRUZ/ASTRAZENECA,3258,2967,291
Comodoro,510330,MT,Centro-Oeste,BUTANTAN/SINOVAC,2999,1543,1456
Comodoro,510330,MT,Centro-Oeste,PFIZER/BIONTECH,228,228,0
Conceição,250440,PB,Nordeste,BUTANTAN/SINOVAC,4454,2273,2181
Conceição,250440,PB,Nordeste,FIOCRUZ/ASTRAZENECA,3827,3493,334
Conceição,250440,PB,Nordeste,PFIZER/BIONTECH,449,449,0
Conceição Da Aparecida,311710,MG,Sudeste,BUTANTAN/SINOVAC,2265,1160,1105
Conceição Da Aparecida,311710,MG,Sudeste,FIOCRUZ/ASTRAZENECA,2264,2058,206
Conceição Da Aparecida,311710,MG,Sudeste,PFIZER/BIONTECH,325,325,0
Conceição Da Barra,320160,ES,Sudeste,FIOCRUZ/ASTRAZENECA,9486,9311,175
Conceição Da Barra,320160,ES,Sudeste,BUTANTAN/SINOVAC,4330,2363,1967
Conceição Da Barra,320160,ES,Sudeste,PFIZER/BIONTECH,161,161,0
Conceição Da Barra De Minas,311520,MG,Sudeste,BUTANTAN/SINOVAC,954,485,469
Conceição Da Barra De Minas,311520,MG,Sudeste,FIOCRUZ/ASTRAZENECA,819,736,83
Conceição Da Barra De Minas,311520,MG,Sudeste,PFIZER/BIONTECH,41,41,0
Conceição Da Feira,290820,BA,Nordeste,FIOCRUZ/ASTRAZENECA,4149,3645,504
Conceição Da Feira,290820,BA,Nordeste,BUTANTAN/SINOVAC,3491,1881,1610
Conceição Da Feira,290820,BA,Nordeste,PFIZER/BIONTECH,809,809,0
Conceição Das Alagoas,311730,MG,Sudeste,FIOCRUZ/ASTRAZENECA,4765,4465,300
Conceição Das Alagoas,311730,MG,Sudeste,BUTANTAN/SINOVAC,3471,1798,1673
Conceição Das Alagoas,311730,MG,Sudeste,PFIZER/BIONTECH,687,686,1
Conceição Das Pedras,311720,MG,Sudeste,BUTANTAN/SINOVAC,830,436,394
Conceição Das Pedras,311720,MG,Sudeste,FIOCRUZ/ASTRAZENECA,588,531,57
Conceição Das Pedras,311720,MG,Sudeste,PFIZER/BIONTECH,84,84,0
Conceição De Ipanema,311740,MG,Sudeste,BUTANTAN/SINOVAC,1042,534,508
Conceição De Ipanema,311740,MG,Sudeste,FIOCRUZ/ASTRAZENECA,998,934,64
Conceição De Ipanema,311740,MG,Sudeste,PFIZER/BIONTECH,24,24,0
Conceição De Macabu,330140,RJ,Sudeste,BUTANTAN/SINOVAC,6238,3261,2977
Conceição De Macabu,330140,RJ,Sudeste,FIOCRUZ/ASTRAZENECA,4905,4227,678
Conceição De Macabu,330140,RJ,Sudeste,PFIZER/BIONTECH,1158,1158,0
Conceição Do Almeida,290830,BA,Nordeste,BUTANTAN/SINOVAC,3639,1905,1734
Conceição Do Almeida,290830,BA,Nordeste,FIOCRUZ/ASTRAZENECA,3509,3142,367
Conceição Do Almeida,290830,BA,Nordeste,PFIZER/BIONTECH,447,447,0
Conceição Do Araguaia,150270,PA,Norte,FIOCRUZ/ASTRAZENECA,10210,7922,2288
Conceição Do Araguaia,150270,PA,Norte,BUTANTAN/SINOVAC,6550,3503,3047
Conceição Do Araguaia,150270,PA,Norte,PFIZER/BIONTECH,33,33,0
Conceição Do Canindé,220280,PI,Nordeste,BUTANTAN/SINOVAC,968,492,476
Conceição Do Canindé,220280,PI,Nordeste,FIOCRUZ/ASTRAZENECA,868,793,75
Conceição Do Castelo,320170,ES,Sudeste,BUTANTAN/SINOVAC,3786,2064,1722
Conceição Do Castelo,320170,ES,Sudeste,FIOCRUZ/ASTRAZENECA,2562,2448,114
Conceição Do Castelo,320170,ES,Sudeste,PFIZER/BIONTECH,420,420,0
Conceição Do Coité,290840,BA,Nordeste,BUTANTAN/SINOVAC,11552,6269,5283
Conceição Do Coité,290840,BA,Nordeste,FIOCRUZ/ASTRAZENECA,10565,9224,1341
Conceição Do Coité,290840,BA,Nordeste,PFIZER/BIONTECH,1010,1009,1
Conceição Do Jacuípe,290850,BA,Nordeste,FIOCRUZ/ASTRAZENECA,6275,5495,780
Conceição Do Jacuípe,290850,BA,Nordeste,BUTANTAN/SINOVAC,5606,3055,2551
Conceição Do Jacuípe,290850,BA,Nordeste,PFIZER/BIONTECH,1011,1010,1
Conceição Do Lago-Açu,210355,MA,Nordeste,FIOCRUZ/ASTRAZENECA,2611,2469,142
Conceição Do Lago-Açu,210355,MA,Nordeste,BUTANTAN/SINOVAC,1598,825,773
Conceição Do Mato Dentro,311750,MG,Sudeste,FIOCRUZ/ASTRAZENECA,3813,3448,365
Conceição Do Mato Dentro,311750,MG,Sudeste,BUTANTAN/SINOVAC,3703,1923,1780
Conceição Do Mato Dentro,311750,MG,Sudeste,PFIZER/BIONTECH,152,152,0
Conceição Do Pará,311760,MG,Sudeste,BUTANTAN/SINOVAC,1320,668,652
Conceição Do Pará,311760,MG,Sudeste,FIOCRUZ/ASTRAZENECA,1076,1037,39
Conceição Do Pará,311760,MG,Sudeste,PFIZER/BIONTECH,45,45,0
Conceição Do Rio Verde,311770,MG,Sudeste,BUTANTAN/SINOVAC,2820,1497,1323
Conceição Do Rio Verde,311770,MG,Sudeste,FIOCRUZ/ASTRAZENECA,2398,2385,13
Conceição Do Rio Verde,311770,MG,Sudeste,PFIZER/BIONTECH,117,117,0
Conceição Do Tocantins,170560,TO,Norte,BUTANTAN/SINOVAC,896,454,442
Conceição Do Tocantins,170560,TO,Norte,FIOCRUZ/ASTRAZENECA,805,753,52
Conceição Dos Ouros,311780,MG,Sudeste,BUTANTAN/SINOVAC,1986,1022,964
Conceição Dos Ouros,311780,MG,Sudeste,FIOCRUZ/ASTRAZENECA,1681,1511,170
Conceição Dos Ouros,311780,MG,Sudeste,PFIZER/BIONTECH,41,41,0
Conchal,351220,SP,Sudeste,BUTANTAN/SINOVAC,7216,4099,3117
Conchal,351220,SP,Sudeste,FIOCRUZ/ASTRAZENECA,6069,5583,486
Conchal,351220,SP,Sudeste,PFIZER/BIONTECH,586,585,1
Conchas,351230,SP,Sudeste,BUTANTAN/SINOVAC,4188,2387,1801
Conchas,351230,SP,Sudeste,FIOCRUZ/ASTRAZENECA,4049,3725,324
Conchas,351230,SP,Sudeste,PFIZER/BIONTECH,327,324,3
Concórdia,420430,SC,Sul,FIOCRUZ/ASTRAZENECA,18011,16778,1233
Concórdia,420430,SC,Sul,BUTANTAN/SINOVAC,15973,8186,7787
Concórdia,420430,SC,Sul,PFIZER/BIONTECH,1919,1919,0
Concórdia Do Pará,150275,PA,Norte,FIOCRUZ/ASTRAZENECA,10759,9488,1271
Concórdia Do Pará,150275,PA,Norte,BUTANTAN/SINOVAC,2483,1305,1178
Condado,250450,PB,Nordeste,BUTANTAN/SINOVAC,1953,987,966
Condado,250450,PB,Nordeste,FIOCRUZ/ASTRAZENECA,1589,1434,155
Condado,250450,PB,Nordeste,PFIZER/BIONTECH,221,221,0
Condado,260460,PE,Nordeste,FIOCRUZ/ASTRAZENECA,3914,3658,256
Condado,260460,PE,Nordeste,BUTANTAN/SINOVAC,3228,1763,1465
Condado,260460,PE,Nordeste,PFIZER/BIONTECH,164,164,0
Conde,250460,PB,Nordeste,FIOCRUZ/ASTRAZENECA,5245,5005,240
Conde,250460,PB,Nordeste,BUTANTAN/SINOVAC,3388,1801,1587
Conde,250460,PB,Nordeste,PFIZER/BIONTECH,172,172,0
Conde,290860,BA,Nordeste,BUTANTAN/SINOVAC,3799,2095,1704
Conde,290860,BA,Nordeste,FIOCRUZ/ASTRAZENECA,3593,3362,231
Conde,290860,BA,Nordeste,PFIZER/BIONTECH,778,778,0
Condeúba,290870,BA,Nordeste,BUTANTAN/SINOVAC,4580,2361,2219
Condeúba,290870,BA,Nordeste,FIOCRUZ/ASTRAZENECA,3741,3258,483
Condeúba,290870,BA,Nordeste,PFIZER/BIONTECH,185,185,0
Condor,430570,RS,Sul,BUTANTAN/SINOVAC,1747,879,868
Condor,430570,RS,Sul,FIOCRUZ/ASTRAZENECA,1706,1538,168
Condor,430570,RS,Sul,PFIZER/BIONTECH,227,227,0
Cônego Marinho,311783,MG,Sudeste,BUTANTAN/SINOVAC,1731,885,846
Cônego Marinho,311783,MG,Sudeste,FIOCRUZ/ASTRAZENECA,1143,967,176
Cônego Marinho,311783,MG,Sudeste,PFIZER/BIONTECH,53,53,0
Confins,311787,MG,Sudeste,FIOCRUZ/ASTRAZENECA,5949,5770,179
Confins,311787,MG,Sudeste,BUTANTAN/SINOVAC,1501,762,739
Confins,311787,MG,Sudeste,PFIZER/BIONTECH,934,934,0
Confresa,510335,MT,Centro-Oeste,BUTANTAN/SINOVAC,3866,2057,1809
Confresa,510335,MT,Centro-Oeste,FIOCRUZ/ASTRAZENECA,3181,3009,172
Confresa,510335,MT,Centro-Oeste,PFIZER/BIONTECH,242,242,0
Congo,250470,PB,Nordeste,BUTANTAN/SINOVAC,1378,701,677
Congo,250470,PB,Nordeste,FIOCRUZ/ASTRAZENECA,841,760,81
Congo,250470,PB,Nordeste,PFIZER/BIONTECH,65,65,0
Congonhal,311790,MG,Sudeste,BUTANTAN/SINOVAC,2758,1415,1343
Congonhal,311790,MG,Sudeste,FIOCRUZ/ASTRAZENECA,2595,2402,193
Congonhal,311790,MG,Sudeste,PFIZER/BIONTECH,204,204,0
Congonhas,311800,MG,Sudeste,FIOCRUZ/ASTRAZENECA,11821,10009,1812
Congonhas,311800,MG,Sudeste,BUTANTAN/SINOVAC,10164,5228,4936
Congonhas,311800,MG,Sudeste,PFIZER/BIONTECH,2235,2235,0
Congonhas Do Norte,311810,MG,Sudeste,BUTANTAN/SINOVAC,1148,577,571
Congonhas Do Norte,311810,MG,Sudeste,FIOCRUZ/ASTRAZENECA,804,705,99
Congonhas Do Norte,311810,MG,Sudeste,PFIZER/BIONTECH,67,67,0
Congonhinhas,410600,PR,Sul,BUTANTAN/SINOVAC,2095,1080,1015
Congonhinhas,410600,PR,Sul,FIOCRUZ/ASTRAZENECA,1925,1801,124
Conquista,311820,MG,Sudeste,FIOCRUZ/ASTRAZENECA,2319,2148,171
Conquista,311820,MG,Sudeste,BUTANTAN/SINOVAC,1676,860,816
Conquista,311820,MG,Sudeste,PFIZER/BIONTECH,150,150,0
Conquista D'Oeste,510336,MT,Centro-Oeste,FIOCRUZ/ASTRAZENECA,723,688,35
Conquista D'Oeste,510336,MT,Centro-Oeste,BUTANTAN/SINOVAC,701,355,346
Conquista D'Oeste,510336,MT,Centro-Oeste,PFIZER/BIONTECH,32,32,0
Conselheiro Lafaiete,311830,MG,Sudeste,BUTANTAN/SINOVAC,21735,11327,10408
Conselheiro Lafaiete,311830,MG,Sudeste,FIOCRUZ/ASTRAZENECA,19771,17017,2754
Conselheiro Lafaiete,311830,MG,Sudeste,PFIZER/BIONTECH,860,860,0
Conselheiro Mairinck,410610,PR,Sul,FIOCRUZ/ASTRAZENECA,1099,1040,59
Conselheiro Mairinck,410610,PR,Sul,BUTANTAN/SINOVAC,870,450,420
Conselheiro Pena,311840,MG,Sudeste,BUTANTAN/SINOVAC,4956,2479,2477
Conselheiro Pena,311840,MG,Sudeste,FIOCRUZ/ASTRAZENECA,3034,2667,367
Conselheiro Pena,311840,MG,Sudeste,PFIZER/BIONTECH,241,241,0
Consolação,311850,MG,Sudeste,FIOCRUZ/ASTRAZENECA,554,508,46
Consolação,311850,MG,Sudeste,BUTANTAN/SINOVAC,528,267,261
Consolação,311850,MG,Sudeste,PFIZER/BIONTECH,30,30,0
Constantina,430580,RS,Sul,BUTANTAN/SINOVAC,3229,1659,1570
Constantina,430580,RS,Sul,FIOCRUZ/ASTRAZENECA,2635,2423,212
Constantina,430580,RS,Sul,PFIZER/BIONTECH,368,367,1
Contagem,311860,MG,Sudeste,FIOCRUZ/ASTRAZENECA,125137,116183,8954
Contagem,311860,MG,Sudeste,BUTANTAN/SINOVAC,112698,60376,52322
Contagem,311860,MG,Sudeste,PFIZER/BIONTECH,14089,14080,9
Contenda,410620,PR,Sul,FIOCRUZ/ASTRAZENECA,3722,3589,133
Contenda,410620,PR,Sul,BUTANTAN/SINOVAC,2958,1515,1443
Contenda,410620,PR,Sul,PFIZER/BIONTECH,252,227,25
Contendas Do Sincorá,290880,BA,Nordeste,BUTANTAN/SINOVAC,1957,1006,951
Contendas Do Sincorá,290880,BA,Nordeste,FIOCRUZ/ASTRAZENECA,1573,1470,103
Contendas Do Sincorá,290880,BA,Nordeste,PFIZER/BIONTECH,69,69,0
Coqueiral,311870,MG,Sudeste,FIOCRUZ/ASTRAZENECA,2174,1997,177
Coqueiral,311870,MG,Sudeste,BUTANTAN/SINOVAC,2094,1071,1023
Coqueiral,311870,MG,Sudeste,PFIZER/BIONTECH,242,242,0
Coqueiro Baixo,430583,RS,Sul,BUTANTAN/SINOVAC,732,363,369
Coqueiro Baixo,430583,RS,Sul,FIOCRUZ/ASTRAZENECA,491,398,93
Coqueiro Baixo,430583,RS,Sul,PFIZER/BIONTECH,70,70,0
Coqueiro Seco,270220,AL,Nordeste,FIOCRUZ/ASTRAZENECA,1176,1065,111
Coqueiro Seco,270220,AL,Nordeste,BUTANTAN/SINOVAC,1027,521,506
Coqueiros Do Sul,430585,RS,Sul,BUTANTAN/SINOVAC,1282,731,551
Coqueiros Do Sul,430585,RS,Sul,FIOCRUZ/ASTRAZENECA,1072,990,82
Coqueiros Do Sul,430585,RS,Sul,PFIZER/BIONTECH,84,84,0
Coração De Jesus,311880,MG,Sudeste,BUTANTAN/SINOVAC,4665,2434,2231
Coração De Jesus,311880,MG,Sudeste,FIOCRUZ/ASTRAZENECA,4365,4062,303
Coração De Maria,290890,BA,Nordeste,FIOCRUZ/ASTRAZENECA,5725,5005,720
Coração De Maria,290890,BA,Nordeste,BUTANTAN/SINOVAC,5061,2629,2432
Coração De Maria,290890,BA,Nordeste,PFIZER/BIONTECH,632,628,4
Corbélia,410630,PR,Sul,FIOCRUZ/ASTRAZENECA,4305,4026,279
Corbélia,410630,PR,Sul,BUTANTAN/SINOVAC,3021,1600,1421
Corbélia,410630,PR,Sul,PFIZER/BIONTECH,60,60,0
Cordeiro,330150,RJ,Sudeste,FIOCRUZ/ASTRAZENECA,6441,5920,521
Cordeiro,330150,RJ,Sudeste,BUTANTAN/SINOVAC,5408,2797,2611
Cordeiro,330150,RJ,Sudeste,PFIZER/BIONTECH,1326,1325,1
Cordeirópolis,351240,SP,Sudeste,BUTANTAN/SINOVAC,5953,3336,2617
Cordeirópolis,351240,SP,Sudeste,FIOCRUZ/ASTRAZENECA,5533,5083,450
Cordeirópolis,351240,SP,Sudeste,PFIZER/BIONTECH,48,48,0
Cordeiros,290900,BA,Nordeste,BUTANTAN/SINOVAC,1925,958,967
Cordeiros,290900,BA,Nordeste,FIOCRUZ/ASTRAZENECA,1320,1188,132
Cordeiros,290900,BA,Nordeste,PFIZER/BIONTECH,17,17,0
Cordilheira Alta,420435,SC,Sul,FIOCRUZ/ASTRAZENECA,1029,952,77
Cordilheira Alta,420435,SC,Sul,BUTANTAN/SINOVAC,861,456,405
Cordilheira Alta,420435,SC,Sul,PFIZER/BIONTECH,49,49,0
Cordisburgo,311890,MG,Sudeste,BUTANTAN/SINOVAC,2275,1145,1130
Cordisburgo,311890,MG,Sudeste,FIOCRUZ/ASTRAZENECA,1538,1429,109
Cordisburgo,311890,MG,Sudeste,PFIZER/BIONTECH,199,199,0
Cordislândia,311900,MG,Sudeste,BUTANTAN/SINOVAC,823,419,404
Cordislândia,311900,MG,Sudeste,FIOCRUZ/ASTRAZENECA,385,360,25
Coreaú,230400,CE,Nordeste,BUTANTAN/SINOVAC,2340,1395,945
Coreaú,230400,CE,Nordeste,FIOCRUZ/ASTRAZENECA,2027,1945,82
Coremas,250480,PB,Nordeste,FIOCRUZ/ASTRAZENECA,3939,3619,320
Coremas,250480,PB,Nordeste,BUTANTAN/SINOVAC,3554,1784,1770
Coremas,250480,PB,Nordeste,PFIZER/BIONTECH,360,360,0
Corguinho,500310,MS,Centro-Oeste,FIOCRUZ/ASTRAZENECA,1700,1500,200
Corguinho,500310,MS,Centro-Oeste,BUTANTAN/SINOVAC,1305,658,647
Corguinho,500310,MS,Centro-Oeste,PFIZER/BIONTECH,183,183,0
Coribe,290910,BA,Nordeste,BUTANTAN/SINOVAC,3268,1704,1564
Coribe,290910,BA,Nordeste,FIOCRUZ/ASTRAZENECA,3264,2992,272
Coribe,290910,BA,Nordeste,PFIZER/BIONTECH,236,236,0
Corinto,311910,MG,Sudeste,FIOCRUZ/ASTRAZENECA,4845,4476,369
Corinto,311910,MG,Sudeste,BUTANTAN/SINOVAC,4462,2287,2175
Corinto,311910,MG,Sudeste,PFIZER/BIONTECH,662,662,0
Cornélio Procópio,410640,PR,Sul,BUTANTAN/SINOVAC,15734,8282,7452
Cornélio Procópio,410640,PR,Sul,FIOCRUZ/ASTRAZENECA,13309,12645,664
Cornélio Procópio,410640,PR,Sul,PFIZER/BIONTECH,2682,2682,0
Coroaci,311920,MG,Sudeste,BUTANTAN/SINOVAC,2458,1304,1154
Coroaci,311920,MG,Sudeste,FIOCRUZ/ASTRAZENECA,2318,2116,202
Coroaci,311920,MG,Sudeste,PFIZER/BIONTECH,271,271,0
Coroados,351250,SP,Sudeste,FIOCRUZ/ASTRAZENECA,1494,1393,101
Coroados,351250,SP,Sudeste,BUTANTAN/SINOVAC,1346,761,585
Coroados,351250,SP,Sudeste,PFIZER/BIONTECH,43,43,0
Coroatá,210360,MA,Nordeste,FIOCRUZ/ASTRAZENECA,10963,10237,726
Coroatá,210360,MA,Nordeste,BUTANTAN/SINOVAC,9144,4988,4156
Coromandel,311930,MG,Sudeste,FIOCRUZ/ASTRAZENECA,6583,5424,1159
Coromandel,311930,MG,Sudeste,BUTANTAN/SINOVAC,6025,3017,3008
Coromandel,311930,MG,Sudeste,PFIZER/BIONTECH,650,650,0
Coronel Barros,430587,RS,Sul,BUTANTAN/SINOVAC,960,491,469
Coronel Barros,430587,RS,Sul,FIOCRUZ/ASTRAZENECA,754,661,93
Coronel Barros,430587,RS,Sul,PFIZER/BIONTECH,108,108,0
Coronel Bicaco,430590,RS,Sul,BUTANTAN/SINOVAC,1934,972,962
Coronel Bicaco,430590,RS,Sul,FIOCRUZ/ASTRAZENECA,1014,888,126
Coronel Bicaco,430590,RS,Sul,PFIZER/BIONTECH,90,90,0
Coronel Domingos Soares,410645,PR,Sul,FIOCRUZ/ASTRAZENECA,1393,1327,66
Coronel Domingos Soares,410645,PR,Sul,BUTANTAN/SINOVAC,1063,559,504
Coronel Ezequiel,240280,RN,Nordeste,BUTANTAN/SINOVAC,1242,645,597
Coronel Ezequiel,240280,RN,Nordeste,FIOCRUZ/ASTRAZENECA,1159,1065,94
Coronel Ezequiel,240280,RN,Nordeste,PFIZER/BIONTECH,189,189,0
Coronel Fabriciano,311940,MG,Sudeste,BUTANTAN/SINOVAC,18809,9766,9043
Coronel Fabriciano,311940,MG,Sudeste,FIOCRUZ/ASTRAZENECA,5494,4679,815
Coronel Fabriciano,311940,MG,Sudeste,PFIZER/BIONTECH,615,614,1
Coronel Freitas,420440,SC,Sul,BUTANTAN/SINOVAC,2637,1415,1222
Coronel Freitas,420440,SC,Sul,FIOCRUZ/ASTRAZENECA,2507,2275,232
Coronel Freitas,420440,SC,Sul,PFIZER/BIONTECH,322,322,0
Coronel João Pessoa,240290,RN,Nordeste,FIOCRUZ/ASTRAZENECA,1753,1578,175
Coronel João Pessoa,240290,RN,Nordeste,BUTANTAN/SINOVAC,1579,892,687
Coronel João Pessoa,240290,RN,Nordeste,PFIZER/BIONTECH,60,60,0
Coronel João Sá,290920,BA,Nordeste,FIOCRUZ/ASTRAZENECA,3392,3075,317
Coronel João Sá,290920,BA,Nordeste,BUTANTAN/SINOVAC,2896,1525,1371
Coronel José Dias,220285,PI,Nordeste,BUTANTAN/SINOVAC,696,355,341
Coronel José Dias,220285,PI,Nordeste,FIOCRUZ/ASTRAZENECA,539,539,0
Coronel Macedo,351260,SP,Sudeste,BUTANTAN/SINOVAC,1911,1028,883
Coronel Macedo,351260,SP,Sudeste,FIOCRUZ/ASTRAZENECA,1679,1549,130
Coronel Macedo,351260,SP,Sudeste,PFIZER/BIONTECH,226,226,0
Coronel Martins,420445,SC,Sul,BUTANTAN/SINOVAC,745,384,361
Coronel Martins,420445,SC,Sul,FIOCRUZ/ASTRAZENECA,539,508,31
Coronel Martins,420445,SC,Sul,PFIZER/BIONTECH,74,73,1
Coronel Murta,311950,MG,Sudeste,BUTANTAN/SINOVAC,1927,981,946
Coronel Murta,311950,MG,Sudeste,FIOCRUZ/ASTRAZENECA,1712,1537,175
Coronel Murta,311950,MG,Sudeste,PFIZER/BIONTECH,226,226,0
Coronel Pacheco,311960,MG,Sudeste,FIOCRUZ/ASTRAZENECA,882,812,70
Coronel Pacheco,311960,MG,Sudeste,BUTANTAN/SINOVAC,856,435,421
Coronel Pacheco,311960,MG,Sudeste,PFIZER/BIONTECH,78,78,0
Coronel Pilar,430593,RS,Sul,BUTANTAN/SINOVAC,656,344,312
Coronel Pilar,430593,RS,Sul,FIOCRUZ/ASTRAZENECA,615,485,130
Coronel Pilar,430593,RS,Sul,PFIZER/BIONTECH,66,66,0
Coronel Sapucaia,500315,MS,Centro-Oeste,BUTANTAN/SINOVAC,3062,1746,1316
Coronel Sapucaia,500315,MS,Centro-Oeste,FIOCRUZ/ASTRAZENECA,2231,2129,102
Coronel Sapucaia,500315,MS,Centro-Oeste,PFIZER/BIONTECH,346,346,0
Coronel Vivida,410650,PR,Sul,BUTANTAN/SINOVAC,5810,2998,2812
Coronel Vivida,410650,PR,Sul,FIOCRUZ/ASTRAZENECA,5235,4914,321
Coronel Vivida,410650,PR,Sul,PFIZER/BIONTECH,252,252,0
Coronel Xavier Chaves,311970,MG,Sudeste,FIOCRUZ/ASTRAZENECA,998,918,80
Coronel Xavier Chaves,311970,MG,Sudeste,BUTANTAN/SINOVAC,903,463,440
Coronel Xavier Chaves,311970,MG,Sudeste,PFIZER/BIONTECH,75,75,0
Córrego Danta,311980,MG,Sudeste,BUTANTAN/SINOVAC,1200,608,592
Córrego Danta,311980,MG,Sudeste,FIOCRUZ/ASTRAZENECA,717,646,71
Córrego Danta,311980,MG,Sudeste,PFIZER/BIONTECH,58,58,0
Córrego Do Bom Jesus,311990,MG,Sudeste,BUTANTAN/SINOVAC,1237,631,606
Córrego Do Bom Jesus,311990,MG,Sudeste,FIOCRUZ/ASTRAZENECA,766,682,84
Córrego Do Bom Jesus,311990,MG,Sudeste,PFIZER/BIONTECH,52,52,0
Córrego Do Ouro,520570,GO,Centro-Oeste,FIOCRUZ/ASTRAZENECA,732,683,49
Córrego Do Ouro,520570,GO,Centro-Oeste,BUTANTAN/SINOVAC,577,294,283
Córrego Do Ouro,520570,GO,Centro-Oeste,PFIZER/BIONTECH,30,30,0
Córrego Fundo,311995,MG,Sudeste,BUTANTAN/SINOVAC,1178,609,569
Córrego Fundo,311995,MG,Sudeste,FIOCRUZ/ASTRAZENECA,1168,1091,77
Córrego Fundo,311995,MG,Sudeste,PFIZER/BIONTECH,94,94,0
Córrego Novo,312000,MG,Sudeste,FIOCRUZ/ASTRAZENECA,679,659,20
Córrego Novo,312000,MG,Sudeste,BUTANTAN/SINOVAC,675,342,333
Córrego Novo,312000,MG,Sudeste,PFIZER/BIONTECH,106,106,0
Correia Pinto,420455,SC,Sul,FIOCRUZ/ASTRAZENECA,3693,3453,240
Correia Pinto,420455,SC,Sul,BUTANTAN/SINOVAC,2508,1286,1222
Correia Pinto,420455,SC,Sul,PFIZER/BIONTECH,75,74,1
Corrente,220290,PI,Nordeste,BUTANTAN/SINOVAC,2942,1638,1304
Corrente,220290,PI,Nordeste,FIOCRUZ/ASTRAZENECA,479,397,82
Correntes,260470,PE,Nordeste,FIOCRUZ/ASTRAZENECA,3376,3101,275
Correntes,260470,PE,Nordeste,BUTANTAN/SINOVAC,2351,1224,1127
Correntes,260470,PE,Nordeste,PFIZER/BIONTECH,288,288,0
Correntina,290930,BA,Nordeste,FIOCRUZ/ASTRAZENECA,5536,4981,555
Correntina,290930,BA,Nordeste,BUTANTAN/SINOVAC,5365,3015,2350
Correntina,290930,BA,Nordeste,PFIZER/BIONTECH,124,124,0
Cortês,260480,PE,Nordeste,BUTANTAN/SINOVAC,1585,807,778
Cortês,260480,PE,Nordeste,FIOCRUZ/ASTRAZENECA,1576,1441,135
Cortês,260480,PE,Nordeste,PFIZER/BIONTECH,56,56,0
Corumbá,500320,MS,Centro-Oeste,FIOCRUZ/ASTRAZENECA,27410,25563,1847
Corumbá,500320,MS,Centro-Oeste,BUTANTAN/SINOVAC,21372,11363,10009
Corumbá,500320,MS,Centro-Oeste,PFIZER/BIONTECH,913,913,0
Corumbá De Goiás,520580,GO,Centro-Oeste,FIOCRUZ/ASTRAZENECA,2709,2470,239
Corumbá De Goiás,520580,GO,Centro-Oeste,BUTANTAN/SINOVAC,2435,1245,1190
Corumbá De Goiás,520580,GO,Centro-Oeste,PFIZER/BIONTECH,148,148,0
Corumbaíba,520590,GO,Centro-Oeste,FIOCRUZ/ASTRAZENECA,2718,2314,404
Corumbaíba,520590,GO,Centro-Oeste,BUTANTAN/SINOVAC,1478,753,725
Corumbaíba,520590,GO,Centro-Oeste,PFIZER/BIONTECH,148,148,0
Corumbataí,351270,SP,Sudeste,BUTANTAN/SINOVAC,1071,605,466
Corumbataí,351270,SP,Sudeste,FIOCRUZ/ASTRAZENECA,931,846,85
Corumbataí,351270,SP,Sudeste,PFIZER/BIONTECH,102,102,0
Corumbataí Do Sul,410655,PR,Sul,FIOCRUZ/ASTRAZENECA,1181,1121,60
Corumbataí Do Sul,410655,PR,Sul,BUTANTAN/SINOVAC,890,464,426
Corumbataí Do Sul,410655,PR,Sul,PFIZER/BIONTECH,18,18,0
Corumbiara,110007,RO,Norte,FIOCRUZ/ASTRAZENECA,1499,1458,41
Corumbiara,110007,RO,Norte,BUTANTAN/SINOVAC,1470,778,692
Corumbiara,110007,RO,Norte,PFIZER/BIONTECH,180,179,1
Corupá,420450,SC,Sul,FIOCRUZ/ASTRAZENECA,3310,3021,289
Corupá,420450,SC,Sul,BUTANTAN/SINOVAC,2878,1572,1306
Corupá,420450,SC,Sul,PFIZER/BIONTECH,315,315,0
Coruripe,270230,AL,Nordeste,FIOCRUZ/ASTRAZENECA,8107,7546,561
Coruripe,270230,AL,Nordeste,BUTANTAN/SINOVAC,7077,3679,3398
Coruripe,270230,AL,Nordeste,PFIZER/BIONTECH,4946,4945,1
Cosmópolis,351280,SP,Sudeste,FIOCRUZ/ASTRAZENECA,9621,8964,657
Cosmópolis,351280,SP,Sudeste,BUTANTAN/SINOVAC,9577,5243,4334
Cosmópolis,351280,SP,Sudeste,PFIZER/BIONTECH,103,103,0
Cosmorama,351290,SP,Sudeste,BUTANTAN/SINOVAC,2893,1807,1086
Cosmorama,351290,SP,Sudeste,FIOCRUZ/ASTRAZENECA,2054,1879,175
Cosmorama,351290,SP,Sudeste,PFIZER/BIONTECH,150,150,0
Costa Marques,110008,RO,Norte,FIOCRUZ/ASTRAZENECA,2540,2464,76
Costa Marques,110008,RO,Norte,BUTANTAN/SINOVAC,1923,1006,917
Costa Marques,110008,RO,Norte,PFIZER/BIONTECH,40,40,0
Costa Rica,500325,MS,Centro-Oeste,FIOCRUZ/ASTRAZENECA,5806,5054,752
Costa Rica,500325,MS,Centro-Oeste,BUTANTAN/SINOVAC,4019,2120,1899
Costa Rica,500325,MS,Centro-Oeste,PFIZER/BIONTECH,712,709,3
Cotegipe,290940,BA,Nordeste,FIOCRUZ/ASTRAZENECA,2940,2629,311
Cotegipe,290940,BA,Nordeste,BUTANTAN/SINOVAC,2296,1195,1101
Cotegipe,290940,BA,Nordeste,PFIZER/BIONTECH,90,89,1
Cotia,351300,SP,Sudeste,BUTANTAN/SINOVAC,42429,26655,15774
Cotia,351300,SP,Sudeste,FIOCRUZ/ASTRAZENECA,41379,38655,2724
Cotia,351300,SP,Sudeste,PFIZER/BIONTECH,4467,4463,4
Cotiporã,430595,RS,Sul,BUTANTAN/SINOVAC,1369,681,688
Cotiporã,430595,RS,Sul,FIOCRUZ/ASTRAZENECA,1339,1101,238
Cotiporã,430595,RS,Sul,PFIZER/BIONTECH,98,98,0
Cotriguaçu,510337,MT,Centro-Oeste,BUTANTAN/SINOVAC,1487,787,700
Cotriguaçu,510337,MT,Centro-Oeste,FIOCRUZ/ASTRAZENECA,1023,947,76
Cotriguaçu,510337,MT,Centro-Oeste,PFIZER/BIONTECH,49,49,0
Couto De Magalhães De Minas,312010,MG,Sudeste,FIOCRUZ/ASTRAZENECA,1735,1608,127
Couto De Magalhães De Minas,312010,MG,Sudeste,BUTANTAN/SINOVAC,1120,577,543
Couto De Magalhães De Minas,312010,MG,Sudeste,PFIZER/BIONTECH,102,102,0
Couto Magalhães,170600,TO,Norte,FIOCRUZ/ASTRAZENECA,1331,1302,29
Couto Magalhães,170600,TO,Norte,BUTANTAN/SINOVAC,800,407,393
Coxilha,430597,RS,Sul,FIOCRUZ/ASTRAZENECA,757,656,101
Coxilha,430597,RS,Sul,BUTANTAN/SINOVAC,586,290,296
Coxilha,430597,RS,Sul,PFIZER/BIONTECH,139,139,0
Coxim,500330,MS,Centro-Oeste,FIOCRUZ/ASTRAZENECA,9144,8240,904
Coxim,500330,MS,Centro-Oeste,BUTANTAN/SINOVAC,6978,3668,3310
Coxim,500330,MS,Centro-Oeste,PFIZER/BIONTECH,1017,1016,1
Coxixola,250485,PB,Nordeste,BUTANTAN/SINOVAC,639,316,323
Coxixola,250485,PB,Nordeste,FIOCRUZ/ASTRAZENECA,367,317,50
Coxixola,250485,PB,Nordeste,PFIZER/BIONTECH,36,36,0
Craíbas,270235,AL,Nordeste,BUTANTAN/SINOVAC,3786,2111,1675
Craíbas,270235,AL,Nordeste,FIOCRUZ/ASTRAZENECA,3050,2890,160
Crateús,230410,CE,Nordeste,BUTANTAN/SINOVAC,13596,7410,6186
Crateús,230410,CE,Nordeste,FIOCRUZ/ASTRAZENECA,6147,5625,522
Crato,230420,CE,Nordeste,BUTANTAN/SINOVAC,9554,5565,3989
Crato,230420,CE,Nordeste,FIOCRUZ/ASTRAZENECA,2539,2104,435
Cravinhos,351310,SP,Sudeste,FIOCRUZ/ASTRAZENECA,7443,6916,527
Cravinhos,351310,SP,Sudeste,BUTANTAN/SINOVAC,6472,3470,3002
Cravinhos,351310,SP,Sudeste,PFIZER/BIONTECH,348,348,0
Cravolândia,290950,BA,Nordeste,BUTANTAN/SINOVAC,1287,673,614
Cravolândia,290950,BA,Nordeste,FIOCRUZ/ASTRAZENECA,1236,1060,176
Cravolândia,290950,BA,Nordeste,PFIZER/BIONTECH,36,36,0
Criciúma,420460,SC,Sul,FIOCRUZ/ASTRAZENECA,37457,35770,1687
Criciúma,420460,SC,Sul,BUTANTAN/SINOVAC,33603,17314,16289
Criciúma,420460,SC,Sul,PFIZER/BIONTECH,10982,10958,24
Crisólita,312015,MG,Sudeste,BUTANTAN/SINOVAC,1290,654,636
Crisólita,312015,MG,Sudeste,FIOCRUZ/ASTRAZENECA,785,711,74
Crisólita,312015,MG,Sudeste,PFIZER/BIONTECH,57,57,0
Crisópolis,290960,BA,Nordeste,BUTANTAN/SINOVAC,3018,1803,1215
Crisópolis,290960,BA,Nordeste,FIOCRUZ/ASTRAZENECA,1799,1788,11
Crisópolis,290960,BA,Nordeste,PFIZER/BIONTECH,146,146,0
Crissiumal,430600,RS,Sul,BUTANTAN/SINOVAC,4420,2220,2200
Crissiumal,430600,RS,Sul,FIOCRUZ/ASTRAZENECA,3500,3195,305
Crissiumal,430600,RS,Sul,PFIZER/BIONTECH,380,380,0
Cristais,312020,MG,Sudeste,FIOCRUZ/ASTRAZENECA,2720,2547,173
Cristais,312020,MG,Sudeste,BUTANTAN/SINOVAC,2595,1324,1271
Cristais,312020,MG,Sudeste,PFIZER/BIONTECH,228,227,1
Cristais Paulista,351320,SP,Sudeste,BUTANTAN/SINOVAC,1761,930,831
Cristais Paulista,351320,SP,Sudeste,FIOCRUZ/ASTRAZENECA,1726,1576,150
Cristais Paulista,351320,SP,Sudeste,PFIZER/BIONTECH,108,108,0
Cristal,430605,RS,Sul,BUTANTAN/SINOVAC,2337,1192,1145
Cristal,430605,RS,Sul,FIOCRUZ/ASTRAZENECA,1922,1797,125
Cristal,430605,RS,Sul,PFIZER/BIONTECH,234,234,0
Cristal Do Sul,430607,RS,Sul,BUTANTAN/SINOVAC,960,480,480
Cristal Do Sul,430607,RS,Sul,FIOCRUZ/ASTRAZENECA,721,637,84
Cristal Do Sul,430607,RS,Sul,PFIZER/BIONTECH,122,122,0
Cristalândia,170610,TO,Norte,BUTANTAN/SINOVAC,1885,1043,842
Cristalândia,170610,TO,Norte,FIOCRUZ/ASTRAZENECA,1543,1487,56
Cristalândia Do Piauí,220300,PI,Nordeste,FIOCRUZ/ASTRAZENECA,1820,1742,78
Cristalândia Do Piauí,220300,PI,Nordeste,BUTANTAN/SINOVAC,1456,782,674
Cristalândia Do Piauí,220300,PI,Nordeste,PFIZER/BIONTECH,199,199,0
Cristália,312030,MG,Sudeste,FIOCRUZ/ASTRAZENECA,1122,1051,71
Cristália,312030,MG,Sudeste,BUTANTAN/SINOVAC,849,434,415
Cristália,312030,MG,Sudeste,PFIZER/BIONTECH,70,70,0
Cristalina,520620,GO,Centro-Oeste,FIOCRUZ/ASTRAZENECA,11791,11167,624
Cristalina,520620,GO,Centro-Oeste,BUTANTAN/SINOVAC,7704,3979,3725
Cristalina,520620,GO,Centro-Oeste,PFIZER/BIONTECH,911,911,0
Cristiano Otoni,312040,MG,Sudeste,BUTANTAN/SINOVAC,253,168,85
Cristiano Otoni,312040,MG,Sudeste,FIOCRUZ/ASTRAZENECA,83,83,0
Cristianópolis,520630,GO,Centro-Oeste,BUTANTAN/SINOVAC,788,428,360
Cristianópolis,520630,GO,Centro-Oeste,FIOCRUZ/ASTRAZENECA,738,668,70
Cristina,312050,MG,Sudeste,BUTANTAN/SINOVAC,2526,1349,1177
Cristina,312050,MG,Sudeste,FIOCRUZ/ASTRAZENECA,1679,1618,61
Cristinápolis,280170,SE,Nordeste,BUTANTAN/SINOVAC,2215,1267,948
Cristinápolis,280170,SE,Nordeste,FIOCRUZ/ASTRAZENECA,388,388,0
Cristino Castro,220310,PI,Nordeste,FIOCRUZ/ASTRAZENECA,2057,1850,207
Cristino Castro,220310,PI,Nordeste,BUTANTAN/SINOVAC,1518,764,754
Cristino Castro,220310,PI,Nordeste,PFIZER/BIONTECH,165,165,0
Cristópolis,290970,BA,Nordeste,FIOCRUZ/ASTRAZENECA,4786,4169,617
Cristópolis,290970,BA,Nordeste,BUTANTAN/SINOVAC,4499,2293,2206
Cristópolis,290970,BA,Nordeste,PFIZER/BIONTECH,268,268,0
Crixás,520640,GO,Centro-Oeste,FIOCRUZ/ASTRAZENECA,3980,3610,370
Crixás,520640,GO,Centro-Oeste,BUTANTAN/SINOVAC,2794,1418,1376
Crixás,520640,GO,Centro-Oeste,PFIZER/BIONTECH,263,263,0
Crixás Do Tocantins,170625,TO,Norte,BUTANTAN/SINOVAC,424,221,203
Crixás Do Tocantins,170625,TO,Norte,FIOCRUZ/ASTRAZENECA,407,374,33
Croatá,230423,CE,Nordeste,BUTANTAN/SINOVAC,2068,1275,793
Croatá,230423,CE,Nordeste,FIOCRUZ/ASTRAZENECA,1015,954,61
Croatá,230423,CE,Nordeste,PFIZER/BIONTECH,6,6,0
Cromínia,520650,GO,Centro-Oeste,BUTANTAN/SINOVAC,2043,1044,999
Cromínia,520650,GO,Centro-Oeste,FIOCRUZ/ASTRAZENECA,1026,942,84
Crucilândia,312060,MG,Sudeste,BUTANTAN/SINOVAC,1709,892,817
Crucilândia,312060,MG,Sudeste,FIOCRUZ/ASTRAZENECA,1426,1297,129
Crucilândia,312060,MG,Sudeste,PFIZER/BIONTECH,99,99,0
Cruz,230425,CE,Nordeste,BUTANTAN/SINOVAC,4019,2030,1989
Cruz,230425,CE,Nordeste,FIOCRUZ/ASTRAZENECA,3790,3436,354
Cruz,230425,CE,Nordeste,PFIZER/BIONTECH,6,6,0
Cruz Alta,430610,RS,Sul,BUTANTAN/SINOVAC,16316,8221,8095
Cruz Alta,430610,RS,Sul,FIOCRUZ/ASTRAZENECA,16190,14649,1541
Cruz Alta,430610,RS,Sul,PFIZER/BIONTECH,1432,1431,1
Cruz Das Almas,290980,BA,Nordeste,BUTANTAN/SINOVAC,9465,5246,4219
Cruz Das Almas,290980,BA,Nordeste,FIOCRUZ/ASTRAZENECA,7367,6911,456
Cruz Das Almas,290980,BA,Nordeste,PFIZER/BIONTECH,1003,1002,1
Cruz Do Espírito Santo,250490,PB,Nordeste,BUTANTAN/SINOVAC,2363,1231,1132
Cruz Do Espírito Santo,250490,PB,Nordeste,FIOCRUZ/ASTRAZENECA,2129,1979,150
Cruz Do Espírito Santo,250490,PB,Nordeste,PFIZER/BIONTECH,308,308,0
Cruz Machado,410680,PR,Sul,BUTANTAN/SINOVAC,3080,1571,1509
Cruz Machado,410680,PR,Sul,FIOCRUZ/ASTRAZENECA,2890,2726,164
Cruz Machado,410680,PR,Sul,PFIZER/BIONTECH,27,27,0
Cruzália,351330,SP,Sudeste,BUTANTAN/SINOVAC,1297,675,622
Cruzália,351330,SP,Sudeste,FIOCRUZ/ASTRAZENECA,912,804,108
Cruzália,351330,SP,Sudeste,PFIZER/BIONTECH,77,77,0
Cruzaltense,430613,RS,Sul,BUTANTAN/SINOVAC,642,323,319
Cruzaltense,430613,RS,Sul,FIOCRUZ/ASTRAZENECA,558,476,82
Cruzaltense,430613,RS,Sul,PFIZER/BIONTECH,78,78,0
Cruzeiro,351340,SP,Sudeste,BUTANTAN/SINOVAC,14274,7694,6580
Cruzeiro,351340,SP,Sudeste,FIOCRUZ/ASTRAZENECA,13634,12301,1333
Cruzeiro Da Fortaleza,312070,MG,Sudeste,FIOCRUZ/ASTRAZENECA,1058,968,90
Cruzeiro Da Fortaleza,312070,MG,Sudeste,BUTANTAN/SINOVAC,809,416,393
Cruzeiro Da Fortaleza,312070,MG,Sudeste,PFIZER/BIONTECH,70,70,0
Cruzeiro Do Iguaçu,410657,PR,Sul,FIOCRUZ/ASTRAZENECA,1276,1208,68
Cruzeiro Do Iguaçu,410657,PR,Sul,BUTANTAN/SINOVAC,840,433,407
Cruzeiro Do Oeste,410660,PR,Sul,FIOCRUZ/ASTRAZENECA,6423,6095,328
Cruzeiro Do Oeste,410660,PR,Sul,BUTANTAN/SINOVAC,4807,2546,2261
Cruzeiro Do Oeste,410660,PR,Sul,PFIZER/BIONTECH,567,567,0
Cruzeiro Do Sul,120020,AC,Norte,FIOCRUZ/ASTRAZENECA,25760,23323,2437
Cruzeiro Do Sul,120020,AC,Norte,BUTANTAN/SINOVAC,11750,6427,5323
Cruzeiro Do Sul,120020,AC,Norte,PFIZER/BIONTECH,811,811,0
Cruzeiro Do Sul,410670,PR,Sul,FIOCRUZ/ASTRAZENECA,1302,1215,87
Cruzeiro Do Sul,410670,PR,Sul,BUTANTAN/SINOVAC,1102,576,526
Cruzeiro Do Sul,410670,PR,Sul,PFIZER/BIONTECH,24,24,0
Cruzeiro Do Sul,430620,RS,Sul,BUTANTAN/SINOVAC,4063,2092,1971
Cruzeiro Do Sul,430620,RS,Sul,FIOCRUZ/ASTRAZENECA,2667,2368,299
Cruzeiro Do Sul,430620,RS,Sul,PFIZER/BIONTECH,204,203,1
Cruzeta,240300,RN,Nordeste,BUTANTAN/SINOVAC,2086,1077,1009
Cruzeta,240300,RN,Nordeste,FIOCRUZ/ASTRAZENECA,1684,1582,102
Cruzeta,240300,RN,Nordeste,PFIZER/BIONTECH,169,169,0
Cruzília,312080,MG,Sudeste,FIOCRUZ/ASTRAZENECA,4173,3855,318
Cruzília,312080,MG,Sudeste,BUTANTAN/SINOVAC,3739,1915,1824
Cruzília,312080,MG,Sudeste,PFIZER/BIONTECH,170,170,0
Cruzmaltina,410685,PR,Sul,FIOCRUZ/ASTRAZENECA,761,700,61
Cruzmaltina,410685,PR,Sul,BUTANTAN/SINOVAC,643,330,313
Cruzmaltina,410685,PR,Sul,PFIZER/BIONTECH,6,6,0
Cubatão,351350,SP,Sudeste,FIOCRUZ/ASTRAZENECA,25943,24477,1466
Cubatão,351350,SP,Sudeste,BUTANTAN/SINOVAC,21599,11676,9923
Cubatão,351350,SP,Sudeste,PFIZER/BIONTECH,3132,3127,5
Cubati,250500,PB,Nordeste,BUTANTAN/SINOVAC,1630,823,807
Cubati,250500,PB,Nordeste,FIOCRUZ/ASTRAZENECA,1291,1154,137
Cubati,250500,PB,Nordeste,PFIZER/BIONTECH,60,60,0
Cuiabá,510340,MT,Centro-Oeste,BUTANTAN/SINOVAC,121400,63082,58318
Cuiabá,510340,MT,Centro-Oeste,FIOCRUZ/ASTRAZENECA,107759,97788,9971
Cuiabá,510340,MT,Centro-Oeste,PFIZER/BIONTECH,42356,42286,70
Cuité,250510,PB,Nordeste,BUTANTAN/SINOVAC,5400,2798,2602
Cuité,250510,PB,Nordeste,FIOCRUZ/ASTRAZENECA,3534,3107,427
Cuité,250510,PB,Nordeste,PFIZER/BIONTECH,290,289,1
Cuité De Mamanguape,250523,PB,Nordeste,BUTANTAN/SINOVAC,1361,800,561
Cuité De Mamanguape,250523,PB,Nordeste,FIOCRUZ/ASTRAZENECA,583,492,91
Cuité De Mamanguape,250523,PB,Nordeste,PFIZER/BIONTECH,4,4,0
Cuitegi,250520,PB,Nordeste,BUTANTAN/SINOVAC,1297,705,592
Cuitegi,250520,PB,Nordeste,FIOCRUZ/ASTRAZENECA,320,291,29
Cujubim,110094,RO,Norte,FIOCRUZ/ASTRAZENECA,3344,3298,46
Cujubim,110094,RO,Norte,BUTANTAN/SINOVAC,1858,1012,846
Cujubim,110094,RO,Norte,PFIZER/BIONTECH,99,99,0
Cumari,520660,GO,Centro-Oeste,FIOCRUZ/ASTRAZENECA,1196,1051,145
Cumari,520660,GO,Centro-Oeste,BUTANTAN/SINOVAC,600,308,292
Cumari,520660,GO,Centro-Oeste,PFIZER/BIONTECH,18,18,0
Cumaru,260490,PE,Nordeste,FIOCRUZ/ASTRAZENECA,3420,3136,284
Cumaru,260490,PE,Nordeste,BUTANTAN/SINOVAC,2931,1518,1413
Cumaru,260490,PE,Nordeste,PFIZER/BIONTECH,235,235,0
Cumaru Do Norte,150276,PA,Norte,BUTANTAN/SINOVAC,1143,702,441
Cumaru Do Norte,150276,PA,Norte,FIOCRUZ/ASTRAZENECA,1084,901,183
Cumbe,280190,SE,Nordeste,FIOCRUZ/ASTRAZENECA,964,913,51
Cumbe,280190,SE,Nordeste,BUTANTAN/SINOVAC,945,505,440
Cumbe,280190,SE,Nordeste,PFIZER/BIONTECH,87,87,0
Cunha,351360,SP,Sudeste,BUTANTAN/SINOVAC,5641,3198,2443
Cunha,351360,SP,Sudeste,FIOCRUZ/ASTRAZENECA,5084,4742,342
Cunha,351360,SP,Sudeste,PFIZER/BIONTECH,619,619,0
Cunha Porã,420470,SC,Sul,FIOCRUZ/ASTRAZENECA,3149,2779,370
Cunha Porã,420470,SC,Sul,BUTANTAN/SINOVAC,3016,1534,1482
Cunha Porã,420470,SC,Sul,PFIZER/BIONTECH,138,138,0
Cunhataí,420475,SC,Sul,FIOCRUZ/ASTRAZENECA,630,569,61
Cunhataí,420475,SC,Sul,BUTANTAN/SINOVAC,588,311,277
Cunhataí,420475,SC,Sul,PFIZER/BIONTECH,65,65,0
Cuparaque,312083,MG,Sudeste,FIOCRUZ/ASTRAZENECA,1074,1008,66
Cuparaque,312083,MG,Sudeste,BUTANTAN/SINOVAC,1004,513,491
Cuparaque,312083,MG,Sudeste,PFIZER/BIONTECH,175,175,0
Cupira,260500,PE,Nordeste,BUTANTAN/SINOVAC,3887,2077,1810
Cupira,260500,PE,Nordeste,FIOCRUZ/ASTRAZENECA,3362,3088,274
Cupira,260500,PE,Nordeste,PFIZER/BIONTECH,40,40,0
Curaçá,290990,BA,Nordeste,BUTANTAN/SINOVAC,5591,3020,2571
Curaçá,290990,BA,Nordeste,FIOCRUZ/ASTRAZENECA,4093,3923,170
Curimatá,220320,PI,Nordeste,FIOCRUZ/ASTRAZENECA,2199,1940,259
Curimatá,220320,PI,Nordeste,BUTANTAN/SINOVAC,1856,953,903
Curimatá,220320,PI,Nordeste,PFIZER/BIONTECH,288,288,0
Curionópolis,150277,PA,Norte,FIOCRUZ/ASTRAZENECA,3916,3629,287
Curionópolis,150277,PA,Norte,BUTANTAN/SINOVAC,862,473,389
Curitiba,410690,PR,Sul,FIOCRUZ/ASTRAZENECA,416768,369377,47391
Curitiba,410690,PR,Sul,BUTANTAN/SINOVAC,401568,208710,192858
Curitiba,410690,PR,Sul,PFIZER/BIONTECH,150339,150329,10
Curitibanos,420480,SC,Sul,FIOCRUZ/ASTRAZENECA,10183,9442,741
Curitibanos,420480,SC,Sul,BUTANTAN/SINOVAC,7977,4265,3712
Curitibanos,420480,SC,Sul,PFIZER/BIONTECH,1,0,1
Curiúva,410700,PR,Sul,FIOCRUZ/ASTRAZENECA,3951,3797,154
Curiúva,410700,PR,Sul,BUTANTAN/SINOVAC,3891,2164,1727
Curiúva,410700,PR,Sul,PFIZER/BIONTECH,18,18,0
Currais,220323,PI,Nordeste,FIOCRUZ/ASTRAZENECA,959,871,88
Currais,220323,PI,Nordeste,BUTANTAN/SINOVAC,643,346,297
Currais,220323,PI,Nordeste,PFIZER/BIONTECH,119,119,0
Currais Novos,240310,RN,Nordeste,FIOCRUZ/ASTRAZENECA,6564,5919,645
Currais Novos,240310,RN,Nordeste,BUTANTAN/SINOVAC,6021,3086,2935
Currais Novos,240310,RN,Nordeste,PFIZER/BIONTECH,1245,1244,1
Curral De Cima,250527,PB,Nordeste,BUTANTAN/SINOVAC,1246,645,601
Curral De Cima,250527,PB,Nordeste,FIOCRUZ/ASTRAZENECA,842,766,76
Curral De Cima,250527,PB,Nordeste,PFIZER/BIONTECH,48,48,0
Curral De Dentro,312087,MG,Sudeste,BUTANTAN/SINOVAC,1402,714,688
Curral De Dentro,312087,MG,Sudeste,FIOCRUZ/ASTRAZENECA,1285,1188,97
Curral De Dentro,312087,MG,Sudeste,PFIZER/BIONTECH,100,100,0
Curral Novo Do Piauí,220327,PI,Nordeste,BUTANTAN/SINOVAC,657,345,312
Curral Novo Do Piauí,220327,PI,Nordeste,FIOCRUZ/ASTRAZENECA,591,522,69
Curral Velho,250530,PB,Nordeste,BUTANTAN/SINOVAC,556,290,266
Curral Velho,250530,PB,Nordeste,FIOCRUZ/ASTRAZENECA,441,409,32
Curral Velho,250530,PB,Nordeste,PFIZER/BIONTECH,43,43,0
Curralinho,150280,PA,Norte,FIOCRUZ/ASTRAZENECA,5312,4867,445
Curralinho,150280,PA,Norte,BUTANTAN/SINOVAC,1528,848,680
Curralinhos,220325,PI,Nordeste,BUTANTAN/SINOVAC,1042,537,505
Curralinhos,220325,PI,Nordeste,FIOCRUZ/ASTRAZENECA,530,510,20
Curralinhos,220325,PI,Nordeste,PFIZER/BIONTECH,130,130,0
Curuá,150285,PA,Norte,FIOCRUZ/ASTRAZENECA,4855,3426,1429
Curuá,150285,PA,Norte,BUTANTAN/SINOVAC,455,249,206
Curuçá,150290,PA,Norte,FIOCRUZ/ASTRAZENECA,5901,4747,1154
Curuçá,150290,PA,Norte,BUTANTAN/SINOVAC,5147,2769,2378
Cururupu,210370,MA,Nordeste,FIOCRUZ/ASTRAZENECA,7989,7562,427
Cururupu,210370,MA,Nordeste,BUTANTAN/SINOVAC,5312,2830,2482
Curvelândia,510343,MT,Centro-Oeste,BUTANTAN/SINOVAC,1130,597,533
Curvelândia,510343,MT,Centro-Oeste,FIOCRUZ/ASTRAZENECA,920,873,47
Curvelândia,510343,MT,Centro-Oeste,PFIZER/BIONTECH,4,4,0
Curvelo,312090,MG,Sudeste,BUTANTAN/SINOVAC,17868,9021,8847
Curvelo,312090,MG,Sudeste,FIOCRUZ/ASTRAZENECA,17743,16291,1452
Curvelo,312090,MG,Sudeste,PFIZER/BIONTECH,2206,2205,1
Custódia,260510,PE,Nordeste,FIOCRUZ/ASTRAZENECA,9197,8481,716
Custódia,260510,PE,Nordeste,BUTANTAN/SINOVAC,6109,3095,3014
Custódia,260510,PE,Nordeste,PFIZER/BIONTECH,545,545,0
Cutias,160021,AP,Norte,FIOCRUZ/ASTRAZENECA,1534,1495,39
Cutias,160021,AP,Norte,BUTANTAN/SINOVAC,797,412,385
Cutias,160021,AP,Norte,PFIZER/BIONTECH,444,444,0
Damianópolis,520670,GO,Centro-Oeste,FIOCRUZ/ASTRAZENECA,1440,1157,283
Damianópolis,520670,GO,Centro-Oeste,BUTANTAN/SINOVAC,428,252,176
Damião,250535,PB,Nordeste,BUTANTAN/SINOVAC,1041,530,511
Damião,250535,PB,Nordeste,FIOCRUZ/ASTRAZENECA,775,694,81
Damião,250535,PB,Nordeste,PFIZER/BIONTECH,62,62,0
Damolândia,520680,GO,Centro-Oeste,FIOCRUZ/ASTRAZENECA,884,818,66
Damolândia,520680,GO,Centro-Oeste,BUTANTAN/SINOVAC,722,371,351
Damolândia,520680,GO,Centro-Oeste,PFIZER/BIONTECH,41,41,0
Darcinópolis,170650,TO,Norte,BUTANTAN/SINOVAC,999,513,486
Darcinópolis,170650,TO,Norte,FIOCRUZ/ASTRAZENECA,519,488,31
Dário Meira,291000,BA,Nordeste,BUTANTAN/SINOVAC,1722,899,823
Dário Meira,291000,BA,Nordeste,FIOCRUZ/ASTRAZENECA,1439,1252,187
Dário Meira,291000,BA,Nordeste,PFIZER/BIONTECH,29,29,0
Datas,312100,MG,Sudeste,BUTANTAN/SINOVAC,752,424,328
Datas,312100,MG,Sudeste,FIOCRUZ/ASTRAZENECA,395,357,38
David Canabarro,430630,RS,Sul,BUTANTAN/SINOVAC,1459,737,722
David Canabarro,430630,RS,Sul,FIOCRUZ/ASTRAZENECA,1239,1150,89
David Canabarro,430630,RS,Sul,PFIZER/BIONTECH,176,176,0
Davinópolis,210375,MA,Nordeste,FIOCRUZ/ASTRAZENECA,2493,2332,161
Davinópolis,210375,MA,Nordeste,BUTANTAN/SINOVAC,2080,1082,998
Davinópolis,520690,GO,Centro-Oeste,FIOCRUZ/ASTRAZENECA,798,698,100
Davinópolis,520690,GO,Centro-Oeste,BUTANTAN/SINOVAC,452,228,224
Davinópolis,520690,GO,Centro-Oeste,PFIZER/BIONTECH,24,24,0
Delfim Moreira,312110,MG,Sudeste,FIOCRUZ/ASTRAZENECA,1463,1381,82
Delfim Moreira,312110,MG,Sudeste,BUTANTAN/SINOVAC,1335,688,647
Delfim Moreira,312110,MG,Sudeste,PFIZER/BIONTECH,133,133,0
Delfinópolis,312120,MG,Sudeste,BUTANTAN/SINOVAC,1648,868,780
Delfinópolis,312120,MG,Sudeste,FIOCRUZ/ASTRAZENECA,1602,1524,78
Delfinópolis,312120,MG,Sudeste,PFIZER/BIONTECH,70,70,0
Delmiro Gouveia,270240,AL,Nordeste,FIOCRUZ/ASTRAZENECA,10040,9379,661
Delmiro Gouveia,270240,AL,Nordeste,BUTANTAN/SINOVAC,7464,3840,3624
Delta,312125,MG,Sudeste,FIOCRUZ/ASTRAZENECA,1402,1331,71
Delta,312125,MG,Sudeste,BUTANTAN/SINOVAC,1152,591,561
Delta,312125,MG,Sudeste,PFIZER/BIONTECH,171,171,0
Demerval Lobão,220330,PI,Nordeste,BUTANTAN/SINOVAC,1999,1019,980
Demerval Lobão,220330,PI,Nordeste,FIOCRUZ/ASTRAZENECA,1923,1734,189
Demerval Lobão,220330,PI,Nordeste,PFIZER/BIONTECH,29,29,0
Denise,510345,MT,Centro-Oeste,BUTANTAN/SINOVAC,1017,535,482
Denise,510345,MT,Centro-Oeste,FIOCRUZ/ASTRAZENECA,827,815,12
Deodápolis,500345,MS,Centro-Oeste,BUTANTAN/SINOVAC,3330,1772,1558
Deodápolis,500345,MS,Centro-Oeste,FIOCRUZ/ASTRAZENECA,3218,2766,452
Deodápolis,500345,MS,Centro-Oeste,PFIZER/BIONTECH,470,469,1
Deputado Irapuan Pinheiro,230426,CE,Nordeste,BUTANTAN/SINOVAC,1460,835,625
Deputado Irapuan Pinheiro,230426,CE,Nordeste,FIOCRUZ/ASTRAZENECA,608,477,131
Derrubadas,430632,RS,Sul,BUTANTAN/SINOVAC,947,475,472
Derrubadas,430632,RS,Sul,FIOCRUZ/ASTRAZENECA,794,719,75
Derrubadas,430632,RS,Sul,PFIZER/BIONTECH,108,107,1
Descalvado,351370,SP,Sudeste,BUTANTAN/SINOVAC,9238,5232,4006
Descalvado,351370,SP,Sudeste,FIOCRUZ/ASTRAZENECA,8574,7692,882
Descalvado,351370,SP,Sudeste,PFIZER/BIONTECH,583,583,0
Descanso,420490,SC,Sul,BUTANTAN/SINOVAC,3847,1734,2113
Descanso,420490,SC,Sul,FIOCRUZ/ASTRAZENECA,3315,3057,258
Descanso,420490,SC,Sul,PFIZER/BIONTECH,273,273,0
Descoberto,312130,MG,Sudeste,BUTANTAN/SINOVAC,1291,669,622
Descoberto,312130,MG,Sudeste,FIOCRUZ/ASTRAZENECA,517,463,54
Desterro,250540,PB,Nordeste,BUTANTAN/SINOVAC,1933,973,960
Desterro,250540,PB,Nordeste,FIOCRUZ/ASTRAZENECA,1283,1168,115
Desterro,250540,PB,Nordeste,PFIZER/BIONTECH,167,167,0
Desterro De Entre Rios,312140,MG,Sudeste,BUTANTAN/SINOVAC,2144,1082,1062
Desterro De Entre Rios,312140,MG,Sudeste,FIOCRUZ/ASTRAZENECA,2041,1886,155
Desterro De Entre Rios,312140,MG,Sudeste,PFIZER/BIONTECH,20,20,0
Desterro Do Melo,312150,MG,Sudeste,BUTANTAN/SINOVAC,1063,545,518
Desterro Do Melo,312150,MG,Sudeste,FIOCRUZ/ASTRAZENECA,913,637,276
Desterro Do Melo,312150,MG,Sudeste,PFIZER/BIONTECH,78,78,0
Dezesseis De Novembro,430635,RS,Sul,BUTANTAN/SINOVAC,927,467,460
Dezesseis De Novembro,430635,RS,Sul,FIOCRUZ/ASTRAZENECA,700,615,85
Dezesseis De Novembro,430635,RS,Sul,PFIZER/BIONTECH,118,118,0
Diadema,351380,SP,Sudeste,FIOCRUZ/ASTRAZENECA,82305,77750,4555
Diadema,351380,SP,Sudeste,BUTANTAN/SINOVAC,69954,39578,30376
Diadema,351380,SP,Sudeste,PFIZER/BIONTECH,6902,6894,8
Diamante,250560,PB,Nordeste,FIOCRUZ/ASTRAZENECA,1934,1839,95
Diamante,250560,PB,Nordeste,BUTANTAN/SINOVAC,1365,710,655
Diamante,250560,PB,Nordeste,PFIZER/BIONTECH,177,177,0
Diamante D'Oeste,410715,PR,Sul,BUTANTAN/SINOVAC,1647,845,802
Diamante D'Oeste,410715,PR,Sul,FIOCRUZ/ASTRAZENECA,1279,1200,79
Diamante D'Oeste,410715,PR,Sul,PFIZER/BIONTECH,28,28,0
Diamante Do Norte,410710,PR,Sul,FIOCRUZ/ASTRAZENECA,1558,1438,120
Diamante Do Norte,410710,PR,Sul,BUTANTAN/SINOVAC,1546,871,675
Diamante Do Norte,410710,PR,Sul,PFIZER/BIONTECH,24,24,0
Diamante Do Sul,410712,PR,Sul,FIOCRUZ/ASTRAZENECA,728,686,42
Diamante Do Sul,410712,PR,Sul,BUTANTAN/SINOVAC,606,316,290
Diamantina,312160,MG,Sudeste,BUTANTAN/SINOVAC,8930,4683,4247
Diamantina,312160,MG,Sudeste,FIOCRUZ/ASTRAZENECA,6328,5727,601
Diamantina,312160,MG,Sudeste,PFIZER/BIONTECH,580,579,1
Diamantino,510350,MT,Centro-Oeste,FIOCRUZ/ASTRAZENECA,3388,3196,192
Diamantino,510350,MT,Centro-Oeste,BUTANTAN/SINOVAC,3349,1758,1591
Diamantino,510350,MT,Centro-Oeste,PFIZER/BIONTECH,267,267,0
Dianópolis,170700,TO,Norte,FIOCRUZ/ASTRAZENECA,4227,4068,159
Dianópolis,170700,TO,Norte,BUTANTAN/SINOVAC,3350,1703,1647
Dias D'Ávila,291005,BA,Nordeste,FIOCRUZ/ASTRAZENECA,10733,9187,1546
Dias D'Ávila,291005,BA,Nordeste,BUTANTAN/SINOVAC,8775,4563,4212
Dias D'Ávila,291005,BA,Nordeste,PFIZER/BIONTECH,3148,3146,2
Dilermando De Aguiar,430637,RS,Sul,FIOCRUZ/ASTRAZENECA,910,773,137
Dilermando De Aguiar,430637,RS,Sul,BUTANTAN/SINOVAC,877,438,439
Dilermando De Aguiar,430637,RS,Sul,PFIZER/BIONTECH,132,132,0
Diogo De Vasconcelos,312170,MG,Sudeste,BUTANTAN/SINOVAC,1064,575,489
Diogo De Vasconcelos,312170,MG,Sudeste,FIOCRUZ/ASTRAZENECA,982,923,59
Diogo De Vasconcelos,312170,MG,Sudeste,PFIZER/BIONTECH,137,137,0
Dionísio,312180,MG,Sudeste,BUTANTAN/SINOVAC,2931,1726,1205
Dionísio,312180,MG,Sudeste,FIOCRUZ/ASTRAZENECA,2048,2007,41
Dionísio,312180,MG,Sudeste,PFIZER/BIONTECH,115,115,0
Dionísio Cerqueira,420500,SC,Sul,BUTANTAN/SINOVAC,4061,2192,1869
Dionísio Cerqueira,420500,SC,Sul,FIOCRUZ/ASTRAZENECA,2411,2113,298
Dionísio Cerqueira,420500,SC,Sul,PFIZER/BIONTECH,112,112,0
Diorama,520710,GO,Centro-Oeste,FIOCRUZ/ASTRAZENECA,641,583,58
Diorama,520710,GO,Centro-Oeste,BUTANTAN/SINOVAC,610,313,297
Diorama,520710,GO,Centro-Oeste,PFIZER/BIONTECH,36,36,0
Dirce Reis,351385,SP,Sudeste,BUTANTAN/SINOVAC,647,349,298
Dirce Reis,351385,SP,Sudeste,FIOCRUZ/ASTRAZENECA,568,519,49
Dirce Reis,351385,SP,Sudeste,PFIZER/BIONTECH,56,56,0
Dirceu Arcoverde,220335,PI,Nordeste,FIOCRUZ/ASTRAZENECA,1432,1319,113
Dirceu Arcoverde,220335,PI,Nordeste,BUTANTAN/SINOVAC,1310,658,652
Dirceu Arcoverde,220335,PI,Nordeste,PFIZER/BIONTECH,71,71,0
Divina Pastora,280200,SE,Nordeste,BUTANTAN/SINOVAC,1395,821,574
Divina Pastora,280200,SE,Nordeste,FIOCRUZ/ASTRAZENECA,949,910,39
Divina Pastora,280200,SE,Nordeste,PFIZER/BIONTECH,109,109,0
Divinésia,312190,MG,Sudeste,FIOCRUZ/ASTRAZENECA,1017,962,55
Divinésia,312190,MG,Sudeste,BUTANTAN/SINOVAC,772,404,368
Divinésia,312190,MG,Sudeste,PFIZER/BIONTECH,76,76,0
Divino,312200,MG,Sudeste,FIOCRUZ/ASTRAZENECA,5296,4813,483
Divino,312200,MG,Sudeste,BUTANTAN/SINOVAC,3754,1958,1796
Divino,312200,MG,Sudeste,PFIZER/BIONTECH,573,573,0
Divino Das Laranjeiras,312210,MG,Sudeste,BUTANTAN/SINOVAC,1370,688,682
Divino Das Laranjeiras,312210,MG,Sudeste,FIOCRUZ/ASTRAZENECA,1098,986,112
Divino Das Laranjeiras,312210,MG,Sudeste,PFIZER/BIONTECH,61,61,0
Divino De São Lourenço,320180,ES,Sudeste,FIOCRUZ/ASTRAZENECA,1552,1361,191
Divino De São Lourenço,320180,ES,Sudeste,BUTANTAN/SINOVAC,834,421,413
Divino De São Lourenço,320180,ES,Sudeste,PFIZER/BIONTECH,200,200,0
Divinolândia,351390,SP,Sudeste,BUTANTAN/SINOVAC,3632,1967,1665
Divinolândia,351390,SP,Sudeste,FIOCRUZ/ASTRAZENECA,3537,3002,535
Divinolândia,351390,SP,Sudeste,PFIZER/BIONTECH,370,370,0
Divinolândia De Minas,312220,MG,Sudeste,BUTANTAN/SINOVAC,1655,840,815
Divinolândia De Minas,312220,MG,Sudeste,FIOCRUZ/ASTRAZENECA,1171,1025,146
Divinolândia De Minas,312220,MG,Sudeste,PFIZER/BIONTECH,50,50,0
Divinópolis,312230,MG,Sudeste,BUTANTAN/SINOVAC,50947,27384,23563
Divinópolis,312230,MG,Sudeste,FIOCRUZ/ASTRAZENECA,35054,31107,3947
Divinópolis,312230,MG,Sudeste,PFIZER/BIONTECH,1199,1199,0
Divinópolis De Goiás,520830,GO,Centro-Oeste,FIOCRUZ/ASTRAZENECA,2404,2271,133
Divinópolis De Goiás,520830,GO,Centro-Oeste,BUTANTAN/SINOVAC,520,288,232
Divinópolis Do Tocantins,170710,TO,Norte,BUTANTAN/SINOVAC,1387,711,676
Divinópolis Do Tocantins,170710,TO,Norte,FIOCRUZ/ASTRAZENECA,1003,964,39
Divisa Alegre,312235,MG,Sudeste,BUTANTAN/SINOVAC,1169,587,582
Divisa Alegre,312235,MG,Sudeste,FIOCRUZ/ASTRAZENECA,669,569,100
Divisa Nova,312240,MG,Sudeste,FIOCRUZ/ASTRAZENECA,1398,1267,131
Divisa Nova,312240,MG,Sudeste,BUTANTAN/SINOVAC,1373,687,686
Divisa Nova,312240,MG,Sudeste,PFIZER/BIONTECH,49,49,0
Divisópolis,312245,MG,Sudeste,BUTANTAN/SINOVAC,2356,1217,1139
Divisópolis,312245,MG,Sudeste,FIOCRUZ/ASTRAZENECA,2180,1975,205
Divisópolis,312245,MG,Sudeste,PFIZER/BIONTECH,49,49,0
Dobrada,351400,SP,Sudeste,BUTANTAN/SINOVAC,1638,954,684
Dobrada,351400,SP,Sudeste,FIOCRUZ/ASTRAZENECA,1448,1325,123
Dobrada,351400,SP,Sudeste,PFIZER/BIONTECH,242,241,1
Dois Córregos,351410,SP,Sudeste,BUTANTAN/SINOVAC,6061,3303,2758
Dois Córregos,351410,SP,Sudeste,FIOCRUZ/ASTRAZENECA,5760,5257,503
Dois Córregos,351410,SP,Sudeste,PFIZER/BIONTECH,416,416,0
Dois Irmãos,430640,RS,Sul,FIOCRUZ/ASTRAZENECA,6541,6135,406
Dois Irmãos,430640,RS,Sul,BUTANTAN/SINOVAC,6255,3246,3009
Dois Irmãos,430640,RS,Sul,PFIZER/BIONTECH,1178,1178,0
Dois Irmãos Das Missões,430642,RS,Sul,BUTANTAN/SINOVAC,579,300,279
Dois Irmãos Das Missões,430642,RS,Sul,FIOCRUZ/ASTRAZENECA,570,531,39
Dois Irmãos Das Missões,430642,RS,Sul,PFIZER/BIONTECH,80,80,0
Dois Irmãos Do Buriti,500348,MS,Centro-Oeste,BUTANTAN/SINOVAC,5221,2859,2362
Dois Irmãos Do Buriti,500348,MS,Centro-Oeste,FIOCRUZ/ASTRAZENECA,1698,1389,309
Dois Irmãos Do Buriti,500348,MS,Centro-Oeste,PFIZER/BIONTECH,184,184,0
Dois Irmãos Do Tocantins,170720,TO,Norte,BUTANTAN/SINOVAC,1446,763,683
Dois Irmãos Do Tocantins,170720,TO,Norte,FIOCRUZ/ASTRAZENECA,1041,989,52
Dois Lajeados,430645,RS,Sul,BUTANTAN/SINOVAC,1345,682,663
Dois Lajeados,430645,RS,Sul,FIOCRUZ/ASTRAZENECA,1075,971,104
Dois Lajeados,430645,RS,Sul,PFIZER/BIONTECH,145,143,2
Dois Riachos,270250,AL,Nordeste,FIOCRUZ/ASTRAZENECA,2104,1817,287
Dois Riachos,270250,AL,Nordeste,BUTANTAN/SINOVAC,1821,994,827
Dois Vizinhos,410720,PR,Sul,FIOCRUZ/ASTRAZENECA,9198,8629,569
Dois Vizinhos,410720,PR,Sul,BUTANTAN/SINOVAC,6609,3368,3241
Dois Vizinhos,410720,PR,Sul,PFIZER/BIONTECH,1333,1332,1
Dolcinópolis,351420,SP,Sudeste,BUTANTAN/SINOVAC,785,459,326
Dolcinópolis,351420,SP,Sudeste,FIOCRUZ/ASTRAZENECA,661,599,62
Dolcinópolis,351420,SP,Sudeste,PFIZER/BIONTECH,96,96,0
Dom Aquino,510360,MT,Centro-Oeste,BUTANTAN/SINOVAC,2287,1268,1019
Dom Aquino,510360,MT,Centro-Oeste,FIOCRUZ/ASTRAZENECA,1923,1798,125
Dom Aquino,510360,MT,Centro-Oeste,PFIZER/BIONTECH,54,54,0
Dom Basílio,291010,BA,Nordeste,FIOCRUZ/ASTRAZENECA,3252,2820,432
Dom Basílio,291010,BA,Nordeste,BUTANTAN/SINOVAC,2688,1420,1268
Dom Basílio,291010,BA,Nordeste,PFIZER/BIONTECH,242,241,1
Dom Bosco,312247,MG,Sudeste,BUTANTAN/SINOVAC,994,522,472
Dom Bosco,312247,MG,Sudeste,FIOCRUZ/ASTRAZENECA,885,813,72
Dom Bosco,312247,MG,Sudeste,PFIZER/BIONTECH,89,89,0
Dom Cavati,312250,MG,Sudeste,BUTANTAN/SINOVAC,1485,763,722
Dom Cavati,312250,MG,Sudeste,FIOCRUZ/ASTRAZENECA,1478,1320,158
Dom Cavati,312250,MG,Sudeste,PFIZER/BIONTECH,95,95,0
Dom Eliseu,150293,PA,Norte,FIOCRUZ/ASTRAZENECA,5704,5224,480
Dom Eliseu,150293,PA,Norte,BUTANTAN/SINOVAC,4648,2437,2211
Dom Expedito Lopes,220340,PI,Nordeste,FIOCRUZ/ASTRAZENECA,1526,1267,259
Dom Expedito Lopes,220340,PI,Nordeste,BUTANTAN/SINOVAC,1105,597,508
Dom Feliciano,430650,RS,Sul,BUTANTAN/SINOVAC,3828,2014,1814
Dom Feliciano,430650,RS,Sul,FIOCRUZ/ASTRAZENECA,3237,3026,211
Dom Feliciano,430650,RS,Sul,PFIZER/BIONTECH,588,588,0
Dom Inocêncio,220345,PI,Nordeste,FIOCRUZ/ASTRAZENECA,1978,1854,124
Dom Inocêncio,220345,PI,Nordeste,BUTANTAN/SINOVAC,1639,846,793
Dom Inocêncio,220345,PI,Nordeste,PFIZER/BIONTECH,78,78,0
Dom Joaquim,312260,MG,Sudeste,BUTANTAN/SINOVAC,1257,654,603
Dom Joaquim,312260,MG,Sudeste,FIOCRUZ/ASTRAZENECA,883,770,113
Dom Joaquim,312260,MG,Sudeste,PFIZER/BIONTECH,119,119,0
Dom Macedo Costa,291020,BA,Nordeste,FIOCRUZ/ASTRAZENECA,1091,972,119
Dom Macedo Costa,291020,BA,Nordeste,BUTANTAN/SINOVAC,966,485,481
Dom Macedo Costa,291020,BA,Nordeste,PFIZER/BIONTECH,107,107,0
Dom Pedrito,430660,RS,Sul,FIOCRUZ/ASTRAZENECA,10867,9383,1484
Dom Pedrito,430660,RS,Sul,BUTANTAN/SINOVAC,9703,4949,4754
Dom Pedrito,430660,RS,Sul,PFIZER/BIONTECH,1503,1502,1
Dom Pedro,210380,MA,Nordeste,FIOCRUZ/ASTRAZENECA,5391,4741,650
Dom Pedro,210380,MA,Nordeste,BUTANTAN/SINOVAC,4800,2573,2227
Dom Pedro De Alcântara,430655,RS,Sul,BUTANTAN/SINOVAC,1134,587,547
Dom Pedro De Alcântara,430655,RS,Sul,FIOCRUZ/ASTRAZENECA,729,683,46
Dom Pedro De Alcântara,430655,RS,Sul,PFIZER/BIONTECH,107,107,0
Dom Silvério,312270,MG,Sudeste,FIOCRUZ/ASTRAZENECA,1403,1289,114
Dom Silvério,312270,MG,Sudeste,BUTANTAN/SINOVAC,1214,635,579
Dom Silvério,312270,MG,Sudeste,PFIZER/BIONTECH,48,48,0
Dom Viçoso,312280,MG,Sudeste,FIOCRUZ/ASTRAZENECA,1392,1310,82
Dom Viçoso,312280,MG,Sudeste,BUTANTAN/SINOVAC,809,416,393
Dom Viçoso,312280,MG,Sudeste,PFIZER/BIONTECH,89,89,0
Domingos Martins,320190,ES,Sudeste,BUTANTAN/SINOVAC,9574,4951,4623
Domingos Martins,320190,ES,Sudeste,FIOCRUZ/ASTRAZENECA,7966,7738,228
Domingos Martins,320190,ES,Sudeste,PFIZER/BIONTECH,1042,1040,2
Domingos Mourão,220342,PI,Nordeste,BUTANTAN/SINOVAC,873,443,430
Domingos Mourão,220342,PI,Nordeste,FIOCRUZ/ASTRAZENECA,632,569,63
Dona Emma,420510,SC,Sul,BUTANTAN/SINOVAC,910,461,449
Dona Emma,420510,SC,Sul,FIOCRUZ/ASTRAZENECA,866,808,58
Dona Emma,420510,SC,Sul,PFIZER/BIONTECH,73,73,0
Dona Euzebia,312290,MG,Sudeste,BUTANTAN/SINOVAC,1256,641,615
Dona Euzebia,312290,MG,Sudeste,FIOCRUZ/ASTRAZENECA,1023,932,91
Dona Francisca,430670,RS,Sul,FIOCRUZ/ASTRAZENECA,1203,1118,85
Dona Francisca,430670,RS,Sul,BUTANTAN/SINOVAC,1008,514,494
Dona Francisca,430670,RS,Sul,PFIZER/BIONTECH,137,136,1
Dona Inês,250570,PB,Nordeste,BUTANTAN/SINOVAC,2464,1228,1236
Dona Inês,250570,PB,Nordeste,FIOCRUZ/ASTRAZENECA,2038,1852,186
Dona Inês,250570,PB,Nordeste,PFIZER/BIONTECH,116,116,0
Dores De Campos,312300,MG,Sudeste,FIOCRUZ/ASTRAZENECA,3370,3285,85
Dores De Campos,312300,MG,Sudeste,BUTANTAN/SINOVAC,2060,1098,962
Dores De Campos,312300,MG,Sudeste,PFIZER/BIONTECH,192,192,0
Dores De Guanhães,312310,MG,Sudeste,BUTANTAN/SINOVAC,1540,852,688
Dores De Guanhães,312310,MG,Sudeste,FIOCRUZ/ASTRAZENECA,1104,1014,90
Dores De Guanhães,312310,MG,Sudeste,PFIZER/BIONTECH,58,58,0
Dores Do Indaiá,312320,MG,Sudeste,BUTANTAN/SINOVAC,4190,2168,2022
Dores Do Indaiá,312320,MG,Sudeste,FIOCRUZ/ASTRAZENECA,3739,3408,331
Dores Do Indaiá,312320,MG,Sudeste,PFIZER/BIONTECH,231,231,0
Dores Do Rio Preto,320200,ES,Sudeste,BUTANTAN/SINOVAC,1532,854,678
Dores Do Rio Preto,320200,ES,Sudeste,FIOCRUZ/ASTRAZENECA,1235,1182,53
Dores Do Rio Preto,320200,ES,Sudeste,PFIZER/BIONTECH,137,137,0
Dores Do Turvo,312330,MG,Sudeste,FIOCRUZ/ASTRAZENECA,1251,1165,86
Dores Do Turvo,312330,MG,Sudeste,BUTANTAN/SINOVAC,1034,547,487
Dores Do Turvo,312330,MG,Sudeste,PFIZER/BIONTECH,67,67,0
Doresópolis,312340,MG,Sudeste,BUTANTAN/SINOVAC,459,237,222
Doresópolis,312340,MG,Sudeste,FIOCRUZ/ASTRAZENECA,421,368,53
Doresópolis,312340,MG,Sudeste,PFIZER/BIONTECH,27,27,0
Dormentes,260515,PE,Nordeste,FIOCRUZ/ASTRAZENECA,3748,3406,342
Dormentes,260515,PE,Nordeste,BUTANTAN/SINOVAC,3322,1667,1655
Dormentes,260515,PE,Nordeste,PFIZER/BIONTECH,466,466,0
Douradina,410725,PR,Sul,FIOCRUZ/ASTRAZENECA,2650,2476,174
Douradina,410725,PR,Sul,BUTANTAN/SINOVAC,1670,889,781
Douradina,410725,PR,Sul,PFIZER/BIONTECH,130,130,0
Douradina,500350,MS,Centro-Oeste,BUTANTAN/SINOVAC,2126,1108,1018
Douradina,500350,MS,Centro-Oeste,FIOCRUZ/ASTRAZENECA,1632,1325,307
Douradina,500350,MS,Centro-Oeste,PFIZER/BIONTECH,216,215,1
Dourado,351430,SP,Sudeste,FIOCRUZ/ASTRAZENECA,2418,2192,226
Dourado,351430,SP,Sudeste,BUTANTAN/SINOVAC,2259,1262,997
Dourado,351430,SP,Sudeste,PFIZER/BIONTECH,173,173,0
Douradoquara,312350,MG,Sudeste,BUTANTAN/SINOVAC,584,295,289
Douradoquara,312350,MG,Sudeste,FIOCRUZ/ASTRAZENECA,549,485,64
Douradoquara,312350,MG,Sudeste,PFIZER/BIONTECH,36,36,0
Dourados,500370,MS,Centro-Oeste,BUTANTAN/SINOVAC,68765,37261,31504
Dourados,500370,MS,Centro-Oeste,FIOCRUZ/ASTRAZENECA,52781,48665,4116
Dourados,500370,MS,Centro-Oeste,PFIZER/BIONTECH,7943,7934,9
Doutor Camargo,410730,PR,Sul,FIOCRUZ/ASTRAZENECA,2242,2107,135
Doutor Camargo,410730,PR,Sul,BUTANTAN/SINOVAC,1776,912,864
Doutor Camargo,410730,PR,Sul,PFIZER/BIONTECH,30,30,0
Doutor Maurício Cardoso,430673,RS,Sul,BUTANTAN/SINOVAC,2095,1138,957
Doutor Maurício Cardoso,430673,RS,Sul,FIOCRUZ/ASTRAZENECA,1120,937,183
Doutor Maurício Cardoso,430673,RS,Sul,PFIZER/BIONTECH,109,108,1
Doutor Pedrinho,420515,SC,Sul,BUTANTAN/SINOVAC,989,529,460
Doutor Pedrinho,420515,SC,Sul,FIOCRUZ/ASTRAZENECA,913,903,10
Doutor Ricardo,430675,RS,Sul,BUTANTAN/SINOVAC,703,354,349
Doutor Ricardo,430675,RS,Sul,FIOCRUZ/ASTRAZENECA,668,610,58
Doutor Ricardo,430675,RS,Sul,PFIZER/BIONTECH,87,87,0
Doutor Severiano,240320,RN,Nordeste,BUTANTAN/SINOVAC,1826,932,894
Doutor Severiano,240320,RN,Nordeste,FIOCRUZ/ASTRAZENECA,1600,1506,94
Doutor Severiano,240320,RN,Nordeste,PFIZER/BIONTECH,173,173,0
Doutor Ulysses,412863,PR,Sul,BUTANTAN/SINOVAC,1115,588,527
Doutor Ulysses,412863,PR,Sul,FIOCRUZ/ASTRAZENECA,891,860,31
Doverlândia,520725,GO,Centro-Oeste,FIOCRUZ/ASTRAZENECA,1573,1465,108
Doverlândia,520725,GO,Centro-Oeste,BUTANTAN/SINOVAC,1479,761,718
Doverlândia,520725,GO,Centro-Oeste,PFIZER/BIONTECH,94,94,0
Dracena,351440,SP,Sudeste,BUTANTAN/SINOVAC,15345,8624,6721
Dracena,351440,SP,Sudeste,FIOCRUZ/ASTRAZENECA,13452,12267,1185
Dracena,351440,SP,Sudeste,PFIZER/BIONTECH,955,955,0
Duartina,351450,SP,Sudeste,BUTANTAN/SINOVAC,3806,1994,1812
Duartina,351450,SP,Sudeste,FIOCRUZ/ASTRAZENECA,3611,3234,377
Duartina,351450,SP,Sudeste,PFIZER/BIONTECH,285,285,0
Duas Barras,330160,RJ,Sudeste,BUTANTAN/SINOVAC,873,439,434
Duas Barras,330160,RJ,Sudeste,FIOCRUZ/ASTRAZENECA,303,223,80
Duas Estradas,250580,PB,Nordeste,BUTANTAN/SINOVAC,856,435,421
Duas Estradas,250580,PB,Nordeste,FIOCRUZ/ASTRAZENECA,852,773,79
Duas Estradas,250580,PB,Nordeste,PFIZER/BIONTECH,22,22,0
Dueré,170730,TO,Norte,BUTANTAN/SINOVAC,1157,632,525
Dueré,170730,TO,Norte,FIOCRUZ/ASTRAZENECA,1112,1013,99
Dumont,351460,SP,Sudeste,FIOCRUZ/ASTRAZENECA,1978,1864,114
Dumont,351460,SP,Sudeste,BUTANTAN/SINOVAC,1825,1053,772
Dumont,351460,SP,Sudeste,PFIZER/BIONTECH,192,192,0
Duque Bacelar,210390,MA,Nordeste,FIOCRUZ/ASTRAZENECA,1192,1089,103
Duque Bacelar,210390,MA,Nordeste,BUTANTAN/SINOVAC,1047,587,460
Duque De Caxias,330170,RJ,Sudeste,BUTANTAN/SINOVAC,144801,77594,67207
Duque De Caxias,330170,RJ,Sudeste,FIOCRUZ/ASTRAZENECA,109104,99389,9715
Duque De Caxias,330170,RJ,Sudeste,PFIZER/BIONTECH,14105,14077,28
Durandé,312352,MG,Sudeste,FIOCRUZ/ASTRAZENECA,1630,1530,100
Durandé,312352,MG,Sudeste,BUTANTAN/SINOVAC,1195,598,597
Durandé,312352,MG,Sudeste,PFIZER/BIONTECH,91,91,0
Echaporã,351470,SP,Sudeste,BUTANTAN/SINOVAC,2096,1080,1016
Echaporã,351470,SP,Sudeste,FIOCRUZ/ASTRAZENECA,1622,1506,116
Echaporã,351470,SP,Sudeste,PFIZER/BIONTECH,152,152,0
Ecoporanga,320210,ES,Sudeste,BUTANTAN/SINOVAC,6221,3298,2923
Ecoporanga,320210,ES,Sudeste,FIOCRUZ/ASTRAZENECA,5200,4973,227
Ecoporanga,320210,ES,Sudeste,PFIZER/BIONTECH,776,775,1
Edealina,520735,GO,Centro-Oeste,BUTANTAN/SINOVAC,931,507,424
Edealina,520735,GO,Centro-Oeste,FIOCRUZ/ASTRAZENECA,361,309,52
Edéia,520740,GO,Centro-Oeste,FIOCRUZ/ASTRAZENECA,3447,3204,243
Edéia,520740,GO,Centro-Oeste,BUTANTAN/SINOVAC,2580,1421,1159
Edéia,520740,GO,Centro-Oeste,PFIZER/BIONTECH,185,185,0
Eirunepé,130140,AM,Norte,BUTANTAN/SINOVAC,3487,1959,1528
Eirunepé,130140,AM,Norte,FIOCRUZ/ASTRAZENECA,3371,2732,639
Eldorado,351480,SP,Sudeste,BUTANTAN/SINOVAC,6135,3221,2914
Eldorado,351480,SP,Sudeste,FIOCRUZ/ASTRAZENECA,3828,3291,537
Eldorado,351480,SP,Sudeste,PFIZER/BIONTECH,88,88,0
Eldorado,500375,MS,Centro-Oeste,BUTANTAN/SINOVAC,3157,1671,1486
Eldorado,500375,MS,Centro-Oeste,FIOCRUZ/ASTRAZENECA,2713,2584,129
Eldorado,500375,MS,Centro-Oeste,PFIZER/BIONTECH,290,290,0
Eldorado Do Carajás,150295,PA,Norte,FIOCRUZ/ASTRAZENECA,2927,2603,324
Eldorado Do Carajás,150295,PA,Norte,BUTANTAN/SINOVAC,963,513,450
Eldorado Do Sul,430676,RS,Sul,FIOCRUZ/ASTRAZENECA,7134,6747,387
Eldorado Do Sul,430676,RS,Sul,BUTANTAN/SINOVAC,6970,3647,3323
Eldorado Do Sul,430676,RS,Sul,PFIZER/BIONTECH,507,507,0
Elesbão Veloso,220350,PI,Nordeste,BUTANTAN/SINOVAC,2617,1555,1062
Elesbão Veloso,220350,PI,Nordeste,FIOCRUZ/ASTRAZENECA,1483,1313,170
Elias Fausto,351490,SP,Sudeste,FIOCRUZ/ASTRAZENECA,4047,3818,229
Elias Fausto,351490,SP,Sudeste,BUTANTAN/SINOVAC,2975,1540,1435
Elias Fausto,351490,SP,Sudeste,PFIZER/BIONTECH,292,292,0
Eliseu Martins,220360,PI,Nordeste,BUTANTAN/SINOVAC,988,502,486
Eliseu Martins,220360,PI,Nordeste,FIOCRUZ/ASTRAZENECA,954,864,90
Eliseu Martins,220360,PI,Nordeste,PFIZER/BIONTECH,66,66,0
Elisiário,351492,SP,Sudeste,BUTANTAN/SINOVAC,893,492,401
Elisiário,351492,SP,Sudeste,FIOCRUZ/ASTRAZENECA,823,746,77
Elisiário,351492,SP,Sudeste,PFIZER/BIONTECH,28,28,0
Elísio Medrado,291030,BA,Nordeste,FIOCRUZ/ASTRAZENECA,2088,1776,312
Elísio Medrado,291030,BA,Nordeste,BUTANTAN/SINOVAC,1986,1042,944
Elísio Medrado,291030,BA,Nordeste,PFIZER/BIONTECH,339,339,0
Elói Mendes,312360,MG,Sudeste,BUTANTAN/SINOVAC,5326,2695,2631
Elói Mendes,312360,MG,Sudeste,FIOCRUZ/ASTRAZENECA,4853,4395,458
Elói Mendes,312360,MG,Sudeste,PFIZER/BIONTECH,383,383,0
Emas,250590,PB,Nordeste,BUTANTAN/SINOVAC,733,394,339
Emas,250590,PB,Nordeste,FIOCRUZ/ASTRAZENECA,547,490,57
Emas,250590,PB,Nordeste,PFIZER/BIONTECH,26,26,0
Embaúba,351495,SP,Sudeste,BUTANTAN/SINOVAC,695,372,323
Embaúba,351495,SP,Sudeste,FIOCRUZ/ASTRAZENECA,660,591,69
Embaúba,351495,SP,Sudeste,PFIZER/BIONTECH,75,75,0
Embu,351500,SP,Sudeste,FIOCRUZ/ASTRAZENECA,48628,46356,2272
Embu,351500,SP,Sudeste,BUTANTAN/SINOVAC,36257,20430,15827
Embu,351500,SP,Sudeste,PFIZER/BIONTECH,3799,3799,0
Embu-Guaçu,351510,SP,Sudeste,BUTANTAN/SINOVAC,11865,6742,5123
Embu-Guaçu,351510,SP,Sudeste,FIOCRUZ/ASTRAZENECA,10659,9916,743
Embu-Guaçu,351510,SP,Sudeste,PFIZER/BIONTECH,882,882,0
Emilianópolis,351512,SP,Sudeste,BUTANTAN/SINOVAC,1479,805,674
Emilianópolis,351512,SP,Sudeste,FIOCRUZ/ASTRAZENECA,1144,1042,102
Emilianópolis,351512,SP,Sudeste,PFIZER/BIONTECH,118,118,0
Encantado,430680,RS,Sul,BUTANTAN/SINOVAC,6662,3340,3322
Encantado,430680,RS,Sul,FIOCRUZ/ASTRAZENECA,5742,4936,806
Encantado,430680,RS,Sul,PFIZER/BIONTECH,618,618,0
Encanto,240330,RN,Nordeste,BUTANTAN/SINOVAC,1361,743,618
Encanto,240330,RN,Nordeste,FIOCRUZ/ASTRAZENECA,1259,1174,85
Encanto,240330,RN,Nordeste,PFIZER/BIONTECH,149,149,0
Encruzilhada,291040,BA,Nordeste,BUTANTAN/SINOVAC,3655,1953,1702
Encruzilhada,291040,BA,Nordeste,FIOCRUZ/ASTRAZENECA,3635,3165,470
Encruzilhada,291040,BA,Nordeste,PFIZER/BIONTECH,306,306,0
Encruzilhada Do Sul,430690,RS,Sul,BUTANTAN/SINOVAC,6945,3505,3440
Encruzilhada Do Sul,430690,RS,Sul,FIOCRUZ/ASTRAZENECA,4456,3939,517
Encruzilhada Do Sul,430690,RS,Sul,PFIZER/BIONTECH,413,413,0
Enéas Marques,410740,PR,Sul,FIOCRUZ/ASTRAZENECA,1540,1442,98
Enéas Marques,410740,PR,Sul,BUTANTAN/SINOVAC,1173,613,560
Enéas Marques,410740,PR,Sul,PFIZER/BIONTECH,29,29,0
Engenheiro Beltrão,410750,PR,Sul,FIOCRUZ/ASTRAZENECA,3586,3459,127
Engenheiro Beltrão,410750,PR,Sul,BUTANTAN/SINOVAC,2968,1535,1433
Engenheiro Beltrão,410750,PR,Sul,PFIZER/BIONTECH,30,30,0
Engenheiro Caldas,312370,MG,Sudeste,BUTANTAN/SINOVAC,1967,990,977
Engenheiro Caldas,312370,MG,Sudeste,FIOCRUZ/ASTRAZENECA,1713,1540,173
Engenheiro Caldas,312370,MG,Sudeste,PFIZER/BIONTECH,81,81,0
Engenheiro Coelho,351515,SP,Sudeste,FIOCRUZ/ASTRAZENECA,3699,3526,173
Engenheiro Coelho,351515,SP,Sudeste,BUTANTAN/SINOVAC,3522,2260,1262
Engenheiro Coelho,351515,SP,Sudeste,PFIZER/BIONTECH,397,397,0
Engenheiro Navarro,312380,MG,Sudeste,BUTANTAN/SINOVAC,1609,998,611
Engenheiro Navarro,312380,MG,Sudeste,FIOCRUZ/ASTRAZENECA,1251,1116,135
Engenheiro Navarro,312380,MG,Sudeste,PFIZER/BIONTECH,2,2,0
Engenheiro Paulo De Frontin,330180,RJ,Sudeste,BUTANTAN/SINOVAC,3804,2001,1803
Engenheiro Paulo De Frontin,330180,RJ,Sudeste,FIOCRUZ/ASTRAZENECA,3326,2980,346
Engenheiro Paulo De Frontin,330180,RJ,Sudeste,PFIZER/BIONTECH,104,104,0
Engenho Velho,430692,RS,Sul,BUTANTAN/SINOVAC,939,479,460
Engenho Velho,430692,RS,Sul,FIOCRUZ/ASTRAZENECA,316,268,48
Engenho Velho,430692,RS,Sul,PFIZER/BIONTECH,48,48,0
Entre Folhas,312385,MG,Sudeste,FIOCRUZ/ASTRAZENECA,1483,1346,137
Entre Folhas,312385,MG,Sudeste,BUTANTAN/SINOVAC,1336,677,659
Entre Folhas,312385,MG,Sudeste,PFIZER/BIONTECH,147,147,0
Entre Rios,291050,BA,Nordeste,FIOCRUZ/ASTRAZENECA,6024,5657,367
Entre Rios,291050,BA,Nordeste,BUTANTAN/SINOVAC,5028,2512,2516
Entre Rios,291050,BA,Nordeste,PFIZER/BIONTECH,448,448,0
Entre Rios,420517,SC,Sul,FIOCRUZ/ASTRAZENECA,580,520,60
Entre Rios,420517,SC,Sul,BUTANTAN/SINOVAC,567,283,284
Entre Rios,420517,SC,Sul,PFIZER/BIONTECH,30,30,0
Entre Rios De Minas,312390,MG,Sudeste,BUTANTAN/SINOVAC,4025,2057,1968
Entre Rios De Minas,312390,MG,Sudeste,FIOCRUZ/ASTRAZENECA,3731,3367,364
Entre Rios De Minas,312390,MG,Sudeste,PFIZER/BIONTECH,221,221,0
Entre Rios Do Oeste,410753,PR,Sul,FIOCRUZ/ASTRAZENECA,1234,1154,80
Entre Rios Do Oeste,410753,PR,Sul,BUTANTAN/SINOVAC,1024,517,507
Entre Rios Do Sul,430695,RS,Sul,BUTANTAN/SINOVAC,1044,522,522
Entre Rios Do Sul,430695,RS,Sul,FIOCRUZ/ASTRAZENECA,868,768,100
Entre Rios Do Sul,430695,RS,Sul,PFIZER/BIONTECH,133,132,1
Entre-Ijuís,430693,RS,Sul,BUTANTAN/SINOVAC,2648,1341,1307
Entre-Ijuís,430693,RS,Sul,FIOCRUZ/ASTRAZENECA,2324,2128,196
Entre-Ijuís,430693,RS,Sul,PFIZER/BIONTECH,222,222,0
Envira,130150,AM,Norte,FIOCRUZ/ASTRAZENECA,1682,1446,236
Envira,130150,AM,Norte,BUTANTAN/SINOVAC,1661,1256,405
Epitaciolândia,120025,AC,Norte,FIOCRUZ/ASTRAZENECA,3378,3103,275
Epitaciolândia,120025,AC,Norte,BUTANTAN/SINOVAC,2355,1271,1084
Equador,240340,RN,Nordeste,FIOCRUZ/ASTRAZENECA,1688,1557,131
Equador,240340,RN,Nordeste,BUTANTAN/SINOVAC,1604,804,800
Equador,240340,RN,Nordeste,PFIZER/BIONTECH,79,79,0
Erebango,430697,RS,Sul,BUTANTAN/SINOVAC,1199,604,595
Erebango,430697,RS,Sul,FIOCRUZ/ASTRAZENECA,762,685,77
Erebango,430697,RS,Sul,PFIZER/BIONTECH,89,89,0
Erechim,430700,RS,Sul,FIOCRUZ/ASTRAZENECA,29716,26385,3331
Erechim,430700,RS,Sul,BUTANTAN/SINOVAC,28923,14674,14249
Erechim,430700,RS,Sul,PFIZER/BIONTECH,3665,3665,0
Ererê,230427,CE,Nordeste,BUTANTAN/SINOVAC,1561,787,774
Ererê,230427,CE,Nordeste,FIOCRUZ/ASTRAZENECA,601,462,139
Érico Cardoso,290050,BA,Nordeste,BUTANTAN/SINOVAC,3095,1751,1344
Érico Cardoso,290050,BA,Nordeste,FIOCRUZ/ASTRAZENECA,2614,2530,84
Érico Cardoso,290050,BA,Nordeste,PFIZER/BIONTECH,24,24,0
Ermo,420519,SC,Sul,BUTANTAN/SINOVAC,666,387,279
Ermo,420519,SC,Sul,FIOCRUZ/ASTRAZENECA,633,573,60
Ermo,420519,SC,Sul,PFIZER/BIONTECH,16,16,0
Ernestina,430705,RS,Sul,FIOCRUZ/ASTRAZENECA,1100,978,122
Ernestina,430705,RS,Sul,BUTANTAN/SINOVAC,830,415,415
Ernestina,430705,RS,Sul,PFIZER/BIONTECH,132,132,0
Erval Grande,430720,RS,Sul,BUTANTAN/SINOVAC,1686,872,814
Erval Grande,430720,RS,Sul,FIOCRUZ/ASTRAZENECA,1399,1217,182
Erval Grande,430720,RS,Sul,PFIZER/BIONTECH,119,119,0
Erval Seco,430730,RS,Sul,BUTANTAN/SINOVAC,2819,1443,1376
Erval Seco,430730,RS,Sul,FIOCRUZ/ASTRAZENECA,1858,1787,71
Erval Seco,430730,RS,Sul,PFIZER/BIONTECH,122,122,0
Erval Velho,420520,SC,Sul,BUTANTAN/SINOVAC,1456,779,677
Erval Velho,420520,SC,Sul,FIOCRUZ/ASTRAZENECA,1142,1048,94
Erval Velho,420520,SC,Sul,PFIZER/BIONTECH,114,114,0
Ervália,312400,MG,Sudeste,FIOCRUZ/ASTRAZENECA,4071,3747,324
Ervália,312400,MG,Sudeste,BUTANTAN/SINOVAC,3810,1923,1887
Ervália,312400,MG,Sudeste,PFIZER/BIONTECH,414,414,0
Escada,260520,PE,Nordeste,FIOCRUZ/ASTRAZENECA,10710,10130,580
Escada,260520,PE,Nordeste,BUTANTAN/SINOVAC,7926,4392,3534
Escada,260520,PE,Nordeste,PFIZER/BIONTECH,357,357,0
Esmeralda,430740,RS,Sul,BUTANTAN/SINOVAC,931,476,455
Esmeralda,430740,RS,Sul,FIOCRUZ/ASTRAZENECA,842,782,60
Esmeralda,430740,RS,Sul,PFIZER/BIONTECH,113,113,0
Esmeraldas,312410,MG,Sudeste,BUTANTAN/SINOVAC,8882,4908,3974
Esmeraldas,312410,MG,Sudeste,FIOCRUZ/ASTRAZENECA,4869,4409,460
Esmeraldas,312410,MG,Sudeste,PFIZER/BIONTECH,12,12,0
Espera Feliz,312420,MG,Sudeste,FIOCRUZ/ASTRAZENECA,5258,4964,294
Espera Feliz,312420,MG,Sudeste,BUTANTAN/SINOVAC,4572,2279,2293
Espera Feliz,312420,MG,Sudeste,PFIZER/BIONTECH,571,571,0
Esperança,250600,PB,Nordeste,BUTANTAN/SINOVAC,5370,2813,2557
Esperança,250600,PB,Nordeste,FIOCRUZ/ASTRAZENECA,4658,4240,418
Esperança,250600,PB,Nordeste,PFIZER/BIONTECH,281,281,0
Esperança Do Sul,430745,RS,Sul,BUTANTAN/SINOVAC,1108,558,550
Esperança Do Sul,430745,RS,Sul,FIOCRUZ/ASTRAZENECA,934,873,61
Esperança Do Sul,430745,RS,Sul,PFIZER/BIONTECH,112,112,0
Esperança Nova,410752,PR,Sul,FIOCRUZ/ASTRAZENECA,738,687,51
Esperança Nova,410752,PR,Sul,BUTANTAN/SINOVAC,622,329,293
Esperança Nova,410752,PR,Sul,PFIZER/BIONTECH,12,12,0
Esperantina,170740,TO,Norte,BUTANTAN/SINOVAC,1176,599,577
Esperantina,170740,TO,Norte,FIOCRUZ/ASTRAZENECA,1116,1056,60
Esperantina,220370,PI,Nordeste,FIOCRUZ/ASTRAZENECA,7600,7043,557
Esperantina,220370,PI,Nordeste,BUTANTAN/SINOVAC,6208,3395,2813
Esperantina,220370,PI,Nordeste,PFIZER/BIONTECH,5,5,0
Esperantinópolis,210400,MA,Nordeste,FIOCRUZ/ASTRAZENECA,5186,4983,203
Esperantinópolis,210400,MA,Nordeste,BUTANTAN/SINOVAC,2900,1536,1364
Espigão Alto Do Iguaçu,410754,PR,Sul,BUTANTAN/SINOVAC,1428,766,662
Espigão Alto Do Iguaçu,410754,PR,Sul,FIOCRUZ/ASTRAZENECA,1249,1172,77
Espigão Alto Do Iguaçu,410754,PR,Sul,PFIZER/BIONTECH,24,24,0
Espigão D'Oeste,110009,RO,Norte,BUTANTAN/SINOVAC,5578,2892,2686
Espigão D'Oeste,110009,RO,Norte,FIOCRUZ/ASTRAZENECA,3109,2931,178
Espigão D'Oeste,110009,RO,Norte,PFIZER/BIONTECH,523,523,0
Espinosa,312430,MG,Sudeste,BUTANTAN/SINOVAC,4155,2158,1997
Espinosa,312430,MG,Sudeste,FIOCRUZ/ASTRAZENECA,1676,1608,68
Espírito Santo,240350,RN,Nordeste,BUTANTAN/SINOVAC,2003,1028,975
Espírito Santo,240350,RN,Nordeste,FIOCRUZ/ASTRAZENECA,1584,1477,107
Espírito Santo,240350,RN,Nordeste,PFIZER/BIONTECH,289,289,0
Espírito Santo Do Dourado,312440,MG,Sudeste,BUTANTAN/SINOVAC,1225,624,601
Espírito Santo Do Dourado,312440,MG,Sudeste,FIOCRUZ/ASTRAZENECA,1124,1039,85
Espírito Santo Do Dourado,312440,MG,Sudeste,PFIZER/BIONTECH,147,147,0
Espírito Santo Do Pinhal,351518,SP,Sudeste,BUTANTAN/SINOVAC,12610,7006,5604
Espírito Santo Do Pinhal,351518,SP,Sudeste,FIOCRUZ/ASTRAZENECA,11969,10864,1105
Espírito Santo Do Pinhal,351518,SP,Sudeste,PFIZER/BIONTECH,1092,1092,0
Espírito Santo Do Turvo,351519,SP,Sudeste,FIOCRUZ/ASTRAZENECA,1002,953,49
Espírito Santo Do Turvo,351519,SP,Sudeste,BUTANTAN/SINOVAC,829,436,393
Espírito Santo Do Turvo,351519,SP,Sudeste,PFIZER/BIONTECH,138,138,0
Esplanada,291060,BA,Nordeste,FIOCRUZ/ASTRAZENECA,4067,3794,273
Esplanada,291060,BA,Nordeste,BUTANTAN/SINOVAC,3244,2010,1234
Esplanada,291060,BA,Nordeste,PFIZER/BIONTECH,229,229,0
Espumoso,430750,RS,Sul,FIOCRUZ/ASTRAZENECA,4903,4604,299
Espumoso,430750,RS,Sul,BUTANTAN/SINOVAC,4163,2101,2062
Espumoso,430750,RS,Sul,PFIZER/BIONTECH,562,562,0
Estação,430755,RS,Sul,BUTANTAN/SINOVAC,1835,973,862
Estação,430755,RS,Sul,FIOCRUZ/ASTRAZENECA,1714,1502,212
Estação,430755,RS,Sul,PFIZER/BIONTECH,237,237,0
Estância,280210,SE,Nordeste,BUTANTAN/SINOVAC,10125,5246,4879
Estância,280210,SE,Nordeste,FIOCRUZ/ASTRAZENECA,7429,6856,573
Estância,280210,SE,Nordeste,PFIZER/BIONTECH,37,37,0
Estância Velha,430760,RS,Sul,BUTANTAN/SINOVAC,12562,6386,6176
Estância Velha,430760,RS,Sul,FIOCRUZ/ASTRAZENECA,10911,10235,676
Estância Velha,430760,RS,Sul,PFIZER/BIONTECH,1684,1679,5
Esteio,430770,RS,Sul,BUTANTAN/SINOVAC,25161,12842,12319
Esteio,430770,RS,Sul,FIOCRUZ/ASTRAZENECA,20514,19183,1331
Esteio,430770,RS,Sul,PFIZER/BIONTECH,2831,2829,2
Estiva,312450,MG,Sudeste,BUTANTAN/SINOVAC,2552,1284,1268
Estiva,312450,MG,Sudeste,FIOCRUZ/ASTRAZENECA,1549,1464,85
Estiva Gerbi,355730,SP,Sudeste,FIOCRUZ/ASTRAZENECA,2234,2085,149
Estiva Gerbi,355730,SP,Sudeste,BUTANTAN/SINOVAC,1961,1117,844
Estiva Gerbi,355730,SP,Sudeste,PFIZER/BIONTECH,234,234,0
Estreito,210405,MA,Nordeste,FIOCRUZ/ASTRAZENECA,5113,4823,290
Estreito,210405,MA,Nordeste,BUTANTAN/SINOVAC,4019,2095,1924
Estrela,430780,RS,Sul,BUTANTAN/SINOVAC,9633,4857,4776
Estrela,430780,RS,Sul,FIOCRUZ/ASTRAZENECA,8988,7914,1074
Estrela,430780,RS,Sul,PFIZER/BIONTECH,350,350,0
Estrela D'Oeste,351520,SP,Sudeste,BUTANTAN/SINOVAC,4366,2261,2105
Estrela D'Oeste,351520,SP,Sudeste,FIOCRUZ/ASTRAZENECA,3605,3317,288
Estrela D'Oeste,351520,SP,Sudeste,PFIZER/BIONTECH,325,325,0
Estrela Dalva,312460,MG,Sudeste,BUTANTAN/SINOVAC,851,440,411
Estrela Dalva,312460,MG,Sudeste,FIOCRUZ/ASTRAZENECA,747,677,70
Estrela Dalva,312460,MG,Sudeste,PFIZER/BIONTECH,147,147,0
Estrela De Alagoas,270255,AL,Nordeste,FIOCRUZ/ASTRAZENECA,3841,3489,352
Estrela De Alagoas,270255,AL,Nordeste,BUTANTAN/SINOVAC,3233,1657,1576
Estrela Do Indaiá,312470,MG,Sudeste,BUTANTAN/SINOVAC,1185,599,586
Estrela Do Indaiá,312470,MG,Sudeste,FIOCRUZ/ASTRAZENECA,972,883,89
Estrela Do Indaiá,312470,MG,Sudeste,PFIZER/BIONTECH,65,65,0
Estrela Do Norte,351530,SP,Sudeste,FIOCRUZ/ASTRAZENECA,840,780,60
Estrela Do Norte,351530,SP,Sudeste,BUTANTAN/SINOVAC,704,390,314
Estrela Do Norte,351530,SP,Sudeste,PFIZER/BIONTECH,92,92,0
Estrela Do Norte,520750,GO,Centro-Oeste,FIOCRUZ/ASTRAZENECA,1157,1093,64
Estrela Do Norte,520750,GO,Centro-Oeste,BUTANTAN/SINOVAC,606,320,286
Estrela Do Sul,312480,MG,Sudeste,BUTANTAN/SINOVAC,1523,774,749
Estrela Do Sul,312480,MG,Sudeste,FIOCRUZ/ASTRAZENECA,1230,1087,143
Estrela Do Sul,312480,MG,Sudeste,PFIZER/BIONTECH,124,122,2
Estrela Velha,430781,RS,Sul,FIOCRUZ/ASTRAZENECA,881,827,54
Estrela Velha,430781,RS,Sul,BUTANTAN/SINOVAC,855,430,425
Estrela Velha,430781,RS,Sul,PFIZER/BIONTECH,148,148,0
Euclides Da Cunha,291070,BA,Nordeste,BUTANTAN/SINOVAC,14176,7442,6734
Euclides Da Cunha,291070,BA,Nordeste,FIOCRUZ/ASTRAZENECA,12221,10661,1560
Euclides Da Cunha,291070,BA,Nordeste,PFIZER/BIONTECH,2092,2092,0
Euclides Da Cunha Paulista,351535,SP,Sudeste,FIOCRUZ/ASTRAZENECA,2213,2045,168
Euclides Da Cunha Paulista,351535,SP,Sudeste,BUTANTAN/SINOVAC,2091,1188,903
Euclides Da Cunha Paulista,351535,SP,Sudeste,PFIZER/BIONTECH,194,194,0
Eugênio De Castro,430783,RS,Sul,BUTANTAN/SINOVAC,929,469,460
Eugênio De Castro,430783,RS,Sul,FIOCRUZ/ASTRAZENECA,697,633,64
Eugênio De Castro,430783,RS,Sul,PFIZER/BIONTECH,125,125,0
Eugenópolis,312490,MG,Sudeste,BUTANTAN/SINOVAC,2716,1445,1271
Eugenópolis,312490,MG,Sudeste,FIOCRUZ/ASTRAZENECA,2687,2501,186
Eugenópolis,312490,MG,Sudeste,PFIZER/BIONTECH,416,415,1
Eunápolis,291072,BA,Nordeste,BUTANTAN/SINOVAC,15064,7932,7132
Eunápolis,291072,BA,Nordeste,FIOCRUZ/ASTRAZENECA,14099,13128,971
Eunápolis,291072,BA,Nordeste,PFIZER/BIONTECH,421,419,2
Eusébio,230428,CE,Nordeste,FIOCRUZ/ASTRAZENECA,13328,12863,465
Eusébio,230428,CE,Nordeste,BUTANTAN/SINOVAC,8990,4621,4369
Eusébio,230428,CE,Nordeste,PFIZER/BIONTECH,1647,1644,3
Ewbank Da Câmara,312500,MG,Sudeste,FIOCRUZ/ASTRAZENECA,1165,1103,62
Ewbank Da Câmara,312500,MG,Sudeste,BUTANTAN/SINOVAC,701,364,337
Ewbank Da Câmara,312500,MG,Sudeste,PFIZER/BIONTECH,71,71,0
Extrema,312510,MG,Sudeste,BUTANTAN/SINOVAC,5404,2822,2582
Extrema,312510,MG,Sudeste,FIOCRUZ/ASTRAZENECA,2753,2615,138
Extrema,312510,MG,Sudeste,PFIZER/BIONTECH,5,5,0
Extremoz,240360,RN,Nordeste,FIOCRUZ/ASTRAZENECA,5249,4839,410
Extremoz,240360,RN,Nordeste,BUTANTAN/SINOVAC,4002,2055,1947
Extremoz,240360,RN,Nordeste,PFIZER/BIONTECH,1478,1476,2
Exu,260530,PE,Nordeste,FIOCRUZ/ASTRAZENECA,6630,5885,745
Exu,260530,PE,Nordeste,BUTANTAN/SINOVAC,5620,2859,2761
Exu,260530,PE,Nordeste,PFIZER/BIONTECH,614,613,1
Fagundes,250610,PB,Nordeste,BUTANTAN/SINOVAC,2281,1316,965
Fagundes,250610,PB,Nordeste,FIOCRUZ/ASTRAZENECA,1606,1500,106
Fagundes,250610,PB,Nordeste,PFIZER/BIONTECH,10,10,0
Fagundes Varela,430786,RS,Sul,FIOCRUZ/ASTRAZENECA,799,711,88
Fagundes Varela,430786,RS,Sul,BUTANTAN/SINOVAC,786,399,387
Fagundes Varela,430786,RS,Sul,PFIZER/BIONTECH,99,99,0
Faina,520753,GO,Centro-Oeste,FIOCRUZ/ASTRAZENECA,2245,2107,138
Faina,520753,GO,Centro-Oeste,BUTANTAN/SINOVAC,1667,896,771
Fama,312520,MG,Sudeste,BUTANTAN/SINOVAC,741,396,345
Fama,312520,MG,Sudeste,FIOCRUZ/ASTRAZENECA,716,676,40
Fama,312520,MG,Sudeste,PFIZER/BIONTECH,31,31,0
Faria Lemos,312530,MG,Sudeste,FIOCRUZ/ASTRAZENECA,914,835,79
Faria Lemos,312530,MG,Sudeste,BUTANTAN/SINOVAC,830,443,387
Faria Lemos,312530,MG,Sudeste,PFIZER/BIONTECH,74,73,1
Farias Brito,230430,CE,Nordeste,BUTANTAN/SINOVAC,4753,2444,2309
Farias Brito,230430,CE,Nordeste,FIOCRUZ/ASTRAZENECA,1860,1439,421
Farias Brito,230430,CE,Nordeste,PFIZER/BIONTECH,1,1,0
Faro,150300,PA,Norte,FIOCRUZ/ASTRAZENECA,3135,2399,736
Faro,150300,PA,Norte,BUTANTAN/SINOVAC,478,266,212
Farol,410755,PR,Sul,FIOCRUZ/ASTRAZENECA,1310,1239,71
Farol,410755,PR,Sul,BUTANTAN/SINOVAC,703,355,348
Farol,410755,PR,Sul,PFIZER/BIONTECH,16,16,0
Farroupilha,430790,RS,Sul,FIOCRUZ/ASTRAZENECA,20010,17808,2202
Farroupilha,430790,RS,Sul,BUTANTAN/SINOVAC,12721,6458,6263
Farroupilha,430790,RS,Sul,PFIZER/BIONTECH,2397,2396,1
Fartura,351540,SP,Sudeste,BUTANTAN/SINOVAC,4535,2385,2150
Fartura,351540,SP,Sudeste,FIOCRUZ/ASTRAZENECA,3216,2908,308
Fartura,351540,SP,Sudeste,PFIZER/BIONTECH,374,374,0
Fartura Do Piauí,220375,PI,Nordeste,FIOCRUZ/ASTRAZENECA,1742,1660,82
Fartura Do Piauí,220375,PI,Nordeste,BUTANTAN/SINOVAC,1020,533,487
Fátima,170755,TO,Norte,FIOCRUZ/ASTRAZENECA,844,808,36
Fátima,170755,TO,Norte,BUTANTAN/SINOVAC,822,429,393
Fátima,291075,BA,Nordeste,FIOCRUZ/ASTRAZENECA,4586,3997,589
Fátima,291075,BA,Nordeste,BUTANTAN/SINOVAC,4261,2246,2015
Fátima,291075,BA,Nordeste,PFIZER/BIONTECH,353,353,0
Fátima Do Sul,500380,MS,Centro-Oeste,FIOCRUZ/ASTRAZENECA,6840,5418,1422
Fátima Do Sul,500380,MS,Centro-Oeste,BUTANTAN/SINOVAC,5561,2923,2638
Fátima Do Sul,500380,MS,Centro-Oeste,PFIZER/BIONTECH,721,720,1
Faxinal,410760,PR,Sul,FIOCRUZ/ASTRAZENECA,4418,4179,239
Faxinal,410760,PR,Sul,BUTANTAN/SINOVAC,3905,2028,1877
Faxinal,410760,PR,Sul,PFIZER/BIONTECH,208,208,0
Faxinal Do Soturno,430800,RS,Sul,BUTANTAN/SINOVAC,2326,1176,1150
Faxinal Do Soturno,430800,RS,Sul,FIOCRUZ/ASTRAZENECA,2021,1783,238
Faxinal Do Soturno,430800,RS,Sul,PFIZER/BIONTECH,251,251,0
Faxinal Dos Guedes,420530,SC,Sul,FIOCRUZ/ASTRAZENECA,2737,2517,220
Faxinal Dos Guedes,420530,SC,Sul,BUTANTAN/SINOVAC,2132,1125,1007
Faxinal Dos Guedes,420530,SC,Sul,PFIZER/BIONTECH,249,249,0
Faxinalzinho,430805,RS,Sul,BUTANTAN/SINOVAC,813,400,413
Faxinalzinho,430805,RS,Sul,FIOCRUZ/ASTRAZENECA,701,633,68
Faxinalzinho,430805,RS,Sul,PFIZER/BIONTECH,83,83,0
Fazenda Nova,520760,GO,Centro-Oeste,FIOCRUZ/ASTRAZENECA,1526,1414,112
Fazenda Nova,520760,GO,Centro-Oeste,BUTANTAN/SINOVAC,1446,734,712
Fazenda Nova,520760,GO,Centro-Oeste,PFIZER/BIONTECH,66,66,0
Fazenda Rio Grande,410765,PR,Sul,FIOCRUZ/ASTRAZENECA,16255,15745,510
Fazenda Rio Grande,410765,PR,Sul,BUTANTAN/SINOVAC,12031,6226,5805
Fazenda Rio Grande,410765,PR,Sul,PFIZER/BIONTECH,3517,3516,1
Fazenda Vilanova,430807,RS,Sul,FIOCRUZ/ASTRAZENECA,1007,952,55
Fazenda Vilanova,430807,RS,Sul,BUTANTAN/SINOVAC,946,471,475
Fazenda Vilanova,430807,RS,Sul,PFIZER/BIONTECH,159,159,0
Feijó,120030,AC,Norte,FIOCRUZ/ASTRAZENECA,4710,4005,705
Feijó,120030,AC,Norte,BUTANTAN/SINOVAC,4302,2613,1689
Feira Da Mata,291077,BA,Nordeste,FIOCRUZ/ASTRAZENECA,1466,1378,88
Feira Da Mata,291077,BA,Nordeste,BUTANTAN/SINOVAC,1405,729,676
Feira Da Mata,291077,BA,Nordeste,PFIZER/BIONTECH,98,98,0
Feira De Santana,291080,BA,Nordeste,BUTANTAN/SINOVAC,134374,73564,60810
Feira De Santana,291080,BA,Nordeste,FIOCRUZ/ASTRAZENECA,131018,112691,18327
Feira De Santana,291080,BA,Nordeste,PFIZER/BIONTECH,15256,15219,37
Feira Grande,270260,AL,Nordeste,BUTANTAN/SINOVAC,4624,2349,2275
Feira Grande,270260,AL,Nordeste,FIOCRUZ/ASTRAZENECA,4086,3653,433
Feira Grande,270260,AL,Nordeste,PFIZER/BIONTECH,176,176,0
Feira Nova,260540,PE,Nordeste,FIOCRUZ/ASTRAZENECA,5348,4938,410
Feira Nova,260540,PE,Nordeste,BUTANTAN/SINOVAC,3859,2021,1838
Feira Nova,260540,PE,Nordeste,PFIZER/BIONTECH,658,658,0
Feira Nova,280220,SE,Nordeste,BUTANTAN/SINOVAC,1082,548,534
Feira Nova,280220,SE,Nordeste,FIOCRUZ/ASTRAZENECA,803,803,0
Feira Nova,280220,SE,Nordeste,PFIZER/BIONTECH,138,138,0
Feira Nova Do Maranhão,210407,MA,Nordeste,BUTANTAN/SINOVAC,1169,612,557
Feira Nova Do Maranhão,210407,MA,Nordeste,FIOCRUZ/ASTRAZENECA,1110,1051,59
Felício Dos Santos,312540,MG,Sudeste,BUTANTAN/SINOVAC,1764,995,769
Felício Dos Santos,312540,MG,Sudeste,FIOCRUZ/ASTRAZENECA,1187,1072,115
Felício Dos Santos,312540,MG,Sudeste,PFIZER/BIONTECH,143,143,0
Felipe Guerra,240370,RN,Nordeste,FIOCRUZ/ASTRAZENECA,2007,1926,81
Felipe Guerra,240370,RN,Nordeste,BUTANTAN/SINOVAC,1878,987,891
Felipe Guerra,240370,RN,Nordeste,PFIZER/BIONTECH,307,307,0
Felisburgo,312560,MG,Sudeste,BUTANTAN/SINOVAC,1787,905,882
Felisburgo,312560,MG,Sudeste,FIOCRUZ/ASTRAZENECA,1338,1184,154
Felisburgo,312560,MG,Sudeste,PFIZER/BIONTECH,65,65,0
Felixlândia,312570,MG,Sudeste,BUTANTAN/SINOVAC,3421,1757,1664
Felixlândia,312570,MG,Sudeste,FIOCRUZ/ASTRAZENECA,3183,2909,274
Felixlândia,312570,MG,Sudeste,PFIZER/BIONTECH,465,465,0
Feliz,430810,RS,Sul,FIOCRUZ/ASTRAZENECA,4210,3721,489
Feliz,430810,RS,Sul,BUTANTAN/SINOVAC,2964,1490,1474
Feliz,430810,RS,Sul,PFIZER/BIONTECH,495,495,0
Feliz Deserto,270270,AL,Nordeste,FIOCRUZ/ASTRAZENECA,984,908,76
Feliz Deserto,270270,AL,Nordeste,BUTANTAN/SINOVAC,843,455,388
Feliz Natal,510370,MT,Centro-Oeste,BUTANTAN/SINOVAC,1527,807,720
Feliz Natal,510370,MT,Centro-Oeste,FIOCRUZ/ASTRAZENECA,1520,1430,90
Feliz Natal,510370,MT,Centro-Oeste,PFIZER/BIONTECH,244,244,0
Fênix,410770,PR,Sul,FIOCRUZ/ASTRAZENECA,1234,1202,32
Fênix,410770,PR,Sul,BUTANTAN/SINOVAC,1199,622,577
Fernandes Pinheiro,410773,PR,Sul,FIOCRUZ/ASTRAZENECA,1383,1318,65
Fernandes Pinheiro,410773,PR,Sul,BUTANTAN/SINOVAC,961,510,451
Fernandes Pinheiro,410773,PR,Sul,PFIZER/BIONTECH,34,34,0
Fernandes Tourinho,312580,MG,Sudeste,BUTANTAN/SINOVAC,862,437,425
Fernandes Tourinho,312580,MG,Sudeste,FIOCRUZ/ASTRAZENECA,537,466,71
Fernandes Tourinho,312580,MG,Sudeste,PFIZER/BIONTECH,51,51,0
Fernando De Noronha,260545,PE,Nordeste,FIOCRUZ/ASTRAZENECA,3417,3171,246
Fernando De Noronha,260545,PE,Nordeste,BUTANTAN/SINOVAC,1039,535,504
Fernando De Noronha,260545,PE,Nordeste,PFIZER/BIONTECH,46,46,0
Fernando Falcão,210408,MA,Nordeste,FIOCRUZ/ASTRAZENECA,1812,1650,162
Fernando Falcão,210408,MA,Nordeste,BUTANTAN/SINOVAC,1332,841,491
Fernando Pedroza,240375,RN,Nordeste,FIOCRUZ/ASTRAZENECA,934,879,55
Fernando Pedroza,240375,RN,Nordeste,BUTANTAN/SINOVAC,868,453,415
Fernando Pedroza,240375,RN,Nordeste,PFIZER/BIONTECH,94,94,0
Fernando Prestes,351560,SP,Sudeste,BUTANTAN/SINOVAC,2025,1081,944
Fernando Prestes,351560,SP,Sudeste,FIOCRUZ/ASTRAZENECA,1559,1403,156
Fernando Prestes,351560,SP,Sudeste,PFIZER/BIONTECH,146,146,0
Fernandópolis,351550,SP,Sudeste,BUTANTAN/SINOVAC,22231,12224,10007
Fernandópolis,351550,SP,Sudeste,FIOCRUZ/ASTRAZENECA,20151,17973,2178
Fernandópolis,351550,SP,Sudeste,PFIZER/BIONTECH,2109,2108,1
Fernão,351565,SP,Sudeste,BUTANTAN/SINOVAC,954,485,469
Fernão,351565,SP,Sudeste,FIOCRUZ/ASTRAZENECA,785,696,89
Fernão,351565,SP,Sudeste,PFIZER/BIONTECH,48,48,0
Ferraz De Vasconcelos,351570,SP,Sudeste,FIOCRUZ/ASTRAZENECA,25830,24221,1609
Ferraz De Vasconcelos,351570,SP,Sudeste,BUTANTAN/SINOVAC,23872,13268,10604
Ferraz De Vasconcelos,351570,SP,Sudeste,PFIZER/BIONTECH,4695,4690,5
Ferreira Gomes,160023,AP,Norte,FIOCRUZ/ASTRAZENECA,1489,1439,50
Ferreira Gomes,160023,AP,Norte,BUTANTAN/SINOVAC,1025,532,493
Ferreira Gomes,160023,AP,Norte,PFIZER/BIONTECH,214,214,0
Ferreiros,260550,PE,Nordeste,FIOCRUZ/ASTRAZENECA,2856,2630,226
Ferreiros,260550,PE,Nordeste,BUTANTAN/SINOVAC,1934,974,960
Ferreiros,260550,PE,Nordeste,PFIZER/BIONTECH,188,188,0
Ferros,312590,MG,Sudeste,BUTANTAN/SINOVAC,2419,1220,1199
Ferros,312590,MG,Sudeste,FIOCRUZ/ASTRAZENECA,2382,2216,166
Ferros,312590,MG,Sudeste,PFIZER/BIONTECH,6,5,1
Fervedouro,312595,MG,Sudeste,FIOCRUZ/ASTRAZENECA,2387,2302,85
Fervedouro,312595,MG,Sudeste,BUTANTAN/SINOVAC,1768,930,838
Fervedouro,312595,MG,Sudeste,PFIZER/BIONTECH,478,478,0
Figueira,410775,PR,Sul,BUTANTAN/SINOVAC,2187,1161,1026
Figueira,410775,PR,Sul,FIOCRUZ/ASTRAZENECA,1957,1823,134
Figueira,410775,PR,Sul,PFIZER/BIONTECH,124,124,0
Figueirão,500390,MS,Centro-Oeste,FIOCRUZ/ASTRAZENECA,1037,790,247
Figueirão,500390,MS,Centro-Oeste,BUTANTAN/SINOVAC,357,113,244
Figueirão,500390,MS,Centro-Oeste,PFIZER/BIONTECH,86,86,0
Figueirópolis,170765,TO,Norte,BUTANTAN/SINOVAC,1109,577,532
Figueirópolis,170765,TO,Norte,FIOCRUZ/ASTRAZENECA,764,725,39
Figueirópolis D'Oeste,510380,MT,Centro-Oeste,FIOCRUZ/ASTRAZENECA,1121,1071,50
Figueirópolis D'Oeste,510380,MT,Centro-Oeste,BUTANTAN/SINOVAC,829,416,413
Figueirópolis D'Oeste,510380,MT,Centro-Oeste,PFIZER/BIONTECH,7,7,0
Filadélfia,170770,TO,Norte,BUTANTAN/SINOVAC,1928,1030,898
Filadélfia,170770,TO,Norte,FIOCRUZ/ASTRAZENECA,1302,1189,113
Filadélfia,291085,BA,Nordeste,FIOCRUZ/ASTRAZENECA,7406,6767,639
Filadélfia,291085,BA,Nordeste,BUTANTAN/SINOVAC,3146,1581,1565
Filadélfia,291085,BA,Nordeste,PFIZER/BIONTECH,71,69,2
Firmino Alves,291090,BA,Nordeste,BUTANTAN/SINOVAC,599,319,280
Firmino Alves,291090,BA,Nordeste,FIOCRUZ/ASTRAZENECA,273,231,42
Firminópolis,520780,GO,Centro-Oeste,FIOCRUZ/ASTRAZENECA,3677,3388,289
Firminópolis,520780,GO,Centro-Oeste,BUTANTAN/SINOVAC,3296,1695,1601
Firminópolis,520780,GO,Centro-Oeste,PFIZER/BIONTECH,49,49,0
Flexeiras,270280,AL,Nordeste,BUTANTAN/SINOVAC,1860,1007,853
Flexeiras,270280,AL,Nordeste,FIOCRUZ/ASTRAZENECA,1603,1411,192
Flor Da Serra Do Sul,410785,PR,Sul,FIOCRUZ/ASTRAZENECA,1316,1244,72
Flor Da Serra Do Sul,410785,PR,Sul,BUTANTAN/SINOVAC,990,510,480
Flor Da Serra Do Sul,410785,PR,Sul,PFIZER/BIONTECH,30,30,0
Flor Do Sertão,420535,SC,Sul,BUTANTAN/SINOVAC,554,300,254
Flor Do Sertão,420535,SC,Sul,FIOCRUZ/ASTRAZENECA,512,469,43
Flor Do Sertão,420535,SC,Sul,PFIZER/BIONTECH,26,26,0
Flora Rica,351580,SP,Sudeste,BUTANTAN/SINOVAC,1625,869,756
Flora Rica,351580,SP,Sudeste,FIOCRUZ/ASTRAZENECA,945,807,138
Flora Rica,351580,SP,Sudeste,PFIZER/BIONTECH,50,50,0
Floraí,410780,PR,Sul,FIOCRUZ/ASTRAZENECA,1836,1705,131
Floraí,410780,PR,Sul,BUTANTAN/SINOVAC,1543,806,737
Floraí,410780,PR,Sul,PFIZER/BIONTECH,23,23,0
Florânia,240380,RN,Nordeste,FIOCRUZ/ASTRAZENECA,2078,1951,127
Florânia,240380,RN,Nordeste,BUTANTAN/SINOVAC,2038,1030,1008
Florânia,240380,RN,Nordeste,PFIZER/BIONTECH,305,305,0
Floreal,351590,SP,Sudeste,BUTANTAN/SINOVAC,1251,717,534
Floreal,351590,SP,Sudeste,FIOCRUZ/ASTRAZENECA,1022,909,113
Floreal,351590,SP,Sudeste,PFIZER/BIONTECH,109,109,0
Flores,260560,PE,Nordeste,FIOCRUZ/ASTRAZENECA,7033,6337,696
Flores,260560,PE,Nordeste,BUTANTAN/SINOVAC,4592,2369,2223
Flores,260560,PE,Nordeste,PFIZER/BIONTECH,768,762,6
Flores Da Cunha,430820,RS,Sul,FIOCRUZ/ASTRAZENECA,7741,6669,1072
Flores Da Cunha,430820,RS,Sul,BUTANTAN/SINOVAC,6515,3305,3210
Flores Da Cunha,430820,RS,Sul,PFIZER/BIONTECH,532,531,1
Flores De Goiás,520790,GO,Centro-Oeste,FIOCRUZ/ASTRAZENECA,2173,2088,85
Flores De Goiás,520790,GO,Centro-Oeste,BUTANTAN/SINOVAC,1880,998,882
Flores De Goiás,520790,GO,Centro-Oeste,PFIZER/BIONTECH,25,25,0
Flores Do Piauí,220380,PI,Nordeste,BUTANTAN/SINOVAC,788,399,389
Flores Do Piauí,220380,PI,Nordeste,FIOCRUZ/ASTRAZENECA,668,604,64
Floresta,260570,PE,Nordeste,FIOCRUZ/ASTRAZENECA,6996,6649,347
Floresta,260570,PE,Nordeste,BUTANTAN/SINOVAC,5171,2687,2484
Floresta,260570,PE,Nordeste,PFIZER/BIONTECH,896,893,3
Floresta,410790,PR,Sul,FIOCRUZ/ASTRAZENECA,2180,2091,89
Floresta,410790,PR,Sul,BUTANTAN/SINOVAC,1429,736,693
Floresta,410790,PR,Sul,PFIZER/BIONTECH,6,6,0
Floresta Azul,291100,BA,Nordeste,BUTANTAN/SINOVAC,2658,1388,1270
Floresta Azul,291100,BA,Nordeste,FIOCRUZ/ASTRAZENECA,2495,2287,208
Floresta Azul,291100,BA,Nordeste,PFIZER/BIONTECH,189,189,0
Floresta Do Araguaia,150304,PA,Norte,FIOCRUZ/ASTRAZENECA,2741,1973,768
Floresta Do Araguaia,150304,PA,Norte,BUTANTAN/SINOVAC,1815,1066,749
Floresta Do Araguaia,150304,PA,Norte,PFIZER/BIONTECH,2,2,0
Floresta Do Piauí,220385,PI,Nordeste,BUTANTAN/SINOVAC,808,477,331
Floresta Do Piauí,220385,PI,Nordeste,FIOCRUZ/ASTRAZENECA,543,480,63
Florestal,312600,MG,Sudeste,FIOCRUZ/ASTRAZENECA,1629,1539,90
Florestal,312600,MG,Sudeste,BUTANTAN/SINOVAC,1507,905,602
Florestal,312600,MG,Sudeste,PFIZER/BIONTECH,179,179,0
Florestópolis,410800,PR,Sul,FIOCRUZ/ASTRAZENECA,2847,2698,149
Florestópolis,410800,PR,Sul,BUTANTAN/SINOVAC,1862,1005,857
Florestópolis,410800,PR,Sul,PFIZER/BIONTECH,31,31,0
Floriano,220390,PI,Nordeste,FIOCRUZ/ASTRAZENECA,14261,12087,2174
Floriano,220390,PI,Nordeste,BUTANTAN/SINOVAC,12419,6541,5878
Floriano,220390,PI,Nordeste,PFIZER/BIONTECH,954,954,0
Floriano Peixoto,430825,RS,Sul,BUTANTAN/SINOVAC,743,374,369
Floriano Peixoto,430825,RS,Sul,FIOCRUZ/ASTRAZENECA,516,447,69
Floriano Peixoto,430825,RS,Sul,PFIZER/BIONTECH,83,82,1
Florianópolis,420540,SC,Sul,BUTANTAN/SINOVAC,101148,53364,47784
Florianópolis,420540,SC,Sul,FIOCRUZ/ASTRAZENECA,45077,43205,1872
Florianópolis,420540,SC,Sul,PFIZER/BIONTECH,6771,6770,1
Flórida,410810,PR,Sul,FIOCRUZ/ASTRAZENECA,1001,941,60
Flórida,410810,PR,Sul,BUTANTAN/SINOVAC,783,408,375
Flórida,410810,PR,Sul,PFIZER/BIONTECH,6,6,0
Flórida Paulista,351600,SP,Sudeste,FIOCRUZ/ASTRAZENECA,3381,3113,268
Flórida Paulista,351600,SP,Sudeste,BUTANTAN/SINOVAC,3295,1780,1515
Flórida Paulista,351600,SP,Sudeste,PFIZER/BIONTECH,230,230,0
Florínea,351610,SP,Sudeste,BUTANTAN/SINOVAC,1214,746,468
Florínea,351610,SP,Sudeste,FIOCRUZ/ASTRAZENECA,806,745,61
Florínea,351610,SP,Sudeste,PFIZER/BIONTECH,116,116,0
Fonte Boa,130160,AM,Norte,BUTANTAN/SINOVAC,2287,1217,1070
Fonte Boa,130160,AM,Norte,FIOCRUZ/ASTRAZENECA,2011,1523,488
Fontoura Xavier,430830,RS,Sul,FIOCRUZ/ASTRAZENECA,3313,3040,273
Fontoura Xavier,430830,RS,Sul,BUTANTAN/SINOVAC,2124,1068,1056
Fontoura Xavier,430830,RS,Sul,PFIZER/BIONTECH,455,454,1
Formiga,312610,MG,Sudeste,BUTANTAN/SINOVAC,14271,7836,6435
Formiga,312610,MG,Sudeste,FIOCRUZ/ASTRAZENECA,13357,12681,676
Formiga,312610,MG,Sudeste,PFIZER/BIONTECH,1669,1669,0
Formigueiro,430840,RS,Sul,FIOCRUZ/ASTRAZENECA,3088,2771,317
Formigueiro,430840,RS,Sul,BUTANTAN/SINOVAC,2241,1114,1127
Formigueiro,430840,RS,Sul,PFIZER/BIONTECH,100,100,0
Formosa,520800,GO,Centro-Oeste,FIOCRUZ/ASTRAZENECA,26960,24445,2515
Formosa,520800,GO,Centro-Oeste,BUTANTAN/SINOVAC,13569,6925,6644
Formosa,520800,GO,Centro-Oeste,PFIZER/BIONTECH,1781,1781,0
Formosa Da Serra Negra,210409,MA,Nordeste,FIOCRUZ/ASTRAZENECA,3612,3438,174
Formosa Da Serra Negra,210409,MA,Nordeste,BUTANTAN/SINOVAC,2021,1050,971
Formosa Do Oeste,410820,PR,Sul,FIOCRUZ/ASTRAZENECA,2182,2003,179
Formosa Do Oeste,410820,PR,Sul,BUTANTAN/SINOVAC,2105,1081,1024
Formosa Do Oeste,410820,PR,Sul,PFIZER/BIONTECH,42,42,0
Formosa Do Rio Preto,291110,BA,Nordeste,BUTANTAN/SINOVAC,3443,1887,1556
Formosa Do Rio Preto,291110,BA,Nordeste,FIOCRUZ/ASTRAZENECA,3222,3019,203
Formosa Do Rio Preto,291110,BA,Nordeste,PFIZER/BIONTECH,362,362,0
Formosa Do Sul,420543,SC,Sul,BUTANTAN/SINOVAC,792,416,376
Formosa Do Sul,420543,SC,Sul,FIOCRUZ/ASTRAZENECA,764,686,78
Formosa Do Sul,420543,SC,Sul,PFIZER/BIONTECH,36,36,0
Formoso,312620,MG,Sudeste,FIOCRUZ/ASTRAZENECA,1831,1417,414
Formoso,312620,MG,Sudeste,BUTANTAN/SINOVAC,1310,680,630
Formoso,520810,GO,Centro-Oeste,FIOCRUZ/ASTRAZENECA,1548,1438,110
Formoso,520810,GO,Centro-Oeste,BUTANTAN/SINOVAC,883,464,419
Formoso Do Araguaia,170820,TO,Norte,BUTANTAN/SINOVAC,4029,2093,1936
Formoso Do Araguaia,170820,TO,Norte,FIOCRUZ/ASTRAZENECA,2008,1890,118
Forquetinha,430843,RS,Sul,BUTANTAN/SINOVAC,1046,522,524
Forquetinha,430843,RS,Sul,FIOCRUZ/ASTRAZENECA,703,605,98
Forquetinha,430843,RS,Sul,PFIZER/BIONTECH,49,49,0
Forquilha,230435,CE,Nordeste,BUTANTAN/SINOVAC,5989,3104,2885
Forquilha,230435,CE,Nordeste,FIOCRUZ/ASTRAZENECA,1648,1426,222
Forquilhinha,420545,SC,Sul,FIOCRUZ/ASTRAZENECA,5302,4953,349
Forquilhinha,420545,SC,Sul,BUTANTAN/SINOVAC,3609,1966,1643
Forquilhinha,420545,SC,Sul,PFIZER/BIONTECH,461,461,0
Fortaleza,230440,CE,Nordeste,BUTANTAN/SINOVAC,724891,389824,335067
Fortaleza,230440,CE,Nordeste,FIOCRUZ/ASTRAZENECA,654053,606426,47627
Fortaleza,230440,CE,Nordeste,PFIZER/BIONTECH,159185,159184,1
Fortaleza De Minas,312630,MG,Sudeste,FIOCRUZ/ASTRAZENECA,975,905,70
Fortaleza De Minas,312630,MG,Sudeste,BUTANTAN/SINOVAC,964,484,480
Fortaleza De Minas,312630,MG,Sudeste,PFIZER/BIONTECH,50,50,0
Fortaleza Do Tabocão,170825,TO,Norte,FIOCRUZ/ASTRAZENECA,521,488,33
Fortaleza Do Tabocão,170825,TO,Norte,BUTANTAN/SINOVAC,446,231,215
Fortaleza Dos Nogueiras,210410,MA,Nordeste,FIOCRUZ/ASTRAZENECA,2593,2474,119
Fortaleza Dos Nogueiras,210410,MA,Nordeste,BUTANTAN/SINOVAC,1910,1035,875
Fortaleza Dos Valos,430845,RS,Sul,BUTANTAN/SINOVAC,2579,1455,1124
Fortaleza Dos Valos,430845,RS,Sul,FIOCRUZ/ASTRAZENECA,1864,1668,196
Fortaleza Dos Valos,430845,RS,Sul,PFIZER/BIONTECH,151,151,0
Fortim,230445,CE,Nordeste,BUTANTAN/SINOVAC,630,279,351
Fortim,230445,CE,Nordeste,FIOCRUZ/ASTRAZENECA,583,477,106
Fortuna,210420,MA,Nordeste,FIOCRUZ/ASTRAZENECA,3875,3693,182
Fortuna,210420,MA,Nordeste,BUTANTAN/SINOVAC,2579,1380,1199
Fortuna De Minas,312640,MG,Sudeste,FIOCRUZ/ASTRAZENECA,1117,1042,75
Fortuna De Minas,312640,MG,Sudeste,BUTANTAN/SINOVAC,853,449,404
Fortuna De Minas,312640,MG,Sudeste,PFIZER/BIONTECH,56,56,0
Foz Do Iguaçu,410830,PR,Sul,FIOCRUZ/ASTRAZENECA,59864,55240,4624
Foz Do Iguaçu,410830,PR,Sul,BUTANTAN/SINOVAC,46965,25618,21347
Foz Do Iguaçu,410830,PR,Sul,PFIZER/BIONTECH,19010,19010,0
Foz Do Jordão,410845,PR,Sul,FIOCRUZ/ASTRAZENECA,1644,1573,71
Foz Do Jordão,410845,PR,Sul,BUTANTAN/SINOVAC,1126,611,515
Foz Do Jordão,410845,PR,Sul,PFIZER/BIONTECH,30,30,0
Fraiburgo,420550,SC,Sul,FIOCRUZ/ASTRAZENECA,9021,8549,472
Fraiburgo,420550,SC,Sul,BUTANTAN/SINOVAC,6551,3071,3480
Fraiburgo,420550,SC,Sul,PFIZER/BIONTECH,544,544,0
Franca,351620,SP,Sudeste,FIOCRUZ/ASTRAZENECA,80398,75947,4451
Franca,351620,SP,Sudeste,BUTANTAN/SINOVAC,72811,41684,31127
Franca,351620,SP,Sudeste,PFIZER/BIONTECH,7034,7020,14
Francinópolis,220400,PI,Nordeste,FIOCRUZ/ASTRAZENECA,1226,1164,62
Francinópolis,220400,PI,Nordeste,BUTANTAN/SINOVAC,1095,573,522
Francinópolis,220400,PI,Nordeste,PFIZER/BIONTECH,3,3,0
Francisco Alves,410832,PR,Sul,BUTANTAN/SINOVAC,1604,849,755
Francisco Alves,410832,PR,Sul,FIOCRUZ/ASTRAZENECA,1380,1297,83
Francisco Alves,410832,PR,Sul,PFIZER/BIONTECH,11,11,0
Francisco Ayres,220410,PI,Nordeste,FIOCRUZ/ASTRAZENECA,1209,1097,112
Francisco Ayres,220410,PI,Nordeste,BUTANTAN/SINOVAC,1169,600,569
Francisco Ayres,220410,PI,Nordeste,PFIZER/BIONTECH,63,63,0
Francisco Badaró,312650,MG,Sudeste,FIOCRUZ/ASTRAZENECA,2627,2440,187
Francisco Badaró,312650,MG,Sudeste,BUTANTAN/SINOVAC,2449,1270,1179
Francisco Badaró,312650,MG,Sudeste,PFIZER/BIONTECH,229,229,0
Francisco Beltrão,410840,PR,Sul,FIOCRUZ/ASTRAZENECA,22230,20504,1726
Francisco Beltrão,410840,PR,Sul,BUTANTAN/SINOVAC,18059,9389,8670
Francisco Beltrão,410840,PR,Sul,PFIZER/BIONTECH,4810,4810,0
Francisco Dantas,240390,RN,Nordeste,BUTANTAN/SINOVAC,709,364,345
Francisco Dantas,240390,RN,Nordeste,FIOCRUZ/ASTRAZENECA,594,558,36
Francisco Dantas,240390,RN,Nordeste,PFIZER/BIONTECH,96,96,0
Francisco Dumont,312660,MG,Sudeste,BUTANTAN/SINOVAC,1745,903,842
Francisco Dumont,312660,MG,Sudeste,FIOCRUZ/ASTRAZENECA,1388,1262,126
Francisco Dumont,312660,MG,Sudeste,PFIZER/BIONTECH,143,143,0
Francisco Macedo,220415,PI,Nordeste,BUTANTAN/SINOVAC,559,284,275
Francisco Macedo,220415,PI,Nordeste,FIOCRUZ/ASTRAZENECA,430,395,35
Francisco Macedo,220415,PI,Nordeste,PFIZER/BIONTECH,4,4,0
Francisco Morato,351630,SP,Sudeste,FIOCRUZ/ASTRAZENECA,33396,31681,1715
Francisco Morato,351630,SP,Sudeste,BUTANTAN/SINOVAC,22876,13732,9144
Francisco Morato,351630,SP,Sudeste,PFIZER/BIONTECH,1019,1016,3
Francisco Sá,312670,MG,Sudeste,BUTANTAN/SINOVAC,4427,2325,2102
Francisco Sá,312670,MG,Sudeste,FIOCRUZ/ASTRAZENECA,3928,3735,193
Francisco Santos,220420,PI,Nordeste,FIOCRUZ/ASTRAZENECA,1753,1592,161
Francisco Santos,220420,PI,Nordeste,BUTANTAN/SINOVAC,1460,764,696
Francisco Santos,220420,PI,Nordeste,PFIZER/BIONTECH,163,163,0
Franciscópolis,312675,MG,Sudeste,BUTANTAN/SINOVAC,1204,612,592
Franciscópolis,312675,MG,Sudeste,FIOCRUZ/ASTRAZENECA,1108,990,118
Franciscópolis,312675,MG,Sudeste,PFIZER/BIONTECH,84,84,0
Franco Da Rocha,351640,SP,Sudeste,FIOCRUZ/ASTRAZENECA,32540,30147,2393
Franco Da Rocha,351640,SP,Sudeste,BUTANTAN/SINOVAC,31878,18467,13411
Franco Da Rocha,351640,SP,Sudeste,PFIZER/BIONTECH,4000,3997,3
Frecheirinha,230450,CE,Nordeste,BUTANTAN/SINOVAC,2513,1282,1231
Frecheirinha,230450,CE,Nordeste,FIOCRUZ/ASTRAZENECA,1822,1601,221
Frederico Westphalen,430850,RS,Sul,BUTANTAN/SINOVAC,9681,4911,4770
Frederico Westphalen,430850,RS,Sul,FIOCRUZ/ASTRAZENECA,7734,7135,599
Frederico Westphalen,430850,RS,Sul,PFIZER/BIONTECH,875,874,1
Frei Gaspar,312680,MG,Sudeste,BUTANTAN/SINOVAC,1167,614,553
Frei Gaspar,312680,MG,Sudeste,FIOCRUZ/ASTRAZENECA,846,739,107
Frei Gaspar,312680,MG,Sudeste,PFIZER/BIONTECH,57,57,0
Frei Inocêncio,312690,MG,Sudeste,BUTANTAN/SINOVAC,2034,1072,962
Frei Inocêncio,312690,MG,Sudeste,FIOCRUZ/ASTRAZENECA,1982,1700,282
Frei Inocêncio,312690,MG,Sudeste,PFIZER/BIONTECH,126,126,0
Frei Lagonegro,312695,MG,Sudeste,FIOCRUZ/ASTRAZENECA,776,733,43
Frei Lagonegro,312695,MG,Sudeste,BUTANTAN/SINOVAC,589,339,250
Frei Lagonegro,312695,MG,Sudeste,PFIZER/BIONTECH,22,22,0
Frei Martinho,250620,PB,Nordeste,BUTANTAN/SINOVAC,1060,537,523
Frei Martinho,250620,PB,Nordeste,FIOCRUZ/ASTRAZENECA,801,697,104
Frei Martinho,250620,PB,Nordeste,PFIZER/BIONTECH,66,66,0
Frei Miguelinho,260580,PE,Nordeste,BUTANTAN/SINOVAC,3026,1646,1380
Frei Miguelinho,260580,PE,Nordeste,FIOCRUZ/ASTRAZENECA,2678,2348,330
Frei Miguelinho,260580,PE,Nordeste,PFIZER/BIONTECH,248,248,0
Frei Paulo,280230,SE,Nordeste,BUTANTAN/SINOVAC,2701,1568,1133
Frei Paulo,280230,SE,Nordeste,FIOCRUZ/ASTRAZENECA,2618,2616,2
Frei Paulo,280230,SE,Nordeste,PFIZER/BIONTECH,273,273,0
Frei Rogério,420555,SC,Sul,FIOCRUZ/ASTRAZENECA,689,603,86
Frei Rogério,420555,SC,Sul,BUTANTAN/SINOVAC,547,297,250
Frei Rogério,420555,SC,Sul,PFIZER/BIONTECH,80,80,0
Fronteira,312700,MG,Sudeste,FIOCRUZ/ASTRAZENECA,3130,2890,240
Fronteira,312700,MG,Sudeste,BUTANTAN/SINOVAC,2609,1347,1262
Fronteira,312700,MG,Sudeste,PFIZER/BIONTECH,136,136,0
Fronteira Dos Vales,312705,MG,Sudeste,BUTANTAN/SINOVAC,1124,605,519
Fronteira Dos Vales,312705,MG,Sudeste,FIOCRUZ/ASTRAZENECA,759,723,36
Fronteiras,220430,PI,Nordeste,FIOCRUZ/ASTRAZENECA,2582,2376,206
Fronteiras,220430,PI,Nordeste,BUTANTAN/SINOVAC,2078,1048,1030
Fronteiras,220430,PI,Nordeste,PFIZER/BIONTECH,100,100,0
Fruta De Leite,312707,MG,Sudeste,BUTANTAN/SINOVAC,1379,715,664
Fruta De Leite,312707,MG,Sudeste,FIOCRUZ/ASTRAZENECA,1204,1096,108
Fruta De Leite,312707,MG,Sudeste,PFIZER/BIONTECH,95,95,0
Frutal,312710,MG,Sudeste,BUTANTAN/SINOVAC,10557,5596,4961
Frutal,312710,MG,Sudeste,FIOCRUZ/ASTRAZENECA,8901,8094,807
Frutal,312710,MG,Sudeste,PFIZER/BIONTECH,583,583,0
Frutuoso Gomes,240400,RN,Nordeste,BUTANTAN/SINOVAC,1048,529,519
Frutuoso Gomes,240400,RN,Nordeste,FIOCRUZ/ASTRAZENECA,793,735,58
Frutuoso Gomes,240400,RN,Nordeste,PFIZER/BIONTECH,72,72,0
Fundão,320220,ES,Sudeste,BUTANTAN/SINOVAC,5486,2929,2557
Fundão,320220,ES,Sudeste,FIOCRUZ/ASTRAZENECA,3848,3683,165
Fundão,320220,ES,Sudeste,PFIZER/BIONTECH,526,526,0
Funilândia,312720,MG,Sudeste,BUTANTAN/SINOVAC,1029,536,493
Funilândia,312720,MG,Sudeste,FIOCRUZ/ASTRAZENECA,1020,921,99
Funilândia,312720,MG,Sudeste,PFIZER/BIONTECH,158,158,0
Gabriel Monteiro,351650,SP,Sudeste,BUTANTAN/SINOVAC,908,483,425
Gabriel Monteiro,351650,SP,Sudeste,FIOCRUZ/ASTRAZENECA,870,791,79
Gabriel Monteiro,351650,SP,Sudeste,PFIZER/BIONTECH,145,145,0
Gado Bravo,250625,PB,Nordeste,BUTANTAN/SINOVAC,2479,1437,1042
Gado Bravo,250625,PB,Nordeste,FIOCRUZ/ASTRAZENECA,1254,1174,80
Gado Bravo,250625,PB,Nordeste,PFIZER/BIONTECH,22,22,0
Gália,351660,SP,Sudeste,BUTANTAN/SINOVAC,2183,1134,1049
Gália,351660,SP,Sudeste,FIOCRUZ/ASTRAZENECA,2041,1813,228
Gália,351660,SP,Sudeste,PFIZER/BIONTECH,148,148,0
Galiléia,312730,MG,Sudeste,BUTANTAN/SINOVAC,1290,712,578
Galiléia,312730,MG,Sudeste,FIOCRUZ/ASTRAZENECA,682,598,84
Galiléia,312730,MG,Sudeste,PFIZER/BIONTECH,15,15,0
Galinhos,240410,RN,Nordeste,BUTANTAN/SINOVAC,508,259,249
Galinhos,240410,RN,Nordeste,FIOCRUZ/ASTRAZENECA,317,307,10
Galinhos,240410,RN,Nordeste,PFIZER/BIONTECH,41,41,0
Galvão,420560,SC,Sul,FIOCRUZ/ASTRAZENECA,948,842,106
Galvão,420560,SC,Sul,BUTANTAN/SINOVAC,793,408,385
Galvão,420560,SC,Sul,PFIZER/BIONTECH,72,72,0
Gameleira,260590,PE,Nordeste,FIOCRUZ/ASTRAZENECA,3289,2966,323
Gameleira,260590,PE,Nordeste,BUTANTAN/SINOVAC,2854,1635,1219
Gameleira,260590,PE,Nordeste,PFIZER/BIONTECH,103,103,0
Gameleira De Goiás,520815,GO,Centro-Oeste,FIOCRUZ/ASTRAZENECA,861,842,19
Gameleira De Goiás,520815,GO,Centro-Oeste,BUTANTAN/SINOVAC,673,397,276
Gameleira De Goiás,520815,GO,Centro-Oeste,PFIZER/BIONTECH,33,33,0
Gameleiras,312733,MG,Sudeste,BUTANTAN/SINOVAC,927,554,373
Gameleiras,312733,MG,Sudeste,FIOCRUZ/ASTRAZENECA,626,582,44
Gandu,291120,BA,Nordeste,BUTANTAN/SINOVAC,5204,2715,2489
Gandu,291120,BA,Nordeste,FIOCRUZ/ASTRAZENECA,5011,4599,412
Gandu,291120,BA,Nordeste,PFIZER/BIONTECH,195,145,50
Garanhuns,260600,PE,Nordeste,FIOCRUZ/ASTRAZENECA,33561,31016,2545
Garanhuns,260600,PE,Nordeste,BUTANTAN/SINOVAC,25572,13005,12567
Garanhuns,260600,PE,Nordeste,PFIZER/BIONTECH,3288,3287,1
Gararu,280240,SE,Nordeste,BUTANTAN/SINOVAC,2408,1198,1210
Gararu,280240,SE,Nordeste,FIOCRUZ/ASTRAZENECA,1725,1722,3
Gararu,280240,SE,Nordeste,PFIZER/BIONTECH,265,265,0
Garça,351670,SP,Sudeste,BUTANTAN/SINOVAC,10953,6091,4862
Garça,351670,SP,Sudeste,FIOCRUZ/ASTRAZENECA,9634,8575,1059
Garça,351670,SP,Sudeste,PFIZER/BIONTECH,852,850,2
Garibaldi,430860,RS,Sul,FIOCRUZ/ASTRAZENECA,8776,8141,635
Garibaldi,430860,RS,Sul,BUTANTAN/SINOVAC,8232,4133,4099
Garibaldi,430860,RS,Sul,PFIZER/BIONTECH,1221,1220,1
Garopaba,420570,SC,Sul,FIOCRUZ/ASTRAZENECA,7576,7126,450
Garopaba,420570,SC,Sul,BUTANTAN/SINOVAC,4567,2332,2235
Garopaba,420570,SC,Sul,PFIZER/BIONTECH,61,61,0
Garrafão Do Norte,150307,PA,Norte,BUTANTAN/SINOVAC,4176,2220,1956
Garrafão Do Norte,150307,PA,Norte,FIOCRUZ/ASTRAZENECA,3935,3570,365
Garruchos,430865,RS,Sul,FIOCRUZ/ASTRAZENECA,870,773,97
Garruchos,430865,RS,Sul,BUTANTAN/SINOVAC,845,417,428
Garruchos,430865,RS,Sul,PFIZER/BIONTECH,126,126,0
Garuva,420580,SC,Sul,FIOCRUZ/ASTRAZENECA,4070,3698,372
Garuva,420580,SC,Sul,BUTANTAN/SINOVAC,2235,1247,988
Garuva,420580,SC,Sul,PFIZER/BIONTECH,382,382,0
Gaspar,420590,SC,Sul,FIOCRUZ/ASTRAZENECA,11947,11636,311
Gaspar,420590,SC,Sul,BUTANTAN/SINOVAC,10893,5970,4923
Gaspar,420590,SC,Sul,PFIZER/BIONTECH,1568,1568,0
Gastão Vidigal,351680,SP,Sudeste,BUTANTAN/SINOVAC,959,503,456
Gastão Vidigal,351680,SP,Sudeste,FIOCRUZ/ASTRAZENECA,886,819,67
Gastão Vidigal,351680,SP,Sudeste,PFIZER/BIONTECH,111,111,0
Gaúcha Do Norte,510385,MT,Centro-Oeste,BUTANTAN/SINOVAC,3519,2054,1465
Gaúcha Do Norte,510385,MT,Centro-Oeste,FIOCRUZ/ASTRAZENECA,1160,863,297
Gaúcha Do Norte,510385,MT,Centro-Oeste,PFIZER/BIONTECH,138,138,0
Gaurama,430870,RS,Sul,BUTANTAN/SINOVAC,2142,1090,1052
Gaurama,430870,RS,Sul,FIOCRUZ/ASTRAZENECA,1663,1415,248
Gaurama,430870,RS,Sul,PFIZER/BIONTECH,245,245,0
Gavião,291125,BA,Nordeste,BUTANTAN/SINOVAC,1257,649,608
Gavião,291125,BA,Nordeste,FIOCRUZ/ASTRAZENECA,1194,975,219
Gavião,291125,BA,Nordeste,PFIZER/BIONTECH,125,123,2
Gavião Peixoto,351685,SP,Sudeste,BUTANTAN/SINOVAC,1171,664,507
Gavião Peixoto,351685,SP,Sudeste,FIOCRUZ/ASTRAZENECA,1012,931,81
Gavião Peixoto,351685,SP,Sudeste,PFIZER/BIONTECH,172,171,1
Geminiano,220435,PI,Nordeste,FIOCRUZ/ASTRAZENECA,1051,975,76
Geminiano,220435,PI,Nordeste,BUTANTAN/SINOVAC,866,456,410
General Câmara,430880,RS,Sul,BUTANTAN/SINOVAC,2690,1373,1317
General Câmara,430880,RS,Sul,FIOCRUZ/ASTRAZENECA,1897,1686,211
General Câmara,430880,RS,Sul,PFIZER/BIONTECH,153,153,0
General Carneiro,410850,PR,Sul,FIOCRUZ/ASTRAZENECA,2639,2527,112
General Carneiro,410850,PR,Sul,BUTANTAN/SINOVAC,2029,1041,988
General Carneiro,410850,PR,Sul,PFIZER/BIONTECH,156,156,0
General Carneiro,510390,MT,Centro-Oeste,BUTANTAN/SINOVAC,3121,1600,1521
General Carneiro,510390,MT,Centro-Oeste,FIOCRUZ/ASTRAZENECA,1258,1138,120
General Carneiro,510390,MT,Centro-Oeste,PFIZER/BIONTECH,163,163,0
General Maynard,280250,SE,Nordeste,BUTANTAN/SINOVAC,713,360,353
General Maynard,280250,SE,Nordeste,FIOCRUZ/ASTRAZENECA,605,576,29
General Maynard,280250,SE,Nordeste,PFIZER/BIONTECH,83,83,0
General Salgado,351690,SP,Sudeste,BUTANTAN/SINOVAC,3395,1844,1551
General Salgado,351690,SP,Sudeste,FIOCRUZ/ASTRAZENECA,2970,2684,286
General Salgado,351690,SP,Sudeste,PFIZER/BIONTECH,245,245,0
General Sampaio,230460,CE,Nordeste,BUTANTAN/SINOVAC,1296,656,640
General Sampaio,230460,CE,Nordeste,FIOCRUZ/ASTRAZENECA,593,461,132
Gentil,430885,RS,Sul,BUTANTAN/SINOVAC,537,274,263
Gentil,430885,RS,Sul,FIOCRUZ/ASTRAZENECA,432,404,28
Gentil,430885,RS,Sul,PFIZER/BIONTECH,74,74,0
Gentio Do Ouro,291130,BA,Nordeste,FIOCRUZ/ASTRAZENECA,2964,2619,345
Gentio Do Ouro,291130,BA,Nordeste,BUTANTAN/SINOVAC,2510,1298,1212
Gentio Do Ouro,291130,BA,Nordeste,PFIZER/BIONTECH,68,68,0
Getulina,351700,SP,Sudeste,BUTANTAN/SINOVAC,2627,1430,1197
Getulina,351700,SP,Sudeste,FIOCRUZ/ASTRAZENECA,2314,2173,141
Getulina,351700,SP,Sudeste,PFIZER/BIONTECH,161,161,0
Getúlio Vargas,430890,RS,Sul,BUTANTAN/SINOVAC,5174,2596,2578
Getúlio Vargas,430890,RS,Sul,FIOCRUZ/ASTRAZENECA,4875,4304,571
Getúlio Vargas,430890,RS,Sul,PFIZER/BIONTECH,617,617,0
Gilbués,220440,PI,Nordeste,BUTANTAN/SINOVAC,1622,860,762
Gilbués,220440,PI,Nordeste,FIOCRUZ/ASTRAZENECA,1132,1074,58
Girau Do Ponciano,270290,AL,Nordeste,FIOCRUZ/ASTRAZENECA,7470,6946,524
Girau Do Ponciano,270290,AL,Nordeste,BUTANTAN/SINOVAC,6330,3326,3004
Giruá,430900,RS,Sul,BUTANTAN/SINOVAC,4622,2317,2305
Giruá,430900,RS,Sul,FIOCRUZ/ASTRAZENECA,4381,3969,412
Giruá,430900,RS,Sul,PFIZER/BIONTECH,639,639,0
Glaucilândia,312735,MG,Sudeste,BUTANTAN/SINOVAC,1177,674,503
Glaucilândia,312735,MG,Sudeste,FIOCRUZ/ASTRAZENECA,705,632,73
Glaucilândia,312735,MG,Sudeste,PFIZER/BIONTECH,42,42,0
Glicério,351710,SP,Sudeste,FIOCRUZ/ASTRAZENECA,1033,950,83
Glicério,351710,SP,Sudeste,BUTANTAN/SINOVAC,1008,522,486
Glicério,351710,SP,Sudeste,PFIZER/BIONTECH,61,60,1
Glória,291140,BA,Nordeste,BUTANTAN/SINOVAC,4535,2306,2229
Glória,291140,BA,Nordeste,FIOCRUZ/ASTRAZENECA,3267,2941,326
Glória,291140,BA,Nordeste,PFIZER/BIONTECH,194,194,0
Glória D'Oeste,510395,MT,Centro-Oeste,BUTANTAN/SINOVAC,1116,598,518
Glória D'Oeste,510395,MT,Centro-Oeste,FIOCRUZ/ASTRAZENECA,1081,986,95
Glória D'Oeste,510395,MT,Centro-Oeste,PFIZER/BIONTECH,9,9,0
Glória De Dourados,500400,MS,Centro-Oeste,FIOCRUZ/ASTRAZENECA,2990,2396,594
Glória De Dourados,500400,MS,Centro-Oeste,BUTANTAN/SINOVAC,2758,1427,1331
Glória De Dourados,500400,MS,Centro-Oeste,PFIZER/BIONTECH,480,480,0
Glória Do Goitá,260610,PE,Nordeste,FIOCRUZ/ASTRAZENECA,6406,5855,551
Glória Do Goitá,260610,PE,Nordeste,BUTANTAN/SINOVAC,4977,2545,2432
Glória Do Goitá,260610,PE,Nordeste,PFIZER/BIONTECH,886,886,0
Glorinha,430905,RS,Sul,BUTANTAN/SINOVAC,2244,1162,1082
Glorinha,430905,RS,Sul,FIOCRUZ/ASTRAZENECA,1701,1632,69
Glorinha,430905,RS,Sul,PFIZER/BIONTECH,84,84,0
Godofredo Viana,210430,MA,Nordeste,FIOCRUZ/ASTRAZENECA,1345,1288,57
Godofredo Viana,210430,MA,Nordeste,BUTANTAN/SINOVAC,1046,564,482
Godoy Moreira,410855,PR,Sul,FIOCRUZ/ASTRAZENECA,958,892,66
Godoy Moreira,410855,PR,Sul,BUTANTAN/SINOVAC,938,492,446
Godoy Moreira,410855,PR,Sul,PFIZER/BIONTECH,17,17,0
Goiabeira,312737,MG,Sudeste,BUTANTAN/SINOVAC,829,417,412
Goiabeira,312737,MG,Sudeste,FIOCRUZ/ASTRAZENECA,767,695,72
Goiabeira,312737,MG,Sudeste,PFIZER/BIONTECH,60,60,0
Goiana,260620,PE,Nordeste,FIOCRUZ/ASTRAZENECA,14148,13181,967
Goiana,260620,PE,Nordeste,BUTANTAN/SINOVAC,11846,6227,5619
Goiana,260620,PE,Nordeste,PFIZER/BIONTECH,621,621,0
Goianá,312738,MG,Sudeste,BUTANTAN/SINOVAC,997,507,490
Goianá,312738,MG,Sudeste,FIOCRUZ/ASTRAZENECA,762,741,21
Goianápolis,520840,GO,Centro-Oeste,FIOCRUZ/ASTRAZENECA,2696,2563,133
Goianápolis,520840,GO,Centro-Oeste,BUTANTAN/SINOVAC,1806,948,858
Goianápolis,520840,GO,Centro-Oeste,PFIZER/BIONTECH,18,18,0
Goiandira,520850,GO,Centro-Oeste,FIOCRUZ/ASTRAZENECA,1856,1717,139
Goiandira,520850,GO,Centro-Oeste,BUTANTAN/SINOVAC,1115,572,543
Goianésia,520860,GO,Centro-Oeste,FIOCRUZ/ASTRAZENECA,23244,21773,1471
Goianésia,520860,GO,Centro-Oeste,BUTANTAN/SINOVAC,10122,5526,4596
Goianésia,520860,GO,Centro-Oeste,PFIZER/BIONTECH,590,590,0
Goianésia Do Pará,150309,PA,Norte,FIOCRUZ/ASTRAZENECA,4568,4059,509
Goianésia Do Pará,150309,PA,Norte,BUTANTAN/SINOVAC,1042,600,442
Goiânia,520870,GO,Centro-Oeste,BUTANTAN/SINOVAC,350028,178782,171246
Goiânia,520870,GO,Centro-Oeste,FIOCRUZ/ASTRAZENECA,227477,196687,30790
Goiânia,520870,GO,Centro-Oeste,PFIZER/BIONTECH,124912,124839,73
Goianinha,240420,RN,Nordeste,FIOCRUZ/ASTRAZENECA,5261,4597,664
Goianinha,240420,RN,Nordeste,BUTANTAN/SINOVAC,4014,2114,1900
Goianinha,240420,RN,Nordeste,PFIZER/BIONTECH,1151,1149,2
Goianira,520880,GO,Centro-Oeste,FIOCRUZ/ASTRAZENECA,8527,7934,593
Goianira,520880,GO,Centro-Oeste,BUTANTAN/SINOVAC,6455,3642,2813
Goianira,520880,GO,Centro-Oeste,PFIZER/BIONTECH,1087,1086,1
Goianorte,170830,TO,Norte,BUTANTAN/SINOVAC,959,484,475
Goianorte,170830,TO,Norte,FIOCRUZ/ASTRAZENECA,915,874,41
Goiás,520890,GO,Centro-Oeste,FIOCRUZ/ASTRAZENECA,7089,6601,488
Goiás,520890,GO,Centro-Oeste,BUTANTAN/SINOVAC,5190,2687,2503
Goiás,520890,GO,Centro-Oeste,PFIZER/BIONTECH,672,672,0
Goiatins,170900,TO,Norte,BUTANTAN/SINOVAC,3841,2069,1772
Goiatins,170900,TO,Norte,FIOCRUZ/ASTRAZENECA,734,649,85
Goiatuba,520910,GO,Centro-Oeste,FIOCRUZ/ASTRAZENECA,10396,9688,708
Goiatuba,520910,GO,Centro-Oeste,BUTANTAN/SINOVAC,7280,3706,3574
Goiatuba,520910,GO,Centro-Oeste,PFIZER/BIONTECH,467,467,0
Goioerê,410860,PR,Sul,FIOCRUZ/ASTRAZENECA,7418,7001,417
Goioerê,410860,PR,Sul,BUTANTAN/SINOVAC,6457,3392,3065
Goioerê,410860,PR,Sul,PFIZER/BIONTECH,801,801,0
Goioxim,410865,PR,Sul,FIOCRUZ/ASTRAZENECA,1736,1661,75
Goioxim,410865,PR,Sul,BUTANTAN/SINOVAC,1273,658,615
Goioxim,410865,PR,Sul,PFIZER/BIONTECH,15,15,0
Gonçalves,312740,MG,Sudeste,BUTANTAN/SINOVAC,1020,516,504
Gonçalves,312740,MG,Sudeste,FIOCRUZ/ASTRAZENECA,996,945,51
Gonçalves,312740,MG,Sudeste,PFIZER/BIONTECH,30,30,0
Gonçalves Dias,210440,MA,Nordeste,FIOCRUZ/ASTRAZENECA,4496,4069,427
Gonçalves Dias,210440,MA,Nordeste,BUTANTAN/SINOVAC,2841,1520,1321
Gongogi,291150,BA,Nordeste,BUTANTAN/SINOVAC,268,156,112
Gongogi,291150,BA,Nordeste,FIOCRUZ/ASTRAZENECA,100,98,2
Gongogi,291150,BA,Nordeste,PFIZER/BIONTECH,2,2,0
Gonzaga,312750,MG,Sudeste,BUTANTAN/SINOVAC,1094,565,529
Gonzaga,312750,MG,Sudeste,FIOCRUZ/ASTRAZENECA,773,731,42
Gouveia,312760,MG,Sudeste,FIOCRUZ/ASTRAZENECA,2743,2541,202
Gouveia,312760,MG,Sudeste,BUTANTAN/SINOVAC,2583,1335,1248
Gouveia,312760,MG,Sudeste,PFIZER/BIONTECH,286,286,0
Gouvelândia,520915,GO,Centro-Oeste,FIOCRUZ/ASTRAZENECA,1455,1374,81
Gouvelândia,520915,GO,Centro-Oeste,BUTANTAN/SINOVAC,1020,514,506
Gouvelândia,520915,GO,Centro-Oeste,PFIZER/BIONTECH,2,2,0
Governador Archer,210450,MA,Nordeste,FIOCRUZ/ASTRAZENECA,2871,2704,167
Governador Archer,210450,MA,Nordeste,BUTANTAN/SINOVAC,1962,1082,880
Governador Celso Ramos,420600,SC,Sul,FIOCRUZ/ASTRAZENECA,4330,4142,188
Governador Celso Ramos,420600,SC,Sul,BUTANTAN/SINOVAC,2372,1242,1130
Governador Celso Ramos,420600,SC,Sul,PFIZER/BIONTECH,210,209,1
Governador Dix-Sept Rosado,240430,RN,Nordeste,BUTANTAN/SINOVAC,2417,1234,1183
Governador Dix-Sept Rosado,240430,RN,Nordeste,FIOCRUZ/ASTRAZENECA,2049,1975,74
Governador Dix-Sept Rosado,240430,RN,Nordeste,PFIZER/BIONTECH,281,280,1
Governador Edison Lobão,210455,MA,Nordeste,FIOCRUZ/ASTRAZENECA,2559,2380,179
Governador Edison Lobão,210455,MA,Nordeste,BUTANTAN/SINOVAC,2195,1210,985
Governador Eugênio Barros,210460,MA,Nordeste,FIOCRUZ/ASTRAZENECA,3552,2777,775
Governador Eugênio Barros,210460,MA,Nordeste,BUTANTAN/SINOVAC,3161,1635,1526
Governador Jorge Teixeira,110100,RO,Norte,FIOCRUZ/ASTRAZENECA,2147,2083,64
Governador Jorge Teixeira,110100,RO,Norte,BUTANTAN/SINOVAC,1693,868,825
Governador Jorge Teixeira,110100,RO,Norte,PFIZER/BIONTECH,217,216,1
Governador Lindenberg,320225,ES,Sudeste,BUTANTAN/SINOVAC,3241,1804,1437
Governador Lindenberg,320225,ES,Sudeste,FIOCRUZ/ASTRAZENECA,2662,2553,109
Governador Lindenberg,320225,ES,Sudeste,PFIZER/BIONTECH,373,373,0
Governador Luiz Rocha,210462,MA,Nordeste,FIOCRUZ/ASTRAZENECA,1948,1826,122
Governador Luiz Rocha,210462,MA,Nordeste,BUTANTAN/SINOVAC,1376,738,638
Governador Mangabeira,291160,BA,Nordeste,BUTANTAN/SINOVAC,5348,2767,2581
Governador Mangabeira,291160,BA,Nordeste,FIOCRUZ/ASTRAZENECA,5205,4617,588
Governador Mangabeira,291160,BA,Nordeste,PFIZER/BIONTECH,565,565,0
Governador Newton Bello,210465,MA,Nordeste,FIOCRUZ/ASTRAZENECA,1415,1311,104
Governador Newton Bello,210465,MA,Nordeste,BUTANTAN/SINOVAC,1275,689,586
Governador Nunes Freire,210467,MA,Nordeste,FIOCRUZ/ASTRAZENECA,4991,4679,312
Governador Nunes Freire,210467,MA,Nordeste,BUTANTAN/SINOVAC,3154,1827,1327
Governador Valadares,312770,MG,Sudeste,BUTANTAN/SINOVAC,57617,31917,25700
Governador Valadares,312770,MG,Sudeste,FIOCRUZ/ASTRAZENECA,30186,27479,2707
Governador Valadares,312770,MG,Sudeste,PFIZER/BIONTECH,1249,1248,1
Graça,230465,CE,Nordeste,BUTANTAN/SINOVAC,2248,1375,873
Graça,230465,CE,Nordeste,FIOCRUZ/ASTRAZENECA,1291,1120,171
Graça Aranha,210470,MA,Nordeste,FIOCRUZ/ASTRAZENECA,1190,1138,52
Graça Aranha,210470,MA,Nordeste,BUTANTAN/SINOVAC,1046,547,499
Gracho Cardoso,280260,SE,Nordeste,BUTANTAN/SINOVAC,1219,667,552
Gracho Cardoso,280260,SE,Nordeste,FIOCRUZ/ASTRAZENECA,888,888,0
Gracho Cardoso,280260,SE,Nordeste,PFIZER/BIONTECH,12,12,0
Grajaú,210480,MA,Nordeste,FIOCRUZ/ASTRAZENECA,13281,12505,776
Grajaú,210480,MA,Nordeste,BUTANTAN/SINOVAC,13091,6984,6107
Gramado,430910,RS,Sul,FIOCRUZ/ASTRAZENECA,9794,8238,1556
Gramado,430910,RS,Sul,BUTANTAN/SINOVAC,8102,4047,4055
Gramado,430910,RS,Sul,PFIZER/BIONTECH,1160,1157,3
Gramado Dos Loureiros,430912,RS,Sul,BUTANTAN/SINOVAC,1250,641,609
Gramado Dos Loureiros,430912,RS,Sul,FIOCRUZ/ASTRAZENECA,749,694,55
Gramado Dos Loureiros,430912,RS,Sul,PFIZER/BIONTECH,47,47,0
Gramado Xavier,430915,RS,Sul,BUTANTAN/SINOVAC,645,337,308
Gramado Xavier,430915,RS,Sul,FIOCRUZ/ASTRAZENECA,451,421,30
Gramado Xavier,430915,RS,Sul,PFIZER/BIONTECH,52,52,0
Grandes Rios,410870,PR,Sul,FIOCRUZ/ASTRAZENECA,1666,1580,86
Grandes Rios,410870,PR,Sul,BUTANTAN/SINOVAC,1343,716,627
Grandes Rios,410870,PR,Sul,PFIZER/BIONTECH,26,26,0
Granito,260630,PE,Nordeste,BUTANTAN/SINOVAC,1796,933,863
Granito,260630,PE,Nordeste,FIOCRUZ/ASTRAZENECA,1396,1286,110
Granito,260630,PE,Nordeste,PFIZER/BIONTECH,120,120,0
Granja,230470,CE,Nordeste,BUTANTAN/SINOVAC,7594,3979,3615
Granja,230470,CE,Nordeste,FIOCRUZ/ASTRAZENECA,4025,3379,646
Granjeiro,230480,CE,Nordeste,BUTANTAN/SINOVAC,104,104,0
Granjeiro,230480,CE,Nordeste,FIOCRUZ/ASTRAZENECA,87,87,0
Grão Mogol,312780,MG,Sudeste,FIOCRUZ/ASTRAZENECA,2668,2433,235
Grão Mogol,312780,MG,Sudeste,BUTANTAN/SINOVAC,2485,1251,1234
Grão Mogol,312780,MG,Sudeste,PFIZER/BIONTECH,155,155,0
Grão Pará,420610,SC,Sul,FIOCRUZ/ASTRAZENECA,1923,1788,135
Grão Pará,420610,SC,Sul,BUTANTAN/SINOVAC,1320,740,580
Grão Pará,420610,SC,Sul,PFIZER/BIONTECH,89,89,0
Gravatá,260640,PE,Nordeste,FIOCRUZ/ASTRAZENECA,14890,13604,1286
Gravatá,260640,PE,Nordeste,BUTANTAN/SINOVAC,12947,6562,6385
Gravatá,260640,PE,Nordeste,PFIZER/BIONTECH,596,596,0
Gravataí,430920,RS,Sul,BUTANTAN/SINOVAC,71323,37187,34136
Gravataí,430920,RS,Sul,FIOCRUZ/ASTRAZENECA,63025,60560,2465
Gravataí,430920,RS,Sul,PFIZER/BIONTECH,9102,9092,10
Gravatal,420620,SC,Sul,FIOCRUZ/ASTRAZENECA,3241,2861,380
Gravatal,420620,SC,Sul,BUTANTAN/SINOVAC,2210,1263,947
Gravatal,420620,SC,Sul,PFIZER/BIONTECH,341,341,0
Groaíras,230490,CE,Nordeste,BUTANTAN/SINOVAC,2453,1261,1192
Groaíras,230490,CE,Nordeste,FIOCRUZ/ASTRAZENECA,1357,1141,216
Grossos,240440,RN,Nordeste,FIOCRUZ/ASTRAZENECA,1962,1882,80
Grossos,240440,RN,Nordeste,BUTANTAN/SINOVAC,1927,979,948
Grossos,240440,RN,Nordeste,PFIZER/BIONTECH,264,263,1
Grupiara,312790,MG,Sudeste,FIOCRUZ/ASTRAZENECA,546,494,52
Grupiara,312790,MG,Sudeste,BUTANTAN/SINOVAC,441,213,228
Grupiara,312790,MG,Sudeste,PFIZER/BIONTECH,48,48,0
Guabiju,430925,RS,Sul,BUTANTAN/SINOVAC,899,531,368
Guabiju,430925,RS,Sul,FIOCRUZ/ASTRAZENECA,712,610,102
Guabiju,430925,RS,Sul,PFIZER/BIONTECH,71,71,0
Guabiruba,420630,SC,Sul,BUTANTAN/SINOVAC,4235,1983,2252
Guabiruba,420630,SC,Sul,FIOCRUZ/ASTRAZENECA,4210,4124,86
Guabiruba,420630,SC,Sul,PFIZER/BIONTECH,491,490,1
Guaçuí,320230,ES,Sudeste,BUTANTAN/SINOVAC,8390,4276,4114
Guaçuí,320230,ES,Sudeste,FIOCRUZ/ASTRAZENECA,6175,5805,370
Guaçuí,320230,ES,Sudeste,PFIZER/BIONTECH,1541,1541,0
Guadalupe,220450,PI,Nordeste,FIOCRUZ/ASTRAZENECA,1738,1574,164
Guadalupe,220450,PI,Nordeste,BUTANTAN/SINOVAC,1599,878,721
Guadalupe,220450,PI,Nordeste,PFIZER/BIONTECH,127,127,0
Guaíba,430930,RS,Sul,FIOCRUZ/ASTRAZENECA,22701,21567,1134
Guaíba,430930,RS,Sul,BUTANTAN/SINOVAC,20911,10862,10049
Guaíba,430930,RS,Sul,PFIZER/BIONTECH,2674,2673,1
Guaiçara,351720,SP,Sudeste,BUTANTAN/SINOVAC,2562,1484,1078
Guaiçara,351720,SP,Sudeste,FIOCRUZ/ASTRAZENECA,2548,2392,156
Guaiçara,351720,SP,Sudeste,PFIZER/BIONTECH,282,282,0
Guaimbê,351730,SP,Sudeste,BUTANTAN/SINOVAC,1459,792,667
Guaimbê,351730,SP,Sudeste,FIOCRUZ/ASTRAZENECA,1332,1194,138
Guaimbê,351730,SP,Sudeste,PFIZER/BIONTECH,107,107,0
Guaíra,351740,SP,Sudeste,BUTANTAN/SINOVAC,9472,5169,4303
Guaíra,351740,SP,Sudeste,FIOCRUZ/ASTRAZENECA,8972,8369,603
Guaíra,351740,SP,Sudeste,PFIZER/BIONTECH,918,906,12
Guaíra,410880,PR,Sul,BUTANTAN/SINOVAC,7720,3982,3738
Guaíra,410880,PR,Sul,FIOCRUZ/ASTRAZENECA,6283,5832,451
Guaíra,410880,PR,Sul,PFIZER/BIONTECH,740,740,0
Guairaçá,410890,PR,Sul,FIOCRUZ/ASTRAZENECA,2191,2059,132
Guairaçá,410890,PR,Sul,BUTANTAN/SINOVAC,1558,816,742
Guairaçá,410890,PR,Sul,PFIZER/BIONTECH,12,12,0
Guaiúba,230495,CE,Nordeste,BUTANTAN/SINOVAC,3395,1910,1485
Guaiúba,230495,CE,Nordeste,FIOCRUZ/ASTRAZENECA,1044,919,125
Guajará,130165,AM,Norte,FIOCRUZ/ASTRAZENECA,1966,1615,351
Guajará,130165,AM,Norte,BUTANTAN/SINOVAC,1879,994,885
Guajará-Mirim,110010,RO,Norte,BUTANTAN/SINOVAC,11492,6447,5045
Guajará-Mirim,110010,RO,Norte,FIOCRUZ/ASTRAZENECA,10414,9446,968
Guajará-Mirim,110010,RO,Norte,PFIZER/BIONTECH,909,905,4
Guajeru,291165,BA,Nordeste,FIOCRUZ/ASTRAZENECA,2293,2012,281
Guajeru,291165,BA,Nordeste,BUTANTAN/SINOVAC,2136,1143,993
Guajeru,291165,BA,Nordeste,PFIZER/BIONTECH,148,148,0
Guamaré,240450,RN,Nordeste,FIOCRUZ/ASTRAZENECA,5277,4899,378
Guamaré,240450,RN,Nordeste,BUTANTAN/SINOVAC,4310,2670,1640
Guamaré,240450,RN,Nordeste,PFIZER/BIONTECH,1059,1057,2
Guamiranga,410895,PR,Sul,FIOCRUZ/ASTRAZENECA,2009,1901,108
Guamiranga,410895,PR,Sul,BUTANTAN/SINOVAC,1224,637,587
Guamiranga,410895,PR,Sul,PFIZER/BIONTECH,37,37,0
Guanambi,291170,BA,Nordeste,BUTANTAN/SINOVAC,13310,7159,6151
Guanambi,291170,BA,Nordeste,FIOCRUZ/ASTRAZENECA,10464,9331,1133
Guanambi,291170,BA,Nordeste,PFIZER/BIONTECH,397,396,1
Guanhães,312800,MG,Sudeste,BUTANTAN/SINOVAC,6582,3338,3244
Guanhães,312800,MG,Sudeste,FIOCRUZ/ASTRAZENECA,5860,5341,519
Guanhães,312800,MG,Sudeste,PFIZER/BIONTECH,691,691,0
Guapé,312810,MG,Sudeste,FIOCRUZ/ASTRAZENECA,3186,2955,231
Guapé,312810,MG,Sudeste,BUTANTAN/SINOVAC,2960,1494,1466
Guapé,312810,MG,Sudeste,PFIZER/BIONTECH,194,194,0
Guapiaçu,351750,SP,Sudeste,BUTANTAN/SINOVAC,5392,3315,2077
Guapiaçu,351750,SP,Sudeste,FIOCRUZ/ASTRAZENECA,3793,3495,298
Guapiaçu,351750,SP,Sudeste,PFIZER/BIONTECH,157,157,0
Guapiara,351760,SP,Sudeste,BUTANTAN/SINOVAC,3862,2057,1805
Guapiara,351760,SP,Sudeste,FIOCRUZ/ASTRAZENECA,3832,3617,215
Guapiara,351760,SP,Sudeste,PFIZER/BIONTECH,375,375,0
Guapimirim,330185,RJ,Sudeste,FIOCRUZ/ASTRAZENECA,14049,12957,1092
Guapimirim,330185,RJ,Sudeste,BUTANTAN/SINOVAC,12932,6755,6177
Guapimirim,330185,RJ,Sudeste,PFIZER/BIONTECH,1914,1913,1
Guapirama,410900,PR,Sul,FIOCRUZ/ASTRAZENECA,1295,1238,57
Guapirama,410900,PR,Sul,BUTANTAN/SINOVAC,838,444,394
Guapirama,410900,PR,Sul,PFIZER/BIONTECH,24,24,0
Guapó,520920,GO,Centro-Oeste,FIOCRUZ/ASTRAZENECA,3793,3538,255
Guapó,520920,GO,Centro-Oeste,BUTANTAN/SINOVAC,2809,1429,1380
Guapó,520920,GO,Centro-Oeste,PFIZER/BIONTECH,202,202,0
Guaporé,430940,RS,Sul,FIOCRUZ/ASTRAZENECA,6418,5949,469
Guaporé,430940,RS,Sul,BUTANTAN/SINOVAC,5698,2870,2828
Guaporé,430940,RS,Sul,PFIZER/BIONTECH,570,570,0
Guaporema,410910,PR,Sul,FIOCRUZ/ASTRAZENECA,751,690,61
Guaporema,410910,PR,Sul,BUTANTAN/SINOVAC,597,321,276
Guaporema,410910,PR,Sul,PFIZER/BIONTECH,12,12,0
Guará,351770,SP,Sudeste,FIOCRUZ/ASTRAZENECA,4793,4341,452
Guará,351770,SP,Sudeste,BUTANTAN/SINOVAC,4487,2404,2083
Guará,351770,SP,Sudeste,PFIZER/BIONTECH,447,446,1
Guarabira,250630,PB,Nordeste,BUTANTAN/SINOVAC,12701,6500,6201
Guarabira,250630,PB,Nordeste,FIOCRUZ/ASTRAZENECA,9898,9038,860
Guarabira,250630,PB,Nordeste,PFIZER/BIONTECH,1413,1413,0
Guaraçaí,351780,SP,Sudeste,BUTANTAN/SINOVAC,2164,1201,963
Guaraçaí,351780,SP,Sudeste,FIOCRUZ/ASTRAZENECA,2079,1863,216
Guaraçaí,351780,SP,Sudeste,PFIZER/BIONTECH,272,272,0
Guaraci,351790,SP,Sudeste,BUTANTAN/SINOVAC,2312,1194,1118
Guaraci,351790,SP,Sudeste,FIOCRUZ/ASTRAZENECA,1959,1759,200
Guaraci,351790,SP,Sudeste,PFIZER/BIONTECH,191,191,0
Guaraci,410920,PR,Sul,FIOCRUZ/ASTRAZENECA,1678,1432,246
Guaraci,410920,PR,Sul,BUTANTAN/SINOVAC,1215,623,592
Guaraciaba,312820,MG,Sudeste,BUTANTAN/SINOVAC,2857,1518,1339
Guaraciaba,312820,MG,Sudeste,FIOCRUZ/ASTRAZENECA,2330,2072,258
Guaraciaba,312820,MG,Sudeste,PFIZER/BIONTECH,1,1,0
Guaraciaba,420640,SC,Sul,FIOCRUZ/ASTRAZENECA,3540,3246,294
Guaraciaba,420640,SC,Sul,BUTANTAN/SINOVAC,3085,1638,1447
Guaraciaba,420640,SC,Sul,PFIZER/BIONTECH,151,151,0
Guaraciaba Do Norte,230500,CE,Nordeste,BUTANTAN/SINOVAC,2111,1247,864
Guaraciaba Do Norte,230500,CE,Nordeste,FIOCRUZ/ASTRAZENECA,1163,1019,144
Guaraciama,312825,MG,Sudeste,FIOCRUZ/ASTRAZENECA,1082,1013,69
Guaraciama,312825,MG,Sudeste,BUTANTAN/SINOVAC,984,505,479
Guaraciama,312825,MG,Sudeste,PFIZER/BIONTECH,78,78,0
Guaraí,170930,TO,Norte,BUTANTAN/SINOVAC,4837,2450,2387
Guaraí,170930,TO,Norte,FIOCRUZ/ASTRAZENECA,4214,3879,335
Guaraíta,520929,GO,Centro-Oeste,FIOCRUZ/ASTRAZENECA,660,608,52
Guaraíta,520929,GO,Centro-Oeste,BUTANTAN/SINOVAC,488,256,232
Guaramiranga,230510,CE,Nordeste,FIOCRUZ/ASTRAZENECA,1048,977,71
Guaramiranga,230510,CE,Nordeste,BUTANTAN/SINOVAC,846,487,359
Guaramiranga,230510,CE,Nordeste,PFIZER/BIONTECH,22,22,0
Guaramirim,420650,SC,Sul,FIOCRUZ/ASTRAZENECA,5407,4822,585
Guaramirim,420650,SC,Sul,BUTANTAN/SINOVAC,4295,2342,1953
Guaramirim,420650,SC,Sul,PFIZER/BIONTECH,346,346,0
Guaranésia,312830,MG,Sudeste,BUTANTAN/SINOVAC,4464,2374,2090
Guaranésia,312830,MG,Sudeste,FIOCRUZ/ASTRAZENECA,3997,3677,320
Guaranésia,312830,MG,Sudeste,PFIZER/BIONTECH,60,60,0
Guarani,312840,MG,Sudeste,BUTANTAN/SINOVAC,2267,1128,1139
Guarani,312840,MG,Sudeste,FIOCRUZ/ASTRAZENECA,2156,1939,217
Guarani,312840,MG,Sudeste,PFIZER/BIONTECH,226,226,0
Guarani D'Oeste,351800,SP,Sudeste,BUTANTAN/SINOVAC,719,444,275
Guarani D'Oeste,351800,SP,Sudeste,FIOCRUZ/ASTRAZENECA,636,540,96
Guarani D'Oeste,351800,SP,Sudeste,PFIZER/BIONTECH,61,61,0
Guarani Das Missões,430950,RS,Sul,BUTANTAN/SINOVAC,2637,1361,1276
Guarani Das Missões,430950,RS,Sul,FIOCRUZ/ASTRAZENECA,2248,2013,235
Guarani Das Missões,430950,RS,Sul,PFIZER/BIONTECH,172,171,1
Guarani De Goiás,520940,GO,Centro-Oeste,FIOCRUZ/ASTRAZENECA,2189,2027,162
Guarani De Goiás,520940,GO,Centro-Oeste,BUTANTAN/SINOVAC,473,249,224
Guaraniaçu,410930,PR,Sul,FIOCRUZ/ASTRAZENECA,3175,3019,156
Guaraniaçu,410930,PR,Sul,BUTANTAN/SINOVAC,2786,1468,1318
Guarantã,351810,SP,Sudeste,BUTANTAN/SINOVAC,2586,1387,1199
Guarantã,351810,SP,Sudeste,FIOCRUZ/ASTRAZENECA,1939,1744,195
Guarantã,351810,SP,Sudeste,PFIZER/BIONTECH,153,153,0
Guarantã Do Norte,510410,MT,Centro-Oeste,BUTANTAN/SINOVAC,4840,2480,2360
Guarantã Do Norte,510410,MT,Centro-Oeste,FIOCRUZ/ASTRAZENECA,3786,3460,326
Guarantã Do Norte,510410,MT,Centro-Oeste,PFIZER/BIONTECH,274,273,1
Guarapari,320240,ES,Sudeste,FIOCRUZ/ASTRAZENECA,32540,30587,1953
Guarapari,320240,ES,Sudeste,BUTANTAN/SINOVAC,24155,12780,11375
Guarapari,320240,ES,Sudeste,PFIZER/BIONTECH,1203,1203,0
Guarapuava,410940,PR,Sul,FIOCRUZ/ASTRAZENECA,43400,41231,2169
Guarapuava,410940,PR,Sul,BUTANTAN/SINOVAC,27471,13933,13538
Guarapuava,410940,PR,Sul,PFIZER/BIONTECH,7579,7576,3
Guaraqueçaba,410950,PR,Sul,FIOCRUZ/ASTRAZENECA,4054,3856,198
Guaraqueçaba,410950,PR,Sul,BUTANTAN/SINOVAC,2174,1195,979
Guarará,312850,MG,Sudeste,FIOCRUZ/ASTRAZENECA,1078,992,86
Guarará,312850,MG,Sudeste,BUTANTAN/SINOVAC,1054,549,505
Guarará,312850,MG,Sudeste,PFIZER/BIONTECH,48,48,0
Guararapes,351820,SP,Sudeste,BUTANTAN/SINOVAC,8420,4623,3797
Guararapes,351820,SP,Sudeste,FIOCRUZ/ASTRAZENECA,8253,7696,557
Guararapes,351820,SP,Sudeste,PFIZER/BIONTECH,718,718,0
Guararema,351830,SP,Sudeste,BUTANTAN/SINOVAC,6912,3949,2963
Guararema,351830,SP,Sudeste,FIOCRUZ/ASTRAZENECA,5873,5524,349
Guararema,351830,SP,Sudeste,PFIZER/BIONTECH,470,469,1
Guaratinga,291180,BA,Nordeste,BUTANTAN/SINOVAC,1597,1079,518
Guaratinga,291180,BA,Nordeste,FIOCRUZ/ASTRAZENECA,661,612,49
Guaratinguetá,351840,SP,Sudeste,FIOCRUZ/ASTRAZENECA,30206,27762,2444
Guaratinguetá,351840,SP,Sudeste,BUTANTAN/SINOVAC,26756,14622,12134
Guaratinguetá,351840,SP,Sudeste,PFIZER/BIONTECH,886,874,12
Guaratuba,410960,PR,Sul,FIOCRUZ/ASTRAZENECA,8695,8196,499
Guaratuba,410960,PR,Sul,BUTANTAN/SINOVAC,7506,4075,3431
Guaratuba,410960,PR,Sul,PFIZER/BIONTECH,1088,1088,0
Guarda-Mor,312860,MG,Sudeste,FIOCRUZ/ASTRAZENECA,3258,2289,969
Guarda-Mor,312860,MG,Sudeste,BUTANTAN/SINOVAC,1403,709,694
Guarda-Mor,312860,MG,Sudeste,PFIZER/BIONTECH,112,112,0
Guareí,351850,SP,Sudeste,BUTANTAN/SINOVAC,3574,2194,1380
Guareí,351850,SP,Sudeste,FIOCRUZ/ASTRAZENECA,2772,2580,192
Guareí,351850,SP,Sudeste,PFIZER/BIONTECH,332,332,0
Guariba,351860,SP,Sudeste,FIOCRUZ/ASTRAZENECA,7864,7416,448
Guariba,351860,SP,Sudeste,BUTANTAN/SINOVAC,5869,3079,2790
Guariba,351860,SP,Sudeste,PFIZER/BIONTECH,563,563,0
Guaribas,220455,PI,Nordeste,FIOCRUZ/ASTRAZENECA,666,617,49
Guaribas,220455,PI,Nordeste,BUTANTAN/SINOVAC,512,259,253
Guaribas,220455,PI,Nordeste,PFIZER/BIONTECH,78,78,0
Guarinos,520945,GO,Centro-Oeste,FIOCRUZ/ASTRAZENECA,761,687,74
Guarinos,520945,GO,Centro-Oeste,BUTANTAN/SINOVAC,430,219,211
Guarinos,520945,GO,Centro-Oeste,PFIZER/BIONTECH,5,5,0
Guarujá,351870,SP,Sudeste,FIOCRUZ/ASTRAZENECA,62572,57357,5215
Guarujá,351870,SP,Sudeste,BUTANTAN/SINOVAC,56929,32682,24247
Guarujá,351870,SP,Sudeste,PFIZER/BIONTECH,2963,2949,14
Guarujá Do Sul,420660,SC,Sul,FIOCRUZ/ASTRAZENECA,1995,1853,142
Guarujá Do Sul,420660,SC,Sul,BUTANTAN/SINOVAC,1511,789,722
Guarujá Do Sul,420660,SC,Sul,PFIZER/BIONTECH,165,165,0
Guarulhos,351880,SP,Sudeste,FIOCRUZ/ASTRAZENECA,312988,295732,17256
Guarulhos,351880,SP,Sudeste,BUTANTAN/SINOVAC,211422,112366,99056
Guarulhos,351880,SP,Sudeste,PFIZER/BIONTECH,26141,26070,71
Guatambú,420665,SC,Sul,BUTANTAN/SINOVAC,1166,586,580
Guatambú,420665,SC,Sul,FIOCRUZ/ASTRAZENECA,1140,1030,110
Guatambú,420665,SC,Sul,PFIZER/BIONTECH,132,132,0
Guatapará,351885,SP,Sudeste,FIOCRUZ/ASTRAZENECA,1759,1591,168
Guatapará,351885,SP,Sudeste,BUTANTAN/SINOVAC,1509,724,785
Guatapará,351885,SP,Sudeste,PFIZER/BIONTECH,88,88,0
Guaxupé,312870,MG,Sudeste,BUTANTAN/SINOVAC,10613,5560,5053
Guaxupé,312870,MG,Sudeste,FIOCRUZ/ASTRAZENECA,8207,7688,519
Guaxupé,312870,MG,Sudeste,PFIZER/BIONTECH,1589,1589,0
Guia Lopes Da Laguna,500410,MS,Centro-Oeste,BUTANTAN/SINOVAC,3063,1704,1359
Guia Lopes Da Laguna,500410,MS,Centro-Oeste,FIOCRUZ/ASTRAZENECA,3012,2642,370
Guia Lopes Da Laguna,500410,MS,Centro-Oeste,PFIZER/BIONTECH,368,365,3
Guidoval,312880,MG,Sudeste,BUTANTAN/SINOVAC,2053,1071,982
Guidoval,312880,MG,Sudeste,FIOCRUZ/ASTRAZENECA,1775,1641,134
Guidoval,312880,MG,Sudeste,PFIZER/BIONTECH,95,95,0
Guimarães,210490,MA,Nordeste,FIOCRUZ/ASTRAZENECA,4935,4526,409
Guimarães,210490,MA,Nordeste,BUTANTAN/SINOVAC,2332,1221,1111
Guimarânia,312890,MG,Sudeste,FIOCRUZ/ASTRAZENECA,2284,2065,219
Guimarânia,312890,MG,Sudeste,BUTANTAN/SINOVAC,1937,1021,916
Guimarânia,312890,MG,Sudeste,PFIZER/BIONTECH,175,175,0
Guiratinga,510420,MT,Centro-Oeste,BUTANTAN/SINOVAC,3731,2003,1728
Guiratinga,510420,MT,Centro-Oeste,FIOCRUZ/ASTRAZENECA,2093,1889,204
Guiratinga,510420,MT,Centro-Oeste,PFIZER/BIONTECH,117,116,1
Guiricema,312900,MG,Sudeste,BUTANTAN/SINOVAC,2552,1280,1272
Guiricema,312900,MG,Sudeste,FIOCRUZ/ASTRAZENECA,2102,1935,167
Guiricema,312900,MG,Sudeste,PFIZER/BIONTECH,186,186,0
Gurinhatã,312910,MG,Sudeste,BUTANTAN/SINOVAC,1937,998,939
Gurinhatã,312910,MG,Sudeste,FIOCRUZ/ASTRAZENECA,1308,1194,114
Gurinhatã,312910,MG,Sudeste,PFIZER/BIONTECH,122,121,1
Gurinhém,250640,PB,Nordeste,BUTANTAN/SINOVAC,2836,1458,1378
Gurinhém,250640,PB,Nordeste,FIOCRUZ/ASTRAZENECA,2390,2249,141
Gurinhém,250640,PB,Nordeste,PFIZER/BIONTECH,114,114,0
Gurjão,250650,PB,Nordeste,BUTANTAN/SINOVAC,926,477,449
Gurjão,250650,PB,Nordeste,FIOCRUZ/ASTRAZENECA,629,566,63
Gurjão,250650,PB,Nordeste,PFIZER/BIONTECH,64,64,0
Gurupá,150310,PA,Norte,FIOCRUZ/ASTRAZENECA,8468,6922,1546
Gurupá,150310,PA,Norte,BUTANTAN/SINOVAC,1406,763,643
Gurupi,170950,TO,Norte,FIOCRUZ/ASTRAZENECA,17109,16060,1049
Gurupi,170950,TO,Norte,BUTANTAN/SINOVAC,13611,6931,6680
Gurupi,170950,TO,Norte,PFIZER/BIONTECH,4774,4767,7
Guzolândia,351890,SP,Sudeste,FIOCRUZ/ASTRAZENECA,1259,1185,74
Guzolândia,351890,SP,Sudeste,BUTANTAN/SINOVAC,1196,677,519
Guzolândia,351890,SP,Sudeste,PFIZER/BIONTECH,82,82,0
Harmonia,430955,RS,Sul,BUTANTAN/SINOVAC,2451,1523,928
Harmonia,430955,RS,Sul,FIOCRUZ/ASTRAZENECA,1069,982,87
Harmonia,430955,RS,Sul,PFIZER/BIONTECH,158,158,0
Heitoraí,520960,GO,Centro-Oeste,FIOCRUZ/ASTRAZENECA,1162,1078,84
Heitoraí,520960,GO,Centro-Oeste,BUTANTAN/SINOVAC,865,457,408
Heliodora,312920,MG,Sudeste,FIOCRUZ/ASTRAZENECA,1513,1408,105
Heliodora,312920,MG,Sudeste,BUTANTAN/SINOVAC,1454,746,708
Heliodora,312920,MG,Sudeste,PFIZER/BIONTECH,89,89,0
Heliópolis,291185,BA,Nordeste,FIOCRUZ/ASTRAZENECA,2942,2792,150
Heliópolis,291185,BA,Nordeste,BUTANTAN/SINOVAC,2770,1441,1329
Heliópolis,291185,BA,Nordeste,PFIZER/BIONTECH,94,94,0
Herculândia,351900,SP,Sudeste,BUTANTAN/SINOVAC,3785,2006,1779
Herculândia,351900,SP,Sudeste,FIOCRUZ/ASTRAZENECA,3625,3277,348
Herculândia,351900,SP,Sudeste,PFIZER/BIONTECH,493,493,0
Herval,430710,RS,Sul,BUTANTAN/SINOVAC,2039,1050,989
Herval,430710,RS,Sul,FIOCRUZ/ASTRAZENECA,1718,1566,152
Herval,430710,RS,Sul,PFIZER/BIONTECH,242,242,0
Herval D'Oeste,420670,SC,Sul,FIOCRUZ/ASTRAZENECA,5450,4990,460
Herval D'Oeste,420670,SC,Sul,BUTANTAN/SINOVAC,4744,2489,2255
Herval D'Oeste,420670,SC,Sul,PFIZER/BIONTECH,277,277,0
Herveiras,430957,RS,Sul,FIOCRUZ/ASTRAZENECA,675,616,59
Herveiras,430957,RS,Sul,BUTANTAN/SINOVAC,616,309,307
Herveiras,430957,RS,Sul,PFIZER/BIONTECH,65,65,0
Hidrolândia,230520,CE,Nordeste,BUTANTAN/SINOVAC,3662,1904,1758
Hidrolândia,230520,CE,Nordeste,FIOCRUZ/ASTRAZENECA,2035,1569,466
Hidrolândia,520970,GO,Centro-Oeste,FIOCRUZ/ASTRAZENECA,5061,4743,318
Hidrolândia,520970,GO,Centro-Oeste,BUTANTAN/SINOVAC,3409,1800,1609
Hidrolândia,520970,GO,Centro-Oeste,PFIZER/BIONTECH,356,356,0
Hidrolina,520980,GO,Centro-Oeste,FIOCRUZ/ASTRAZENECA,1449,1258,191
Hidrolina,520980,GO,Centro-Oeste,BUTANTAN/SINOVAC,817,429,388
Holambra,351905,SP,Sudeste,BUTANTAN/SINOVAC,2893,1889,1004
Holambra,351905,SP,Sudeste,FIOCRUZ/ASTRAZENECA,2078,1966,112
Holambra,351905,SP,Sudeste,PFIZER/BIONTECH,123,120,3
Honório Serpa,410965,PR,Sul,FIOCRUZ/ASTRAZENECA,1343,1271,72
Honório Serpa,410965,PR,Sul,BUTANTAN/SINOVAC,1047,533,514
Horizonte,230523,CE,Nordeste,BUTANTAN/SINOVAC,4990,2815,2175
Horizonte,230523,CE,Nordeste,FIOCRUZ/ASTRAZENECA,2599,2517,82
Horizonte,230523,CE,Nordeste,PFIZER/BIONTECH,6,6,0
Horizontina,430960,RS,Sul,BUTANTAN/SINOVAC,5437,2724,2713
Horizontina,430960,RS,Sul,FIOCRUZ/ASTRAZENECA,4318,3869,449
Horizontina,430960,RS,Sul,PFIZER/BIONTECH,421,421,0
Hortolândia,351907,SP,Sudeste,FIOCRUZ/ASTRAZENECA,44292,40634,3658
Hortolândia,351907,SP,Sudeste,BUTANTAN/SINOVAC,42069,21724,20345
Hortolândia,351907,SP,Sudeste,PFIZER/BIONTECH,2513,2509,4
Hugo Napoleão,220460,PI,Nordeste,BUTANTAN/SINOVAC,1244,671,573
Hugo Napoleão,220460,PI,Nordeste,FIOCRUZ/ASTRAZENECA,777,730,47
Hulha Negra,430965,RS,Sul,FIOCRUZ/ASTRAZENECA,1598,1507,91
Hulha Negra,430965,RS,Sul,BUTANTAN/SINOVAC,1082,564,518
Hulha Negra,430965,RS,Sul,PFIZER/BIONTECH,227,167,60
Humaitá,130170,AM,Norte,FIOCRUZ/ASTRAZENECA,11063,8666,2397
Humaitá,130170,AM,Norte,BUTANTAN/SINOVAC,9223,4893,4330
Humaitá,430970,RS,Sul,BUTANTAN/SINOVAC,1452,724,728
Humaitá,430970,RS,Sul,FIOCRUZ/ASTRAZENECA,1428,1321,107
Humaitá,430970,RS,Sul,PFIZER/BIONTECH,61,61,0
Humberto De Campos,210500,MA,Nordeste,FIOCRUZ/ASTRAZENECA,3343,3045,298
Humberto De Campos,210500,MA,Nordeste,BUTANTAN/SINOVAC,3202,1712,1490
Iacanga,351910,SP,Sudeste,FIOCRUZ/ASTRAZENECA,2969,2712,257
Iacanga,351910,SP,Sudeste,BUTANTAN/SINOVAC,2796,1635,1161
Iacanga,351910,SP,Sudeste,PFIZER/BIONTECH,189,189,0
Iaciara,520990,GO,Centro-Oeste,FIOCRUZ/ASTRAZENECA,4102,3670,432
Iaciara,520990,GO,Centro-Oeste,BUTANTAN/SINOVAC,1128,601,527
Iacri,351920,SP,Sudeste,BUTANTAN/SINOVAC,1737,947,790
Iacri,351920,SP,Sudeste,FIOCRUZ/ASTRAZENECA,1480,1333,147
Iacri,351920,SP,Sudeste,PFIZER/BIONTECH,156,156,0
Iaçu,291190,BA,Nordeste,BUTANTAN/SINOVAC,4231,2142,2089
Iaçu,291190,BA,Nordeste,FIOCRUZ/ASTRAZENECA,4147,3935,212
Iaçu,291190,BA,Nordeste,PFIZER/BIONTECH,303,303,0
Iapu,312930,MG,Sudeste,FIOCRUZ/ASTRAZENECA,2552,2381,171
Iapu,312930,MG,Sudeste,BUTANTAN/SINOVAC,2275,1185,1090
Iapu,312930,MG,Sudeste,PFIZER/BIONTECH,265,265,0
Iaras,351925,SP,Sudeste,BUTANTAN/SINOVAC,1647,957,690
Iaras,351925,SP,Sudeste,FIOCRUZ/ASTRAZENECA,1543,1468,75
Iaras,351925,SP,Sudeste,PFIZER/BIONTECH,252,249,3
Iati,260650,PE,Nordeste,FIOCRUZ/ASTRAZENECA,4993,4265,728
Iati,260650,PE,Nordeste,BUTANTAN/SINOVAC,3235,1649,1586
Iati,260650,PE,Nordeste,PFIZER/BIONTECH,627,627,0
Ibaiti,410970,PR,Sul,BUTANTAN/SINOVAC,8415,5050,3365
Ibaiti,410970,PR,Sul,FIOCRUZ/ASTRAZENECA,7842,7366,476
Ibaiti,410970,PR,Sul,PFIZER/BIONTECH,655,655,0
Ibarama,430975,RS,Sul,BUTANTAN/SINOVAC,961,482,479
Ibarama,430975,RS,Sul,FIOCRUZ/ASTRAZENECA,873,804,69
Ibarama,430975,RS,Sul,PFIZER/BIONTECH,161,161,0
Ibaretama,230526,CE,Nordeste,BUTANTAN/SINOVAC,2378,1253,1125
Ibaretama,230526,CE,Nordeste,FIOCRUZ/ASTRAZENECA,1482,1315,167
Ibaté,351930,SP,Sudeste,FIOCRUZ/ASTRAZENECA,6126,5782,344
Ibaté,351930,SP,Sudeste,BUTANTAN/SINOVAC,5419,2933,2486
Ibaté,351930,SP,Sudeste,PFIZER/BIONTECH,852,852,0
Ibateguara,270300,AL,Nordeste,FIOCRUZ/ASTRAZENECA,2698,2421,277
Ibateguara,270300,AL,Nordeste,BUTANTAN/SINOVAC,2380,1227,1153
Ibatiba,320245,ES,Sudeste,BUTANTAN/SINOVAC,5806,2964,2842
Ibatiba,320245,ES,Sudeste,FIOCRUZ/ASTRAZENECA,5218,5015,203
Ibatiba,320245,ES,Sudeste,PFIZER/BIONTECH,927,925,2
Ibema,410975,PR,Sul,FIOCRUZ/ASTRAZENECA,1451,1377,74
Ibema,410975,PR,Sul,BUTANTAN/SINOVAC,1310,697,613
Ibema,410975,PR,Sul,PFIZER/BIONTECH,28,28,0
Ibertioga,312940,MG,Sudeste,BUTANTAN/SINOVAC,984,622,362
Ibertioga,312940,MG,Sudeste,FIOCRUZ/ASTRAZENECA,517,469,48
Ibertioga,312940,MG,Sudeste,PFIZER/BIONTECH,48,48,0
Ibiá,312950,MG,Sudeste,FIOCRUZ/ASTRAZENECA,4874,4500,374
Ibiá,312950,MG,Sudeste,BUTANTAN/SINOVAC,4524,2262,2262
Ibiá,312950,MG,Sudeste,PFIZER/BIONTECH,111,111,0
Ibiaçá,430980,RS,Sul,BUTANTAN/SINOVAC,1679,842,837
Ibiaçá,430980,RS,Sul,FIOCRUZ/ASTRAZENECA,1623,1500,123
Ibiaçá,430980,RS,Sul,PFIZER/BIONTECH,155,155,0
Ibiaí,312960,MG,Sudeste,BUTANTAN/SINOVAC,821,448,373
Ibiaí,312960,MG,Sudeste,FIOCRUZ/ASTRAZENECA,56,54,2
Ibiam,420675,SC,Sul,FIOCRUZ/ASTRAZENECA,607,568,39
Ibiam,420675,SC,Sul,BUTANTAN/SINOVAC,560,291,269
Ibiam,420675,SC,Sul,PFIZER/BIONTECH,67,67,0
Ibiapina,230530,CE,Nordeste,BUTANTAN/SINOVAC,4690,2350,2340
Ibiapina,230530,CE,Nordeste,FIOCRUZ/ASTRAZENECA,2727,2257,470
Ibiara,250660,PB,Nordeste,BUTANTAN/SINOVAC,1977,1014,963
Ibiara,250660,PB,Nordeste,FIOCRUZ/ASTRAZENECA,1066,960,106
Ibiara,250660,PB,Nordeste,PFIZER/BIONTECH,113,113,0
Ibiassucê,291200,BA,Nordeste,BUTANTAN/SINOVAC,2541,1298,1243
Ibiassucê,291200,BA,Nordeste,FIOCRUZ/ASTRAZENECA,2360,2150,210
Ibiassucê,291200,BA,Nordeste,PFIZER/BIONTECH,47,47,0
Ibicaraí,291210,BA,Nordeste,FIOCRUZ/ASTRAZENECA,5876,5430,446
Ibicaraí,291210,BA,Nordeste,BUTANTAN/SINOVAC,5857,3071,2786
Ibicaraí,291210,BA,Nordeste,PFIZER/BIONTECH,432,432,0
Ibicaré,420680,SC,Sul,BUTANTAN/SINOVAC,1046,561,485
Ibicaré,420680,SC,Sul,FIOCRUZ/ASTRAZENECA,966,892,74
Ibicaré,420680,SC,Sul,PFIZER/BIONTECH,116,115,1
Ibicoara,291220,BA,Nordeste,FIOCRUZ/ASTRAZENECA,3081,2835,246
Ibicoara,291220,BA,Nordeste,BUTANTAN/SINOVAC,2122,1128,994
Ibicoara,291220,BA,Nordeste,PFIZER/BIONTECH,252,252,0
Ibicuí,291230,BA,Nordeste,FIOCRUZ/ASTRAZENECA,7292,6444,848
Ibicuí,291230,BA,Nordeste,BUTANTAN/SINOVAC,4266,2055,2211
Ibicuí,291230,BA,Nordeste,PFIZER/BIONTECH,315,315,0
Ibicuitinga,230533,CE,Nordeste,BUTANTAN/SINOVAC,2552,1354,1198
Ibicuitinga,230533,CE,Nordeste,FIOCRUZ/ASTRAZENECA,1470,1219,251
Ibimirim,260660,PE,Nordeste,BUTANTAN/SINOVAC,7134,3609,3525
Ibimirim,260660,PE,Nordeste,FIOCRUZ/ASTRAZENECA,4093,3759,334
Ibimirim,260660,PE,Nordeste,PFIZER/BIONTECH,336,336,0
Ibipeba,291240,BA,Nordeste,FIOCRUZ/ASTRAZENECA,5852,5469,383
Ibipeba,291240,BA,Nordeste,BUTANTAN/SINOVAC,3442,1763,1679
Ibipeba,291240,BA,Nordeste,PFIZER/BIONTECH,22,22,0
Ibipitanga,291250,BA,Nordeste,BUTANTAN/SINOVAC,3283,1763,1520
Ibipitanga,291250,BA,Nordeste,FIOCRUZ/ASTRAZENECA,3210,2919,291
Ibipitanga,291250,BA,Nordeste,PFIZER/BIONTECH,212,212,0
Ibiporã,410980,PR,Sul,FIOCRUZ/ASTRAZENECA,13954,12877,1077
Ibiporã,410980,PR,Sul,BUTANTAN/SINOVAC,9695,4979,4716
Ibiporã,410980,PR,Sul,PFIZER/BIONTECH,553,553,0
Ibiquera,291260,BA,Nordeste,BUTANTAN/SINOVAC,1027,535,492
Ibiquera,291260,BA,Nordeste,FIOCRUZ/ASTRAZENECA,813,765,48
Ibirá,351940,SP,Sudeste,BUTANTAN/SINOVAC,4735,2693,2042
Ibirá,351940,SP,Sudeste,FIOCRUZ/ASTRAZENECA,2532,2271,261
Ibirá,351940,SP,Sudeste,PFIZER/BIONTECH,251,251,0
Ibiracatu,312965,MG,Sudeste,BUTANTAN/SINOVAC,1089,564,525
Ibiracatu,312965,MG,Sudeste,FIOCRUZ/ASTRAZENECA,945,865,80
Ibiracatu,312965,MG,Sudeste,PFIZER/BIONTECH,8,8,0
Ibiraci,312970,MG,Sudeste,FIOCRUZ/ASTRAZENECA,2470,2295,175
Ibiraci,312970,MG,Sudeste,BUTANTAN/SINOVAC,2356,1209,1147
Ibiraci,312970,MG,Sudeste,PFIZER/BIONTECH,448,448,0
Ibiraçu,320250,ES,Sudeste,BUTANTAN/SINOVAC,3355,1831,1524
Ibiraçu,320250,ES,Sudeste,FIOCRUZ/ASTRAZENECA,2920,2782,138
Ibiraçu,320250,ES,Sudeste,PFIZER/BIONTECH,402,402,0
Ibiraiaras,430990,RS,Sul,BUTANTAN/SINOVAC,2629,1328,1301
Ibiraiaras,430990,RS,Sul,FIOCRUZ/ASTRAZENECA,2176,1859,317
Ibiraiaras,430990,RS,Sul,PFIZER/BIONTECH,111,111,0
Ibirajuba,260670,PE,Nordeste,FIOCRUZ/ASTRAZENECA,1782,1560,222
Ibirajuba,260670,PE,Nordeste,BUTANTAN/SINOVAC,1600,873,727
Ibirajuba,260670,PE,Nordeste,PFIZER/BIONTECH,129,129,0
Ibirama,420690,SC,Sul,FIOCRUZ/ASTRAZENECA,4637,4209,428
Ibirama,420690,SC,Sul,BUTANTAN/SINOVAC,3654,1894,1760
Ibirama,420690,SC,Sul,PFIZER/BIONTECH,63,63,0
Ibirapitanga,291270,BA,Nordeste,BUTANTAN/SINOVAC,4091,2120,1971
Ibirapitanga,291270,BA,Nordeste,FIOCRUZ/ASTRAZENECA,3083,2874,209
Ibirapitanga,291270,BA,Nordeste,PFIZER/BIONTECH,27,27,0
Ibirapuã,291280,BA,Nordeste,FIOCRUZ/ASTRAZENECA,1890,1772,118
Ibirapuã,291280,BA,Nordeste,BUTANTAN/SINOVAC,1675,881,794
Ibirapuã,291280,BA,Nordeste,PFIZER/BIONTECH,199,199,0
Ibirapuitã,430995,RS,Sul,BUTANTAN/SINOVAC,1070,547,523
Ibirapuitã,430995,RS,Sul,FIOCRUZ/ASTRAZENECA,1053,918,135
Ibirapuitã,430995,RS,Sul,PFIZER/BIONTECH,172,171,1
Ibirarema,351950,SP,Sudeste,BUTANTAN/SINOVAC,1898,1001,897
Ibirarema,351950,SP,Sudeste,FIOCRUZ/ASTRAZENECA,1581,1453,128
Ibirarema,351950,SP,Sudeste,PFIZER/BIONTECH,187,187,0
Ibirataia,291290,BA,Nordeste,FIOCRUZ/ASTRAZENECA,4118,3648,470
Ibirataia,291290,BA,Nordeste,BUTANTAN/SINOVAC,3381,1785,1596
Ibirataia,291290,BA,Nordeste,PFIZER/BIONTECH,223,223,0
Ibirité,312980,MG,Sudeste,FIOCRUZ/ASTRAZENECA,27841,25648,2193
Ibirité,312980,MG,Sudeste,BUTANTAN/SINOVAC,23442,12117,11325
Ibirité,312980,MG,Sudeste,PFIZER/BIONTECH,2558,2557,1
Ibirubá,431000,RS,Sul,BUTANTAN/SINOVAC,5560,2805,2755
Ibirubá,431000,RS,Sul,FIOCRUZ/ASTRAZENECA,5404,4966,438
Ibirubá,431000,RS,Sul,PFIZER/BIONTECH,451,451,0
Ibitiara,291300,BA,Nordeste,BUTANTAN/SINOVAC,3719,1954,1765
Ibitiara,291300,BA,Nordeste,FIOCRUZ/ASTRAZENECA,2942,2704,238
Ibitiara,291300,BA,Nordeste,PFIZER/BIONTECH,18,18,0
Ibitinga,351960,SP,Sudeste,BUTANTAN/SINOVAC,13061,7326,5735
Ibitinga,351960,SP,Sudeste,FIOCRUZ/ASTRAZENECA,12557,11550,1007
Ibitinga,351960,SP,Sudeste,PFIZER/BIONTECH,484,478,6
Ibitirama,320255,ES,Sudeste,BUTANTAN/SINOVAC,1891,975,916
Ibitirama,320255,ES,Sudeste,FIOCRUZ/ASTRAZENECA,1539,1453,86
Ibitirama,320255,ES,Sudeste,PFIZER/BIONTECH,136,136,0
Ibititá,291310,BA,Nordeste,FIOCRUZ/ASTRAZENECA,7155,6418,737
Ibititá,291310,BA,Nordeste,BUTANTAN/SINOVAC,4015,2203,1812
Ibititá,291310,BA,Nordeste,PFIZER/BIONTECH,59,59,0
Ibitiúra De Minas,312990,MG,Sudeste,BUTANTAN/SINOVAC,249,174,75
Ibitiúra De Minas,312990,MG,Sudeste,FIOCRUZ/ASTRAZENECA,75,75,0
Ibitiúra De Minas,312990,MG,Sudeste,PFIZER/BIONTECH,32,32,0
Ibituruna,313000,MG,Sudeste,BUTANTAN/SINOVAC,838,447,391
Ibituruna,313000,MG,Sudeste,FIOCRUZ/ASTRAZENECA,647,585,62
Ibituruna,313000,MG,Sudeste,PFIZER/BIONTECH,95,95,0
Ibiúna,351970,SP,Sudeste,BUTANTAN/SINOVAC,14070,7719,6351
Ibiúna,351970,SP,Sudeste,FIOCRUZ/ASTRAZENECA,13628,12200,1428
Ibiúna,351970,SP,Sudeste,PFIZER/BIONTECH,528,528,0
Ibotirama,291320,BA,Nordeste,FIOCRUZ/ASTRAZENECA,6171,5840,331
Ibotirama,291320,BA,Nordeste,BUTANTAN/SINOVAC,5773,2995,2778
Ibotirama,291320,BA,Nordeste,PFIZER/BIONTECH,211,211,0
Icapuí,230535,CE,Nordeste,FIOCRUZ/ASTRAZENECA,4896,4318,578
Icapuí,230535,CE,Nordeste,BUTANTAN/SINOVAC,3670,1905,1765
Icapuí,230535,CE,Nordeste,PFIZER/BIONTECH,337,337,0
Içara,420700,SC,Sul,FIOCRUZ/ASTRAZENECA,11736,10886,850
Içara,420700,SC,Sul,BUTANTAN/SINOVAC,8415,4627,3788
Içara,420700,SC,Sul,PFIZER/BIONTECH,1252,1252,0
Icaraí De Minas,313005,MG,Sudeste,FIOCRUZ/ASTRAZENECA,1777,1629,148
Icaraí De Minas,313005,MG,Sudeste,BUTANTAN/SINOVAC,1630,824,806
Icaraí De Minas,313005,MG,Sudeste,PFIZER/BIONTECH,114,114,0
Icaraíma,410990,PR,Sul,FIOCRUZ/ASTRAZENECA,2573,2413,160
Icaraíma,410990,PR,Sul,BUTANTAN/SINOVAC,2080,1070,1010
Icaraíma,410990,PR,Sul,PFIZER/BIONTECH,114,114,0
Icatu,210510,MA,Nordeste,FIOCRUZ/ASTRAZENECA,5990,5415,575
Icatu,210510,MA,Nordeste,BUTANTAN/SINOVAC,3293,1768,1525
Icém,351980,SP,Sudeste,BUTANTAN/SINOVAC,2342,1387,955
Icém,351980,SP,Sudeste,FIOCRUZ/ASTRAZENECA,2039,1874,165
Icém,351980,SP,Sudeste,PFIZER/BIONTECH,131,131,0
Ichu,291330,BA,Nordeste,FIOCRUZ/ASTRAZENECA,1412,1235,177
Ichu,291330,BA,Nordeste,BUTANTAN/SINOVAC,1410,744,666
Ichu,291330,BA,Nordeste,PFIZER/BIONTECH,339,339,0
Icó,230540,CE,Nordeste,BUTANTAN/SINOVAC,8385,4978,3407
Icó,230540,CE,Nordeste,FIOCRUZ/ASTRAZENECA,3712,3228,484
Icó,230540,CE,Nordeste,PFIZER/BIONTECH,1,1,0
Iconha,320260,ES,Sudeste,BUTANTAN/SINOVAC,4224,2195,2029
Iconha,320260,ES,Sudeste,FIOCRUZ/ASTRAZENECA,3173,3033,140
Iconha,320260,ES,Sudeste,PFIZER/BIONTECH,517,517,0
Ielmo Marinho,240460,RN,Nordeste,FIOCRUZ/ASTRAZENECA,2935,2829,106
Ielmo Marinho,240460,RN,Nordeste,BUTANTAN/SINOVAC,2356,1198,1158
Ielmo Marinho,240460,RN,Nordeste,PFIZER/BIONTECH,110,110,0
Iepê,351990,SP,Sudeste,BUTANTAN/SINOVAC,2246,1238,1008
Iepê,351990,SP,Sudeste,FIOCRUZ/ASTRAZENECA,2213,2025,188
Iepê,351990,SP,Sudeste,PFIZER/BIONTECH,191,191,0
Igaci,270310,AL,Nordeste,FIOCRUZ/ASTRAZENECA,5864,5149,715
Igaci,270310,AL,Nordeste,BUTANTAN/SINOVAC,4976,2717,2259
Igaporã,291340,BA,Nordeste,BUTANTAN/SINOVAC,3727,1931,1796
Igaporã,291340,BA,Nordeste,FIOCRUZ/ASTRAZENECA,3160,2933,227
Igaraçu Do Tietê,352000,SP,Sudeste,FIOCRUZ/ASTRAZENECA,5372,5086,286
Igaraçu Do Tietê,352000,SP,Sudeste,BUTANTAN/SINOVAC,4052,2187,1865
Igaraçu Do Tietê,352000,SP,Sudeste,PFIZER/BIONTECH,634,634,0
Igaracy,250260,PB,Nordeste,BUTANTAN/SINOVAC,1600,818,782
Igaracy,250260,PB,Nordeste,FIOCRUZ/ASTRAZENECA,998,973,25
Igarapava,352010,SP,Sudeste,FIOCRUZ/ASTRAZENECA,6751,6235,516
Igarapava,352010,SP,Sudeste,BUTANTAN/SINOVAC,6361,3445,2916
Igarapava,352010,SP,Sudeste,PFIZER/BIONTECH,458,452,6
Igarapé,313010,MG,Sudeste,FIOCRUZ/ASTRAZENECA,7640,7142,498
Igarapé,313010,MG,Sudeste,BUTANTAN/SINOVAC,6080,3131,2949
Igarapé,313010,MG,Sudeste,PFIZER/BIONTECH,968,967,1
Igarapé Do Meio,210515,MA,Nordeste,BUTANTAN/SINOVAC,2783,1690,1093
Igarapé Do Meio,210515,MA,Nordeste,FIOCRUZ/ASTRAZENECA,2636,2500,136
Igarapé Grande,210520,MA,Nordeste,FIOCRUZ/ASTRAZENECA,3498,3030,468
Igarapé Grande,210520,MA,Nordeste,BUTANTAN/SINOVAC,2204,1232,972
Igarapé-Açu,150320,PA,Norte,BUTANTAN/SINOVAC,7636,4072,3564
Igarapé-Açu,150320,PA,Norte,FIOCRUZ/ASTRAZENECA,6349,4817,1532
Igarapé-Miri,150330,PA,Norte,FIOCRUZ/ASTRAZENECA,19461,17171,2290
Igarapé-Miri,150330,PA,Norte,BUTANTAN/SINOVAC,6523,3515,3008
Igarassu,260680,PE,Nordeste,BUTANTAN/SINOVAC,22221,13371,8850
Igarassu,260680,PE,Nordeste,FIOCRUZ/ASTRAZENECA,9242,7924,1318
Igarassu,260680,PE,Nordeste,PFIZER/BIONTECH,515,514,1
Igaratá,352020,SP,Sudeste,FIOCRUZ/ASTRAZENECA,2397,2209,188
Igaratá,352020,SP,Sudeste,BUTANTAN/SINOVAC,2307,1290,1017
Igaratá,352020,SP,Sudeste,PFIZER/BIONTECH,193,193,0
Igaratinga,313020,MG,Sudeste,FIOCRUZ/ASTRAZENECA,2209,2023,186
Igaratinga,313020,MG,Sudeste,BUTANTAN/SINOVAC,1915,1022,893
Igaratinga,313020,MG,Sudeste,PFIZER/BIONTECH,112,112,0
Igrapiúna,291345,BA,Nordeste,FIOCRUZ/ASTRAZENECA,2449,2347,102
Igrapiúna,291345,BA,Nordeste,BUTANTAN/SINOVAC,1847,1000,847
Igrapiúna,291345,BA,Nordeste,PFIZER/BIONTECH,36,36,0
Igreja Nova,270320,AL,Nordeste,FIOCRUZ/ASTRAZENECA,6598,6065,533
Igreja Nova,270320,AL,Nordeste,BUTANTAN/SINOVAC,3692,1997,1695
Igrejinha,431010,RS,Sul,FIOCRUZ/ASTRAZENECA,8484,8024,460
Igrejinha,431010,RS,Sul,BUTANTAN/SINOVAC,7690,3850,3840
Igrejinha,431010,RS,Sul,PFIZER/BIONTECH,1260,1259,1
Iguaba Grande,330187,RJ,Sudeste,FIOCRUZ/ASTRAZENECA,10958,10345,613
Iguaba Grande,330187,RJ,Sudeste,BUTANTAN/SINOVAC,7332,3883,3449
Iguaba Grande,330187,RJ,Sudeste,PFIZER/BIONTECH,1357,1357,0
Iguaí,291350,BA,Nordeste,BUTANTAN/SINOVAC,3888,2564,1324
Iguaí,291350,BA,Nordeste,FIOCRUZ/ASTRAZENECA,1771,1749,22
Iguape,352030,SP,Sudeste,FIOCRUZ/ASTRAZENECA,8204,7685,519
Iguape,352030,SP,Sudeste,BUTANTAN/SINOVAC,7865,4308,3557
Iguape,352030,SP,Sudeste,PFIZER/BIONTECH,824,822,2
Iguaraçu,411000,PR,Sul,FIOCRUZ/ASTRAZENECA,1514,1445,69
Iguaraçu,411000,PR,Sul,BUTANTAN/SINOVAC,883,456,427
Iguaraçu,411000,PR,Sul,PFIZER/BIONTECH,4,4,0
Iguaracy,260690,PE,Nordeste,FIOCRUZ/ASTRAZENECA,3582,3300,282
Iguaracy,260690,PE,Nordeste,BUTANTAN/SINOVAC,2481,1284,1197
Iguaracy,260690,PE,Nordeste,PFIZER/BIONTECH,138,138,0
Iguatama,313030,MG,Sudeste,BUTANTAN/SINOVAC,2278,1224,1054
Iguatama,313030,MG,Sudeste,FIOCRUZ/ASTRAZENECA,1868,1703,165
Iguatama,313030,MG,Sudeste,PFIZER/BIONTECH,41,41,0
Iguatemi,500430,MS,Centro-Oeste,FIOCRUZ/ASTRAZENECA,4435,4210,225
Iguatemi,500430,MS,Centro-Oeste,BUTANTAN/SINOVAC,3926,2097,1829
Iguatemi,500430,MS,Centro-Oeste,PFIZER/BIONTECH,495,495,0
Iguatu,230550,CE,Nordeste,BUTANTAN/SINOVAC,12607,8330,4277
Iguatu,230550,CE,Nordeste,FIOCRUZ/ASTRAZENECA,4302,3975,327
Iguatu,230550,CE,Nordeste,PFIZER/BIONTECH,1,1,0
Iguatu,411005,PR,Sul,FIOCRUZ/ASTRAZENECA,703,660,43
Iguatu,411005,PR,Sul,BUTANTAN/SINOVAC,571,292,279
Iguatu,411005,PR,Sul,PFIZER/BIONTECH,12,12,0
Ijaci,313040,MG,Sudeste,FIOCRUZ/ASTRAZENECA,1548,1440,108
Ijaci,313040,MG,Sudeste,BUTANTAN/SINOVAC,1218,634,584
Ijaci,313040,MG,Sudeste,PFIZER/BIONTECH,71,71,0
Ijuí,431020,RS,Sul,BUTANTAN/SINOVAC,25479,12885,12594
Ijuí,431020,RS,Sul,FIOCRUZ/ASTRAZENECA,22473,20093,2380
Ijuí,431020,RS,Sul,PFIZER/BIONTECH,1857,1853,4
Ilha Comprida,352042,SP,Sudeste,FIOCRUZ/ASTRAZENECA,3738,3589,149
Ilha Comprida,352042,SP,Sudeste,BUTANTAN/SINOVAC,3601,1962,1639
Ilha Comprida,352042,SP,Sudeste,PFIZER/BIONTECH,350,344,6
Ilha Das Flores,280270,SE,Nordeste,FIOCRUZ/ASTRAZENECA,1708,1613,95
Ilha Das Flores,280270,SE,Nordeste,BUTANTAN/SINOVAC,1320,670,650
Ilha Das Flores,280270,SE,Nordeste,PFIZER/BIONTECH,92,92,0
Ilha De Itamaracá,260760,PE,Nordeste,BUTANTAN/SINOVAC,3591,1814,1777
Ilha De Itamaracá,260760,PE,Nordeste,FIOCRUZ/ASTRAZENECA,2408,2256,152
Ilha De Itamaracá,260760,PE,Nordeste,PFIZER/BIONTECH,59,59,0
Ilha Grande,220465,PI,Nordeste,FIOCRUZ/ASTRAZENECA,1474,1371,103
Ilha Grande,220465,PI,Nordeste,BUTANTAN/SINOVAC,1282,673,609
Ilha Grande,220465,PI,Nordeste,PFIZER/BIONTECH,112,112,0
Ilha Solteira,352044,SP,Sudeste,BUTANTAN/SINOVAC,8827,4765,4062
Ilha Solteira,352044,SP,Sudeste,FIOCRUZ/ASTRAZENECA,7794,7255,539
Ilha Solteira,352044,SP,Sudeste,PFIZER/BIONTECH,592,592,0
Ilhabela,352040,SP,Sudeste,BUTANTAN/SINOVAC,7714,4321,3393
Ilhabela,352040,SP,Sudeste,FIOCRUZ/ASTRAZENECA,7066,6586,480
Ilhabela,352040,SP,Sudeste,PFIZER/BIONTECH,737,737,0
Ilhéus,291360,BA,Nordeste,BUTANTAN/SINOVAC,33127,18651,14476
Ilhéus,291360,BA,Nordeste,FIOCRUZ/ASTRAZENECA,18036,16832,1204
Ilhéus,291360,BA,Nordeste,PFIZER/BIONTECH,50,50,0
Ilhota,420710,SC,Sul,BUTANTAN/SINOVAC,2021,1091,930
Ilhota,420710,SC,Sul,FIOCRUZ/ASTRAZENECA,1609,1563,46
Ilicínea,313050,MG,Sudeste,FIOCRUZ/ASTRAZENECA,2474,2281,193
Ilicínea,313050,MG,Sudeste,BUTANTAN/SINOVAC,2299,1160,1139
Ilicínea,313050,MG,Sudeste,PFIZER/BIONTECH,97,97,0
Ilópolis,431030,RS,Sul,BUTANTAN/SINOVAC,1747,881,866
Ilópolis,431030,RS,Sul,FIOCRUZ/ASTRAZENECA,1249,1101,148
Ilópolis,431030,RS,Sul,PFIZER/BIONTECH,80,78,2
Imaculada,250670,PB,Nordeste,BUTANTAN/SINOVAC,2376,1277,1099
Imaculada,250670,PB,Nordeste,FIOCRUZ/ASTRAZENECA,1295,1185,110
Imaculada,250670,PB,Nordeste,PFIZER/BIONTECH,56,56,0
Imaruí,420720,SC,Sul,FIOCRUZ/ASTRAZENECA,3756,3272,484
Imaruí,420720,SC,Sul,BUTANTAN/SINOVAC,2889,1575,1314
Imaruí,420720,SC,Sul,PFIZER/BIONTECH,209,209,0
Imbaú,411007,PR,Sul,FIOCRUZ/ASTRAZENECA,2358,2278,80
Imbaú,411007,PR,Sul,BUTANTAN/SINOVAC,2156,1164,992
Imbé,431033,RS,Sul,BUTANTAN/SINOVAC,8473,5075,3398
Imbé,431033,RS,Sul,FIOCRUZ/ASTRAZENECA,6042,5790,252
Imbé,431033,RS,Sul,PFIZER/BIONTECH,755,754,1
Imbé De Minas,313055,MG,Sudeste,BUTANTAN/SINOVAC,256,132,124
Imbé De Minas,313055,MG,Sudeste,FIOCRUZ/ASTRAZENECA,159,106,53
Imbituba,420730,SC,Sul,BUTANTAN/SINOVAC,9275,4893,4382
Imbituba,420730,SC,Sul,FIOCRUZ/ASTRAZENECA,6038,5825,213
Imbituva,411010,PR,Sul,BUTANTAN/SINOVAC,5956,3046,2910
Imbituva,411010,PR,Sul,FIOCRUZ/ASTRAZENECA,5534,5290,244
Imbituva,411010,PR,Sul,PFIZER/BIONTECH,82,82,0
Imbuia,420740,SC,Sul,FIOCRUZ/ASTRAZENECA,1468,1323,145
Imbuia,420740,SC,Sul,BUTANTAN/SINOVAC,1046,565,481
Imbuia,420740,SC,Sul,PFIZER/BIONTECH,183,183,0
Imigrante,431036,RS,Sul,BUTANTAN/SINOVAC,997,539,458
Imigrante,431036,RS,Sul,FIOCRUZ/ASTRAZENECA,718,642,76
Imigrante,431036,RS,Sul,PFIZER/BIONTECH,65,65,0
Imperatriz,210530,MA,Nordeste,FIOCRUZ/ASTRAZENECA,54928,50143,4785
Imperatriz,210530,MA,Nordeste,BUTANTAN/SINOVAC,37818,20740,17078
Imperatriz,210530,MA,Nordeste,PFIZER/BIONTECH,3787,3785,2
Inácio Martins,411020,PR,Sul,FIOCRUZ/ASTRAZENECA,2708,2586,122
Inácio Martins,411020,PR,Sul,BUTANTAN/SINOVAC,1923,1046,877
Inácio Martins,411020,PR,Sul,PFIZER/BIONTECH,60,60,0
Inaciolândia,520993,GO,Centro-Oeste,FIOCRUZ/ASTRAZENECA,1726,1617,109
Inaciolândia,520993,GO,Centro-Oeste,BUTANTAN/SINOVAC,1108,570,538
Inaciolândia,520993,GO,Centro-Oeste,PFIZER/BIONTECH,86,86,0
Inajá,260700,PE,Nordeste,BUTANTAN/SINOVAC,3581,1848,1733
Inajá,260700,PE,Nordeste,FIOCRUZ/ASTRAZENECA,3092,2828,264
Inajá,260700,PE,Nordeste,PFIZER/BIONTECH,273,273,0
Inajá,411030,PR,Sul,FIOCRUZ/ASTRAZENECA,897,834,63
Inajá,411030,PR,Sul,BUTANTAN/SINOVAC,782,409,373
Inajá,411030,PR,Sul,PFIZER/BIONTECH,18,18,0
Inconfidentes,313060,MG,Sudeste,BUTANTAN/SINOVAC,1527,765,762
Inconfidentes,313060,MG,Sudeste,FIOCRUZ/ASTRAZENECA,514,473,41
Indaiabira,313065,MG,Sudeste,BUTANTAN/SINOVAC,1595,811,784
Indaiabira,313065,MG,Sudeste,FIOCRUZ/ASTRAZENECA,1226,1134,92
Indaiabira,313065,MG,Sudeste,PFIZER/BIONTECH,12,12,0
Indaial,420750,SC,Sul,BUTANTAN/SINOVAC,16256,8631,7625
Indaial,420750,SC,Sul,FIOCRUZ/ASTRAZENECA,13388,13028,360
Indaial,420750,SC,Sul,PFIZER/BIONTECH,944,937,7
Indaial,420750,SC,Sul,-,436,370,66
Indaiatuba,352050,SP,Sudeste,FIOCRUZ/ASTRAZENECA,51975,48621,3354
Indaiatuba,352050,SP,Sudeste,BUTANTAN/SINOVAC,50110,28117,21993
Indaiatuba,352050,SP,Sudeste,PFIZER/BIONTECH,5063,5063,0
Independência,230560,CE,Nordeste,BUTANTAN/SINOVAC,4895,2876,2019
Independência,230560,CE,Nordeste,FIOCRUZ/ASTRAZENECA,1921,1676,245
Independência,431040,RS,Sul,BUTANTAN/SINOVAC,1950,982,968
Independência,431040,RS,Sul,FIOCRUZ/ASTRAZENECA,1861,1713,148
Independência,431040,RS,Sul,PFIZER/BIONTECH,231,231,0
Indiana,352060,SP,Sudeste,BUTANTAN/SINOVAC,1803,1058,745
Indiana,352060,SP,Sudeste,FIOCRUZ/ASTRAZENECA,1271,1136,135
Indiana,352060,SP,Sudeste,PFIZER/BIONTECH,149,149,0
Indianópolis,313070,MG,Sudeste,FIOCRUZ/ASTRAZENECA,1235,1125,110
Indianópolis,313070,MG,Sudeste,BUTANTAN/SINOVAC,1101,574,527
Indianópolis,313070,MG,Sudeste,PFIZER/BIONTECH,104,104,0
Indianópolis,411040,PR,Sul,FIOCRUZ/ASTRAZENECA,1552,1476,76
Indianópolis,411040,PR,Sul,BUTANTAN/SINOVAC,1255,655,600
Indianópolis,411040,PR,Sul,PFIZER/BIONTECH,20,20,0
Indiaporã,352070,SP,Sudeste,BUTANTAN/SINOVAC,1653,915,738
Indiaporã,352070,SP,Sudeste,FIOCRUZ/ASTRAZENECA,1090,954,136
Indiaporã,352070,SP,Sudeste,PFIZER/BIONTECH,238,238,0
Indiara,520995,GO,Centro-Oeste,FIOCRUZ/ASTRAZENECA,3509,3317,192
Indiara,520995,GO,Centro-Oeste,BUTANTAN/SINOVAC,2251,1158,1093
Indiara,520995,GO,Centro-Oeste,PFIZER/BIONTECH,171,171,0
Indiaroba,280280,SE,Nordeste,BUTANTAN/SINOVAC,2476,1266,1210
Indiaroba,280280,SE,Nordeste,FIOCRUZ/ASTRAZENECA,2324,2204,120
Indiaroba,280280,SE,Nordeste,PFIZER/BIONTECH,67,67,0
Indiavaí,510450,MT,Centro-Oeste,FIOCRUZ/ASTRAZENECA,702,671,31
Indiavaí,510450,MT,Centro-Oeste,BUTANTAN/SINOVAC,630,331,299
Indiavaí,510450,MT,Centro-Oeste,PFIZER/BIONTECH,64,64,0
Ingá,250680,PB,Nordeste,BUTANTAN/SINOVAC,4991,2543,2448
Ingá,250680,PB,Nordeste,FIOCRUZ/ASTRAZENECA,4518,4201,317
Ingá,250680,PB,Nordeste,PFIZER/BIONTECH,510,510,0
Ingaí,313080,MG,Sudeste,BUTANTAN/SINOVAC,702,361,341
Ingaí,313080,MG,Sudeste,FIOCRUZ/ASTRAZENECA,660,600,60
Ingaí,313080,MG,Sudeste,PFIZER/BIONTECH,37,37,0
Ingazeira,260710,PE,Nordeste,FIOCRUZ/ASTRAZENECA,1238,1129,109
Ingazeira,260710,PE,Nordeste,BUTANTAN/SINOVAC,1102,574,528
Ingazeira,260710,PE,Nordeste,PFIZER/BIONTECH,164,164,0
Inhacorá,431041,RS,Sul,FIOCRUZ/ASTRAZENECA,608,554,54
Inhacorá,431041,RS,Sul,BUTANTAN/SINOVAC,578,297,281
Inhacorá,431041,RS,Sul,PFIZER/BIONTECH,125,125,0
Inhambupe,291370,BA,Nordeste,FIOCRUZ/ASTRAZENECA,5824,5350,474
Inhambupe,291370,BA,Nordeste,BUTANTAN/SINOVAC,5612,3020,2592
Inhambupe,291370,BA,Nordeste,PFIZER/BIONTECH,331,331,0
Inhangapi,150340,PA,Norte,BUTANTAN/SINOVAC,4426,2264,2162
Inhangapi,150340,PA,Norte,FIOCRUZ/ASTRAZENECA,1847,1630,217
Inhapi,270330,AL,Nordeste,BUTANTAN/SINOVAC,3241,1655,1586
Inhapi,270330,AL,Nordeste,FIOCRUZ/ASTRAZENECA,3168,2871,297
Inhapim,313090,MG,Sudeste,BUTANTAN/SINOVAC,4701,2431,2270
Inhapim,313090,MG,Sudeste,FIOCRUZ/ASTRAZENECA,3479,3214,265
Inhapim,313090,MG,Sudeste,PFIZER/BIONTECH,181,181,0
Inhaúma,313100,MG,Sudeste,BUTANTAN/SINOVAC,1250,676,574
Inhaúma,313100,MG,Sudeste,FIOCRUZ/ASTRAZENECA,997,895,102
Inhaúma,313100,MG,Sudeste,PFIZER/BIONTECH,6,6,0
Inhuma,220470,PI,Nordeste,FIOCRUZ/ASTRAZENECA,3164,2803,361
Inhuma,220470,PI,Nordeste,BUTANTAN/SINOVAC,2582,1326,1256
Inhuma,220470,PI,Nordeste,PFIZER/BIONTECH,203,203,0
Inhumas,521000,GO,Centro-Oeste,FIOCRUZ/ASTRAZENECA,14364,13251,1113
Inhumas,521000,GO,Centro-Oeste,BUTANTAN/SINOVAC,10671,5605,5066
Inhumas,521000,GO,Centro-Oeste,PFIZER/BIONTECH,550,549,1
Inimutaba,313110,MG,Sudeste,BUTANTAN/SINOVAC,1589,811,778
Inimutaba,313110,MG,Sudeste,FIOCRUZ/ASTRAZENECA,1438,1310,128
Inimutaba,313110,MG,Sudeste,PFIZER/BIONTECH,123,123,0
Inocência,500440,MS,Centro-Oeste,BUTANTAN/SINOVAC,2262,1193,1069
Inocência,500440,MS,Centro-Oeste,FIOCRUZ/ASTRAZENECA,1928,1693,235
Inocência,500440,MS,Centro-Oeste,PFIZER/BIONTECH,305,305,0
Inúbia Paulista,352080,SP,Sudeste,BUTANTAN/SINOVAC,1049,584,465
Inúbia Paulista,352080,SP,Sudeste,FIOCRUZ/ASTRAZENECA,910,810,100
Inúbia Paulista,352080,SP,Sudeste,PFIZER/BIONTECH,121,121,0
Iomerê,420757,SC,Sul,BUTANTAN/SINOVAC,909,462,447
Iomerê,420757,SC,Sul,FIOCRUZ/ASTRAZENECA,792,689,103
Iomerê,420757,SC,Sul,PFIZER/BIONTECH,97,97,0
Ipaba,313115,MG,Sudeste,BUTANTAN/SINOVAC,2682,1367,1315
Ipaba,313115,MG,Sudeste,FIOCRUZ/ASTRAZENECA,1645,1415,230
Ipaba,313115,MG,Sudeste,PFIZER/BIONTECH,3,3,0
Ipameri,521010,GO,Centro-Oeste,FIOCRUZ/ASTRAZENECA,8450,7571,879
Ipameri,521010,GO,Centro-Oeste,BUTANTAN/SINOVAC,4245,2288,1957
Ipanema,313120,MG,Sudeste,BUTANTAN/SINOVAC,5098,2686,2412
Ipanema,313120,MG,Sudeste,FIOCRUZ/ASTRAZENECA,3741,3482,259
Ipanema,313120,MG,Sudeste,PFIZER/BIONTECH,470,470,0
Ipanguaçu,240470,RN,Nordeste,FIOCRUZ/ASTRAZENECA,3251,2719,532
Ipanguaçu,240470,RN,Nordeste,BUTANTAN/SINOVAC,2176,1151,1025
Ipanguaçu,240470,RN,Nordeste,PFIZER/BIONTECH,149,149,0
Ipaporanga,230565,CE,Nordeste,BUTANTAN/SINOVAC,2671,1353,1318
Ipaporanga,230565,CE,Nordeste,FIOCRUZ/ASTRAZENECA,1353,1064,289
Ipaporanga,230565,CE,Nordeste,PFIZER/BIONTECH,5,5,0
Ipatinga,313130,MG,Sudeste,BUTANTAN/SINOVAC,50327,25507,24820
Ipatinga,313130,MG,Sudeste,FIOCRUZ/ASTRAZENECA,37737,34712,3025
Ipatinga,313130,MG,Sudeste,PFIZER/BIONTECH,926,926,0
Ipaumirim,230570,CE,Nordeste,BUTANTAN/SINOVAC,1594,856,738
Ipaumirim,230570,CE,Nordeste,FIOCRUZ/ASTRAZENECA,827,717,110
Ipaussu,352090,SP,Sudeste,FIOCRUZ/ASTRAZENECA,3283,3038,245
Ipaussu,352090,SP,Sudeste,BUTANTAN/SINOVAC,3186,1783,1403
Ipaussu,352090,SP,Sudeste,PFIZER/BIONTECH,390,390,0
Ipê,431043,RS,Sul,FIOCRUZ/ASTRAZENECA,2009,1777,232
Ipê,431043,RS,Sul,BUTANTAN/SINOVAC,1970,990,980
Ipê,431043,RS,Sul,PFIZER/BIONTECH,219,216,3
Ipecaetá,291380,BA,Nordeste,BUTANTAN/SINOVAC,3313,1690,1623
Ipecaetá,291380,BA,Nordeste,FIOCRUZ/ASTRAZENECA,2513,2311,202
Ipecaetá,291380,BA,Nordeste,PFIZER/BIONTECH,284,284,0
Iperó,352100,SP,Sudeste,FIOCRUZ/ASTRAZENECA,5892,5588,304
Iperó,352100,SP,Sudeste,BUTANTAN/SINOVAC,5321,2932,2389
Iperó,352100,SP,Sudeste,PFIZER/BIONTECH,217,216,1
Ipeúna,352110,SP,Sudeste,FIOCRUZ/ASTRAZENECA,1551,1464,87
Ipeúna,352110,SP,Sudeste,BUTANTAN/SINOVAC,1142,668,474
Ipeúna,352110,SP,Sudeste,PFIZER/BIONTECH,88,88,0
Ipiaçu,313140,MG,Sudeste,BUTANTAN/SINOVAC,1701,902,799
Ipiaçu,313140,MG,Sudeste,FIOCRUZ/ASTRAZENECA,509,415,94
Ipiaú,291390,BA,Nordeste,BUTANTAN/SINOVAC,8809,4772,4037
Ipiaú,291390,BA,Nordeste,FIOCRUZ/ASTRAZENECA,6240,5497,743
Ipiaú,291390,BA,Nordeste,PFIZER/BIONTECH,115,115,0
Ipiguá,352115,SP,Sudeste,BUTANTAN/SINOVAC,1547,904,643
Ipiguá,352115,SP,Sudeste,FIOCRUZ/ASTRAZENECA,1335,1237,98
Ipiguá,352115,SP,Sudeste,PFIZER/BIONTECH,205,205,0
Ipira,420760,SC,Sul,FIOCRUZ/ASTRAZENECA,1327,1172,155
Ipira,420760,SC,Sul,BUTANTAN/SINOVAC,1295,650,645
Ipira,420760,SC,Sul,PFIZER/BIONTECH,60,60,0
Ipirá,291400,BA,Nordeste,BUTANTAN/SINOVAC,11616,6579,5037
Ipirá,291400,BA,Nordeste,FIOCRUZ/ASTRAZENECA,6536,6072,464
Ipirá,291400,BA,Nordeste,PFIZER/BIONTECH,523,519,4
Ipiranga,411050,PR,Sul,FIOCRUZ/ASTRAZENECA,4400,4246,154
Ipiranga,411050,PR,Sul,BUTANTAN/SINOVAC,2053,1011,1042
Ipiranga,411050,PR,Sul,PFIZER/BIONTECH,651,618,33
Ipiranga De Goiás,521015,GO,Centro-Oeste,FIOCRUZ/ASTRAZENECA,981,919,62
Ipiranga De Goiás,521015,GO,Centro-Oeste,BUTANTAN/SINOVAC,571,312,259
Ipiranga Do Norte,510452,MT,Centro-Oeste,FIOCRUZ/ASTRAZENECA,769,708,61
Ipiranga Do Norte,510452,MT,Centro-Oeste,BUTANTAN/SINOVAC,714,382,332
Ipiranga Do Norte,510452,MT,Centro-Oeste,PFIZER/BIONTECH,109,109,0
Ipiranga Do Piauí,220480,PI,Nordeste,FIOCRUZ/ASTRAZENECA,2315,2015,300
Ipiranga Do Piauí,220480,PI,Nordeste,BUTANTAN/SINOVAC,1656,853,803
Ipiranga Do Piauí,220480,PI,Nordeste,PFIZER/BIONTECH,199,199,0
Ipiranga Do Sul,431046,RS,Sul,BUTANTAN/SINOVAC,781,395,386
Ipiranga Do Sul,431046,RS,Sul,FIOCRUZ/ASTRAZENECA,672,612,60
Ipiranga Do Sul,431046,RS,Sul,PFIZER/BIONTECH,101,100,1
Ipixuna,130180,AM,Norte,FIOCRUZ/ASTRAZENECA,2614,2220,394
Ipixuna,130180,AM,Norte,BUTANTAN/SINOVAC,1453,825,628
Ipixuna Do Pará,150345,PA,Norte,FIOCRUZ/ASTRAZENECA,4406,3205,1201
Ipixuna Do Pará,150345,PA,Norte,BUTANTAN/SINOVAC,3405,1820,1585
Ipojuca,260720,PE,Nordeste,FIOCRUZ/ASTRAZENECA,15016,14650,366
Ipojuca,260720,PE,Nordeste,BUTANTAN/SINOVAC,10717,6408,4309
Ipojuca,260720,PE,Nordeste,PFIZER/BIONTECH,1789,1787,2
Iporá,521020,GO,Centro-Oeste,FIOCRUZ/ASTRAZENECA,10491,9425,1066
Iporá,521020,GO,Centro-Oeste,BUTANTAN/SINOVAC,8841,4522,4319
Iporá,521020,GO,Centro-Oeste,PFIZER/BIONTECH,1327,1327,0
Iporã,411060,PR,Sul,BUTANTAN/SINOVAC,3641,1917,1724
Iporã,411060,PR,Sul,FIOCRUZ/ASTRAZENECA,3585,3389,196
Iporã,411060,PR,Sul,PFIZER/BIONTECH,454,454,0
Iporã Do Oeste,420765,SC,Sul,FIOCRUZ/ASTRAZENECA,2883,2672,211
Iporã Do Oeste,420765,SC,Sul,BUTANTAN/SINOVAC,2275,1227,1048
Iporã Do Oeste,420765,SC,Sul,PFIZER/BIONTECH,120,120,0
Iporanga,352120,SP,Sudeste,BUTANTAN/SINOVAC,1471,746,725
Iporanga,352120,SP,Sudeste,FIOCRUZ/ASTRAZENECA,1077,1031,46
Iporanga,352120,SP,Sudeste,PFIZER/BIONTECH,130,130,0
Ipu,230580,CE,Nordeste,BUTANTAN/SINOVAC,7278,3878,3400
Ipu,230580,CE,Nordeste,FIOCRUZ/ASTRAZENECA,6484,5854,630
Ipu,230580,CE,Nordeste,PFIZER/BIONTECH,24,24,0
Ipuã,352130,SP,Sudeste,FIOCRUZ/ASTRAZENECA,3512,3283,229
Ipuã,352130,SP,Sudeste,BUTANTAN/SINOVAC,3089,1652,1437
Ipuã,352130,SP,Sudeste,PFIZER/BIONTECH,278,278,0
Ipuaçu,420768,SC,Sul,BUTANTAN/SINOVAC,1136,574,562
Ipuaçu,420768,SC,Sul,FIOCRUZ/ASTRAZENECA,1102,971,131
Ipuaçu,420768,SC,Sul,PFIZER/BIONTECH,84,84,0
Ipubi,260730,PE,Nordeste,FIOCRUZ/ASTRAZENECA,4705,4346,359
Ipubi,260730,PE,Nordeste,BUTANTAN/SINOVAC,4170,2151,2019
Ipubi,260730,PE,Nordeste,PFIZER/BIONTECH,455,455,0
Ipueira,240480,RN,Nordeste,BUTANTAN/SINOVAC,819,448,371
Ipueira,240480,RN,Nordeste,FIOCRUZ/ASTRAZENECA,610,579,31
Ipueira,240480,RN,Nordeste,PFIZER/BIONTECH,84,84,0
Ipueiras,170980,TO,Norte,BUTANTAN/SINOVAC,441,227,214
Ipueiras,170980,TO,Norte,FIOCRUZ/ASTRAZENECA,326,296,30
Ipueiras,230590,CE,Nordeste,BUTANTAN/SINOVAC,5581,2926,2655
Ipueiras,230590,CE,Nordeste,FIOCRUZ/ASTRAZENECA,4717,3538,1179
Ipuiúna,313150,MG,Sudeste,BUTANTAN/SINOVAC,1519,988,531
Ipuiúna,313150,MG,Sudeste,FIOCRUZ/ASTRAZENECA,531,516,15
Ipuiúna,313150,MG,Sudeste,PFIZER/BIONTECH,9,9,0
Ipumirim,420770,SC,Sul,BUTANTAN/SINOVAC,1887,989,898
Ipumirim,420770,SC,Sul,FIOCRUZ/ASTRAZENECA,1853,1676,177
Ipumirim,420770,SC,Sul,PFIZER/BIONTECH,192,192,0
Ipupiara,291410,BA,Nordeste,BUTANTAN/SINOVAC,2340,1230,1110
Ipupiara,291410,BA,Nordeste,FIOCRUZ/ASTRAZENECA,2147,2075,72
Iracema,140028,RR,Norte,BUTANTAN/SINOVAC,1791,947,844
Iracema,140028,RR,Norte,FIOCRUZ/ASTRAZENECA,852,851,1
Iracema,230600,CE,Nordeste,BUTANTAN/SINOVAC,3608,1869,1739
Iracema,230600,CE,Nordeste,FIOCRUZ/ASTRAZENECA,1846,1625,221
Iracema Do Oeste,411065,PR,Sul,FIOCRUZ/ASTRAZENECA,782,731,51
Iracema Do Oeste,411065,PR,Sul,BUTANTAN/SINOVAC,631,341,290
Iracema Do Oeste,411065,PR,Sul,PFIZER/BIONTECH,11,11,0
Iracemápolis,352140,SP,Sudeste,FIOCRUZ/ASTRAZENECA,4762,4452,310
Iracemápolis,352140,SP,Sudeste,BUTANTAN/SINOVAC,4750,2456,2294
Iracemápolis,352140,SP,Sudeste,PFIZER/BIONTECH,301,301,0
Iraceminha,420775,SC,Sul,BUTANTAN/SINOVAC,1223,636,587
Iraceminha,420775,SC,Sul,FIOCRUZ/ASTRAZENECA,1199,1093,106
Iraceminha,420775,SC,Sul,PFIZER/BIONTECH,30,30,0
Iraí,431050,RS,Sul,BUTANTAN/SINOVAC,2661,1338,1323
Iraí,431050,RS,Sul,FIOCRUZ/ASTRAZENECA,1863,1691,172
Iraí,431050,RS,Sul,PFIZER/BIONTECH,203,203,0
Iraí De Minas,313160,MG,Sudeste,BUTANTAN/SINOVAC,1253,632,621
Iraí De Minas,313160,MG,Sudeste,FIOCRUZ/ASTRAZENECA,1081,959,122
Iraí De Minas,313160,MG,Sudeste,PFIZER/BIONTECH,185,185,0
Irajuba,291420,BA,Nordeste,FIOCRUZ/ASTRAZENECA,1303,1245,58
Irajuba,291420,BA,Nordeste,BUTANTAN/SINOVAC,1227,653,574
Irajuba,291420,BA,Nordeste,PFIZER/BIONTECH,10,10,0
Iramaia,291430,BA,Nordeste,FIOCRUZ/ASTRAZENECA,1932,1821,111
Iramaia,291430,BA,Nordeste,BUTANTAN/SINOVAC,1514,819,695
Iramaia,291430,BA,Nordeste,PFIZER/BIONTECH,51,51,0
Iranduba,130185,AM,Norte,FIOCRUZ/ASTRAZENECA,21507,19647,1860
Iranduba,130185,AM,Norte,BUTANTAN/SINOVAC,4941,2739,2202
Irani,420780,SC,Sul,FIOCRUZ/ASTRAZENECA,2541,2362,179
Irani,420780,SC,Sul,BUTANTAN/SINOVAC,2040,1101,939
Irani,420780,SC,Sul,PFIZER/BIONTECH,187,187,0
Irapuã,352150,SP,Sudeste,BUTANTAN/SINOVAC,3120,1584,1536
Irapuã,352150,SP,Sudeste,FIOCRUZ/ASTRAZENECA,2661,2466,195
Irapuã,352150,SP,Sudeste,PFIZER/BIONTECH,151,150,1
Irapuru,352160,SP,Sudeste,BUTANTAN/SINOVAC,2165,1198,967
Irapuru,352160,SP,Sudeste,FIOCRUZ/ASTRAZENECA,2000,1806,194
Irapuru,352160,SP,Sudeste,PFIZER/BIONTECH,132,132,0
Iraquara,291440,BA,Nordeste,FIOCRUZ/ASTRAZENECA,4597,4179,418
Iraquara,291440,BA,Nordeste,BUTANTAN/SINOVAC,3696,1919,1777
Iraquara,291440,BA,Nordeste,PFIZER/BIONTECH,54,54,0
Irará,291450,BA,Nordeste,FIOCRUZ/ASTRAZENECA,6398,5906,492
Irará,291450,BA,Nordeste,BUTANTAN/SINOVAC,5799,3048,2751
Irará,291450,BA,Nordeste,PFIZER/BIONTECH,634,633,1
Irati,411070,PR,Sul,FIOCRUZ/ASTRAZENECA,13803,13023,780
Irati,411070,PR,Sul,BUTANTAN/SINOVAC,11988,6176,5812
Irati,411070,PR,Sul,PFIZER/BIONTECH,1714,1714,0
Irati,420785,SC,Sul,BUTANTAN/SINOVAC,1178,615,563
Irati,420785,SC,Sul,FIOCRUZ/ASTRAZENECA,908,830,78
Irati,420785,SC,Sul,PFIZER/BIONTECH,82,82,0
Irauçuba,230610,CE,Nordeste,BUTANTAN/SINOVAC,5955,3288,2667
Irauçuba,230610,CE,Nordeste,FIOCRUZ/ASTRAZENECA,1542,1195,347
Irauçuba,230610,CE,Nordeste,PFIZER/BIONTECH,6,6,0
Irecê,291460,BA,Nordeste,BUTANTAN/SINOVAC,13207,6905,6302
Irecê,291460,BA,Nordeste,FIOCRUZ/ASTRAZENECA,10018,9309,709
Iretama,411080,PR,Sul,FIOCRUZ/ASTRAZENECA,2812,2625,187
Iretama,411080,PR,Sul,BUTANTAN/SINOVAC,2484,1268,1216
Iretama,411080,PR,Sul,PFIZER/BIONTECH,98,98,0
Irineópolis,420790,SC,Sul,FIOCRUZ/ASTRAZENECA,2250,2069,181
Irineópolis,420790,SC,Sul,BUTANTAN/SINOVAC,1865,989,876
Irineópolis,420790,SC,Sul,PFIZER/BIONTECH,126,126,0
Irituia,150350,PA,Norte,BUTANTAN/SINOVAC,7940,4418,3522
Irituia,150350,PA,Norte,FIOCRUZ/ASTRAZENECA,7324,6702,622
Irupi,320265,ES,Sudeste,BUTANTAN/SINOVAC,3765,2036,1729
Irupi,320265,ES,Sudeste,FIOCRUZ/ASTRAZENECA,2120,2045,75
Irupi,320265,ES,Sudeste,PFIZER/BIONTECH,183,183,0
Isaías Coelho,220490,PI,Nordeste,FIOCRUZ/ASTRAZENECA,2214,2110,104
Isaías Coelho,220490,PI,Nordeste,BUTANTAN/SINOVAC,1467,740,727
Israelândia,521030,GO,Centro-Oeste,FIOCRUZ/ASTRAZENECA,679,631,48
Israelândia,521030,GO,Centro-Oeste,BUTANTAN/SINOVAC,578,326,252
Itá,420800,SC,Sul,BUTANTAN/SINOVAC,1628,873,755
Itá,420800,SC,Sul,FIOCRUZ/ASTRAZENECA,1611,1451,160
Itá,420800,SC,Sul,PFIZER/BIONTECH,174,174,0
Itaara,431053,RS,Sul,FIOCRUZ/ASTRAZENECA,1460,1336,124
Itaara,431053,RS,Sul,BUTANTAN/SINOVAC,1307,662,645
Itaara,431053,RS,Sul,PFIZER/BIONTECH,218,218,0
Itabaiana,250690,PB,Nordeste,BUTANTAN/SINOVAC,6502,3330,3172
Itabaiana,250690,PB,Nordeste,FIOCRUZ/ASTRAZENECA,5184,4669,515
Itabaiana,250690,PB,Nordeste,PFIZER/BIONTECH,921,920,1
Itabaiana,280290,SE,Nordeste,FIOCRUZ/ASTRAZENECA,19855,18958,897
Itabaiana,280290,SE,Nordeste,BUTANTAN/SINOVAC,13969,7314,6655
Itabaiana,280290,SE,Nordeste,PFIZER/BIONTECH,2764,2762,2
Itabaianinha,280300,SE,Nordeste,FIOCRUZ/ASTRAZENECA,7784,7136,648
Itabaianinha,280300,SE,Nordeste,BUTANTAN/SINOVAC,6039,3149,2890
Itabaianinha,280300,SE,Nordeste,PFIZER/BIONTECH,833,833,0
Itabela,291465,BA,Nordeste,BUTANTAN/SINOVAC,3708,1954,1754
Itabela,291465,BA,Nordeste,FIOCRUZ/ASTRAZENECA,3587,3000,587
Itabela,291465,BA,Nordeste,PFIZER/BIONTECH,194,193,1
Itaberá,352170,SP,Sudeste,FIOCRUZ/ASTRAZENECA,4404,4069,335
Itaberá,352170,SP,Sudeste,BUTANTAN/SINOVAC,4178,2275,1903
Itaberá,352170,SP,Sudeste,PFIZER/BIONTECH,630,629,1
Itaberaba,291470,BA,Nordeste,FIOCRUZ/ASTRAZENECA,11627,10707,920
Itaberaba,291470,BA,Nordeste,BUTANTAN/SINOVAC,11384,5743,5641
Itaberaba,291470,BA,Nordeste,PFIZER/BIONTECH,152,152,0
Itaberaí,521040,GO,Centro-Oeste,FIOCRUZ/ASTRAZENECA,9170,8530,640
Itaberaí,521040,GO,Centro-Oeste,BUTANTAN/SINOVAC,7443,4128,3315
Itaberaí,521040,GO,Centro-Oeste,PFIZER/BIONTECH,627,627,0
Itabi,280310,SE,Nordeste,BUTANTAN/SINOVAC,1343,687,656
Itabi,280310,SE,Nordeste,FIOCRUZ/ASTRAZENECA,897,897,0
Itabi,280310,SE,Nordeste,PFIZER/BIONTECH,129,128,1
Itabira,313170,MG,Sudeste,BUTANTAN/SINOVAC,22835,11343,11492
Itabira,313170,MG,Sudeste,FIOCRUZ/ASTRAZENECA,16998,15474,1524
Itabira,313170,MG,Sudeste,PFIZER/BIONTECH,1231,1231,0
Itabirinha,313180,MG,Sudeste,FIOCRUZ/ASTRAZENECA,2923,2645,278
Itabirinha,313180,MG,Sudeste,BUTANTAN/SINOVAC,2514,1313,1201
Itabirinha,313180,MG,Sudeste,PFIZER/BIONTECH,289,289,0
Itabirito,313190,MG,Sudeste,FIOCRUZ/ASTRAZENECA,9933,9029,904
Itabirito,313190,MG,Sudeste,BUTANTAN/SINOVAC,9728,5087,4641
Itabirito,313190,MG,Sudeste,PFIZER/BIONTECH,2138,2138,0
Itaboraí,330190,RJ,Sudeste,BUTANTAN/SINOVAC,45432,23802,21630
Itaboraí,330190,RJ,Sudeste,FIOCRUZ/ASTRAZENECA,26212,24241,1971
Itaboraí,330190,RJ,Sudeste,PFIZER/BIONTECH,25,25,0
Itabuna,291480,BA,Nordeste,BUTANTAN/SINOVAC,35603,21067,14536
Itabuna,291480,BA,Nordeste,FIOCRUZ/ASTRAZENECA,31622,27786,3836
Itacajá,171050,TO,Norte,BUTANTAN/SINOVAC,2101,1122,979
Itacajá,171050,TO,Norte,FIOCRUZ/ASTRAZENECA,971,891,80
Itacambira,313200,MG,Sudeste,BUTANTAN/SINOVAC,979,482,497
Itacambira,313200,MG,Sudeste,FIOCRUZ/ASTRAZENECA,831,775,56
Itacambira,313200,MG,Sudeste,PFIZER/BIONTECH,57,57,0
Itacarambi,313210,MG,Sudeste,BUTANTAN/SINOVAC,2859,1456,1403
Itacarambi,313210,MG,Sudeste,FIOCRUZ/ASTRAZENECA,2329,2056,273
Itacarambi,313210,MG,Sudeste,PFIZER/BIONTECH,59,59,0
Itacaré,291490,BA,Nordeste,FIOCRUZ/ASTRAZENECA,2674,2520,154
Itacaré,291490,BA,Nordeste,BUTANTAN/SINOVAC,2399,1410,989
Itacaré,291490,BA,Nordeste,PFIZER/BIONTECH,60,60,0
Itacoatiara,130190,AM,Norte,FIOCRUZ/ASTRAZENECA,20127,16893,3234
Itacoatiara,130190,AM,Norte,BUTANTAN/SINOVAC,11116,6188,4928
Itacuruba,260740,PE,Nordeste,FIOCRUZ/ASTRAZENECA,2036,1951,85
Itacuruba,260740,PE,Nordeste,BUTANTAN/SINOVAC,1044,534,510
Itacuruba,260740,PE,Nordeste,PFIZER/BIONTECH,185,185,0
Itacurubi,431055,RS,Sul,BUTANTAN/SINOVAC,985,501,484
Itacurubi,431055,RS,Sul,FIOCRUZ/ASTRAZENECA,879,813,66
Itacurubi,431055,RS,Sul,PFIZER/BIONTECH,121,121,0
Itaeté,291500,BA,Nordeste,BUTANTAN/SINOVAC,576,531,45
Itaeté,291500,BA,Nordeste,FIOCRUZ/ASTRAZENECA,167,166,1
Itagi,291510,BA,Nordeste,BUTANTAN/SINOVAC,3108,1596,1512
Itagi,291510,BA,Nordeste,FIOCRUZ/ASTRAZENECA,2940,2532,408
Itagi,291510,BA,Nordeste,PFIZER/BIONTECH,326,326,0
Itagibá,291520,BA,Nordeste,FIOCRUZ/ASTRAZENECA,2910,2763,147
Itagibá,291520,BA,Nordeste,BUTANTAN/SINOVAC,2324,1384,940
Itagibá,291520,BA,Nordeste,PFIZER/BIONTECH,86,86,0
Itagimirim,291530,BA,Nordeste,FIOCRUZ/ASTRAZENECA,1514,1277,237
Itagimirim,291530,BA,Nordeste,BUTANTAN/SINOVAC,1507,786,721
Itagimirim,291530,BA,Nordeste,PFIZER/BIONTECH,12,12,0
Itaguaçu,320270,ES,Sudeste,BUTANTAN/SINOVAC,4819,2446,2373
Itaguaçu,320270,ES,Sudeste,FIOCRUZ/ASTRAZENECA,3031,2826,205
Itaguaçu,320270,ES,Sudeste,PFIZER/BIONTECH,624,624,0
Itaguaçu Da Bahia,291535,BA,Nordeste,FIOCRUZ/ASTRAZENECA,4021,3824,197
Itaguaçu Da Bahia,291535,BA,Nordeste,BUTANTAN/SINOVAC,1966,1044,922
Itaguaçu Da Bahia,291535,BA,Nordeste,PFIZER/BIONTECH,136,136,0
Itaguaí,330200,RJ,Sudeste,FIOCRUZ/ASTRAZENECA,24757,22942,1815
Itaguaí,330200,RJ,Sudeste,BUTANTAN/SINOVAC,20752,11488,9264
Itaguaí,330200,RJ,Sudeste,PFIZER/BIONTECH,2343,2341,2
Itaguajé,411090,PR,Sul,FIOCRUZ/ASTRAZENECA,1201,1152,49
Itaguajé,411090,PR,Sul,BUTANTAN/SINOVAC,1015,531,484
Itaguara,313220,MG,Sudeste,FIOCRUZ/ASTRAZENECA,3282,3012,270
Itaguara,313220,MG,Sudeste,BUTANTAN/SINOVAC,3106,1595,1511
Itaguara,313220,MG,Sudeste,PFIZER/BIONTECH,161,161,0
Itaguari,521056,GO,Centro-Oeste,FIOCRUZ/ASTRAZENECA,1449,1371,78
Itaguari,521056,GO,Centro-Oeste,BUTANTAN/SINOVAC,982,500,482
Itaguari,521056,GO,Centro-Oeste,PFIZER/BIONTECH,55,55,0
Itaguaru,521060,GO,Centro-Oeste,FIOCRUZ/ASTRAZENECA,1853,1627,226
Itaguaru,521060,GO,Centro-Oeste,BUTANTAN/SINOVAC,1148,578,570
Itaguaru,521060,GO,Centro-Oeste,PFIZER/BIONTECH,13,13,0
Itaguatins,171070,TO,Norte,BUTANTAN/SINOVAC,1127,595,532
Itaguatins,171070,TO,Norte,FIOCRUZ/ASTRAZENECA,936,907,29
Itaguatins,171070,TO,Norte,PFIZER/BIONTECH,6,6,0
Itaí,352180,SP,Sudeste,FIOCRUZ/ASTRAZENECA,6179,5835,344
Itaí,352180,SP,Sudeste,BUTANTAN/SINOVAC,5428,3335,2093
Itaí,352180,SP,Sudeste,PFIZER/BIONTECH,659,659,0
Itaíba,260750,PE,Nordeste,FIOCRUZ/ASTRAZENECA,9065,8017,1048
Itaíba,260750,PE,Nordeste,BUTANTAN/SINOVAC,4206,2178,2028
Itaíba,260750,PE,Nordeste,PFIZER/BIONTECH,851,851,0
Itaiçaba,230620,CE,Nordeste,BUTANTAN/SINOVAC,1890,964,926
Itaiçaba,230620,CE,Nordeste,FIOCRUZ/ASTRAZENECA,1729,1538,191
Itaiçaba,230620,CE,Nordeste,PFIZER/BIONTECH,108,108,0
Itainópolis,220500,PI,Nordeste,BUTANTAN/SINOVAC,2277,1183,1094
Itainópolis,220500,PI,Nordeste,FIOCRUZ/ASTRAZENECA,2148,1965,183
Itaiópolis,420810,SC,Sul,FIOCRUZ/ASTRAZENECA,4508,4123,385
Itaiópolis,420810,SC,Sul,BUTANTAN/SINOVAC,3658,1968,1690
Itaiópolis,420810,SC,Sul,PFIZER/BIONTECH,374,374,0
Itaipava Do Grajaú,210535,MA,Nordeste,FIOCRUZ/ASTRAZENECA,1861,1638,223
Itaipava Do Grajaú,210535,MA,Nordeste,BUTANTAN/SINOVAC,1734,933,801
Itaipé,313230,MG,Sudeste,BUTANTAN/SINOVAC,1917,979,938
Itaipé,313230,MG,Sudeste,FIOCRUZ/ASTRAZENECA,1635,1524,111
Itaipé,313230,MG,Sudeste,PFIZER/BIONTECH,80,80,0
Itaipulândia,411095,PR,Sul,BUTANTAN/SINOVAC,2935,1532,1403
Itaipulândia,411095,PR,Sul,FIOCRUZ/ASTRAZENECA,2172,1997,175
Itaipulândia,411095,PR,Sul,PFIZER/BIONTECH,157,157,0
Itaitinga,230625,CE,Nordeste,FIOCRUZ/ASTRAZENECA,8711,8296,415
Itaitinga,230625,CE,Nordeste,BUTANTAN/SINOVAC,4808,2642,2166
Itaitinga,230625,CE,Nordeste,PFIZER/BIONTECH,78,78,0
Itaituba,150360,PA,Norte,FIOCRUZ/ASTRAZENECA,18139,14588,3551
Itaituba,150360,PA,Norte,BUTANTAN/SINOVAC,5699,3206,2493
Itajá,240485,RN,Nordeste,BUTANTAN/SINOVAC,1597,852,745
Itajá,240485,RN,Nordeste,FIOCRUZ/ASTRAZENECA,1439,1389,50
Itajá,240485,RN,Nordeste,PFIZER/BIONTECH,231,231,0
Itajá,521080,GO,Centro-Oeste,FIOCRUZ/ASTRAZENECA,1594,1503,91
Itajá,521080,GO,Centro-Oeste,BUTANTAN/SINOVAC,1133,577,556
Itajaí,420820,SC,Sul,BUTANTAN/SINOVAC,34539,17512,17027
Itajaí,420820,SC,Sul,FIOCRUZ/ASTRAZENECA,28844,27463,1381
Itajaí,420820,SC,Sul,PFIZER/BIONTECH,4084,4084,0
Itajobi,352190,SP,Sudeste,BUTANTAN/SINOVAC,4605,2576,2029
Itajobi,352190,SP,Sudeste,FIOCRUZ/ASTRAZENECA,3988,3608,380
Itajobi,352190,SP,Sudeste,PFIZER/BIONTECH,547,545,2
Itaju,352200,SP,Sudeste,BUTANTAN/SINOVAC,1309,711,598
Itaju,352200,SP,Sudeste,FIOCRUZ/ASTRAZENECA,1010,927,83
Itaju,352200,SP,Sudeste,PFIZER/BIONTECH,86,86,0
Itaju Do Colônia,291540,BA,Nordeste,BUTANTAN/SINOVAC,2232,1260,972
Itaju Do Colônia,291540,BA,Nordeste,FIOCRUZ/ASTRAZENECA,1085,996,89
Itaju Do Colônia,291540,BA,Nordeste,PFIZER/BIONTECH,1,1,0
Itajubá,313240,MG,Sudeste,BUTANTAN/SINOVAC,21000,10945,10055
Itajubá,313240,MG,Sudeste,FIOCRUZ/ASTRAZENECA,16413,14661,1752
Itajubá,313240,MG,Sudeste,PFIZER/BIONTECH,1607,1603,4
Itajuípe,291550,BA,Nordeste,BUTANTAN/SINOVAC,4271,2249,2022
Itajuípe,291550,BA,Nordeste,FIOCRUZ/ASTRAZENECA,3970,3722,248
Itajuípe,291550,BA,Nordeste,PFIZER/BIONTECH,8,8,0
Italva,330205,RJ,Sudeste,BUTANTAN/SINOVAC,2918,1637,1281
Italva,330205,RJ,Sudeste,FIOCRUZ/ASTRAZENECA,2670,2398,272
Itamaraju,291560,BA,Nordeste,BUTANTAN/SINOVAC,7767,5726,2041
Itamaraju,291560,BA,Nordeste,FIOCRUZ/ASTRAZENECA,5767,5498,269
Itamaraju,291560,BA,Nordeste,PFIZER/BIONTECH,40,40,0
Itamarandiba,313250,MG,Sudeste,BUTANTAN/SINOVAC,6045,3340,2705
Itamarandiba,313250,MG,Sudeste,FIOCRUZ/ASTRAZENECA,6034,5603,431
Itamarandiba,313250,MG,Sudeste,PFIZER/BIONTECH,850,850,0
Itamarati,130195,AM,Norte,FIOCRUZ/ASTRAZENECA,1392,1294,98
Itamarati,130195,AM,Norte,BUTANTAN/SINOVAC,636,322,314
Itamarati De Minas,313260,MG,Sudeste,BUTANTAN/SINOVAC,1056,543,513
Itamarati De Minas,313260,MG,Sudeste,FIOCRUZ/ASTRAZENECA,903,844,59
Itamarati De Minas,313260,MG,Sudeste,PFIZER/BIONTECH,36,36,0
Itamari,291570,BA,Nordeste,BUTANTAN/SINOVAC,1072,687,385
Itamari,291570,BA,Nordeste,FIOCRUZ/ASTRAZENECA,580,542,38
Itambacuri,313270,MG,Sudeste,BUTANTAN/SINOVAC,5186,2623,2563
Itambacuri,313270,MG,Sudeste,FIOCRUZ/ASTRAZENECA,4039,3634,405
Itambacuri,313270,MG,Sudeste,PFIZER/BIONTECH,324,324,0
Itambaracá,411100,PR,Sul,FIOCRUZ/ASTRAZENECA,2170,2055,115
Itambaracá,411100,PR,Sul,BUTANTAN/SINOVAC,1782,913,869
Itambaracá,411100,PR,Sul,PFIZER/BIONTECH,31,31,0
Itambé,260765,PE,Nordeste,FIOCRUZ/ASTRAZENECA,6002,5584,418
Itambé,260765,PE,Nordeste,BUTANTAN/SINOVAC,5301,2762,2539
Itambé,260765,PE,Nordeste,PFIZER/BIONTECH,210,210,0
Itambé,291580,BA,Nordeste,BUTANTAN/SINOVAC,5684,2919,2765
Itambé,291580,BA,Nordeste,FIOCRUZ/ASTRAZENECA,4797,4411,386
Itambé,291580,BA,Nordeste,PFIZER/BIONTECH,87,86,1
Itambé,411110,PR,Sul,FIOCRUZ/ASTRAZENECA,1696,1588,108
Itambé,411110,PR,Sul,BUTANTAN/SINOVAC,1431,735,696
Itambé,411110,PR,Sul,PFIZER/BIONTECH,27,27,0
Itambé Do Mato Dentro,313280,MG,Sudeste,BUTANTAN/SINOVAC,641,337,304
Itambé Do Mato Dentro,313280,MG,Sudeste,FIOCRUZ/ASTRAZENECA,560,513,47
Itambé Do Mato Dentro,313280,MG,Sudeste,PFIZER/BIONTECH,54,54,0
Itamogi,313290,MG,Sudeste,BUTANTAN/SINOVAC,2579,1317,1262
Itamogi,313290,MG,Sudeste,FIOCRUZ/ASTRAZENECA,2513,2313,200
Itamogi,313290,MG,Sudeste,PFIZER/BIONTECH,58,58,0
Itamonte,313300,MG,Sudeste,FIOCRUZ/ASTRAZENECA,1492,1475,17
Itamonte,313300,MG,Sudeste,BUTANTAN/SINOVAC,907,562,345
Itamonte,313300,MG,Sudeste,PFIZER/BIONTECH,77,77,0
Itanagra,291590,BA,Nordeste,BUTANTAN/SINOVAC,859,439,420
Itanagra,291590,BA,Nordeste,FIOCRUZ/ASTRAZENECA,834,822,12
Itanhaém,352210,SP,Sudeste,BUTANTAN/SINOVAC,26501,15182,11319
Itanhaém,352210,SP,Sudeste,FIOCRUZ/ASTRAZENECA,18724,17364,1360
Itanhaém,352210,SP,Sudeste,PFIZER/BIONTECH,1287,1286,1
Itanhandu,313310,MG,Sudeste,BUTANTAN/SINOVAC,3235,1617,1618
Itanhandu,313310,MG,Sudeste,FIOCRUZ/ASTRAZENECA,3096,2797,299
Itanhandu,313310,MG,Sudeste,PFIZER/BIONTECH,302,302,0
Itanhangá,510454,MT,Centro-Oeste,BUTANTAN/SINOVAC,1188,611,577
Itanhangá,510454,MT,Centro-Oeste,FIOCRUZ/ASTRAZENECA,1098,1078,20
Itanhangá,510454,MT,Centro-Oeste,PFIZER/BIONTECH,62,62,0
Itanhém,291600,BA,Nordeste,BUTANTAN/SINOVAC,4350,2423,1927
Itanhém,291600,BA,Nordeste,FIOCRUZ/ASTRAZENECA,4074,3660,414
Itanhém,291600,BA,Nordeste,PFIZER/BIONTECH,50,50,0
Itanhomi,313320,MG,Sudeste,FIOCRUZ/ASTRAZENECA,3014,2788,226
Itanhomi,313320,MG,Sudeste,BUTANTAN/SINOVAC,2828,1453,1375
Itanhomi,313320,MG,Sudeste,PFIZER/BIONTECH,149,149,0
Itaobim,313330,MG,Sudeste,BUTANTAN/SINOVAC,4802,2499,2303
Itaobim,313330,MG,Sudeste,FIOCRUZ/ASTRAZENECA,2998,2796,202
Itaobim,313330,MG,Sudeste,PFIZER/BIONTECH,29,29,0
Itaoca,352215,SP,Sudeste,BUTANTAN/SINOVAC,1460,775,685
Itaoca,352215,SP,Sudeste,FIOCRUZ/ASTRAZENECA,854,767,87
Itaoca,352215,SP,Sudeste,PFIZER/BIONTECH,97,96,1
Itaocara,330210,RJ,Sudeste,BUTANTAN/SINOVAC,6182,3301,2881
Itaocara,330210,RJ,Sudeste,FIOCRUZ/ASTRAZENECA,5101,4647,454
Itaocara,330210,RJ,Sudeste,PFIZER/BIONTECH,403,403,0
Itapaci,521090,GO,Centro-Oeste,FIOCRUZ/ASTRAZENECA,6949,6467,482
Itapaci,521090,GO,Centro-Oeste,BUTANTAN/SINOVAC,3608,1938,1670
Itapagé,230630,CE,Nordeste,BUTANTAN/SINOVAC,4485,3113,1372
Itapagé,230630,CE,Nordeste,FIOCRUZ/ASTRAZENECA,2145,2061,84
Itapagipe,313340,MG,Sudeste,FIOCRUZ/ASTRAZENECA,3248,2967,281
Itapagipe,313340,MG,Sudeste,BUTANTAN/SINOVAC,3006,1572,1434
Itapagipe,313340,MG,Sudeste,PFIZER/BIONTECH,525,525,0
Itaparica,291610,BA,Nordeste,FIOCRUZ/ASTRAZENECA,3964,3526,438
Itaparica,291610,BA,Nordeste,BUTANTAN/SINOVAC,3297,1870,1427
Itaparica,291610,BA,Nordeste,PFIZER/BIONTECH,1151,1150,1
Itapé,291620,BA,Nordeste,FIOCRUZ/ASTRAZENECA,2157,1989,168
Itapé,291620,BA,Nordeste,BUTANTAN/SINOVAC,2151,1135,1016
Itapé,291620,BA,Nordeste,PFIZER/BIONTECH,6,6,0
Itapebi,291630,BA,Nordeste,BUTANTAN/SINOVAC,1951,1058,893
Itapebi,291630,BA,Nordeste,FIOCRUZ/ASTRAZENECA,1776,1656,120
Itapebi,291630,BA,Nordeste,PFIZER/BIONTECH,158,158,0
Itapecerica,313350,MG,Sudeste,BUTANTAN/SINOVAC,5904,3084,2820
Itapecerica,313350,MG,Sudeste,FIOCRUZ/ASTRAZENECA,5821,5365,456
Itapecerica,313350,MG,Sudeste,PFIZER/BIONTECH,219,218,1
Itapecerica Da Serra,352220,SP,Sudeste,FIOCRUZ/ASTRAZENECA,33174,31333,1841
Itapecerica Da Serra,352220,SP,Sudeste,BUTANTAN/SINOVAC,24210,12899,11311
Itapecerica Da Serra,352220,SP,Sudeste,PFIZER/BIONTECH,1256,1255,1
Itapecuru Mirim,210540,MA,Nordeste,FIOCRUZ/ASTRAZENECA,18625,15529,3096
Itapecuru Mirim,210540,MA,Nordeste,BUTANTAN/SINOVAC,8271,4398,3873
Itapecuru Mirim,210540,MA,Nordeste,PFIZER/BIONTECH,313,303,10
Itapejara D'Oeste,411120,PR,Sul,FIOCRUZ/ASTRAZENECA,3680,3502,178
Itapejara D'Oeste,411120,PR,Sul,BUTANTAN/SINOVAC,2625,1339,1286
Itapejara D'Oeste,411120,PR,Sul,PFIZER/BIONTECH,153,153,0
Itapema,420830,SC,Sul,FIOCRUZ/ASTRAZENECA,16004,15377,627
Itapema,420830,SC,Sul,BUTANTAN/SINOVAC,14101,8185,5916
Itapema,420830,SC,Sul,PFIZER/BIONTECH,1633,1633,0
Itapemirim,320280,ES,Sudeste,BUTANTAN/SINOVAC,9452,5142,4310
Itapemirim,320280,ES,Sudeste,FIOCRUZ/ASTRAZENECA,8345,7896,449
Itapemirim,320280,ES,Sudeste,PFIZER/BIONTECH,864,864,0
Itaperuçu,411125,PR,Sul,FIOCRUZ/ASTRAZENECA,4731,4556,175
Itaperuçu,411125,PR,Sul,BUTANTAN/SINOVAC,3842,2052,1790
Itaperuçu,411125,PR,Sul,PFIZER/BIONTECH,301,299,2
Itaperuna,330220,RJ,Sudeste,FIOCRUZ/ASTRAZENECA,18025,17026,999
Itaperuna,330220,RJ,Sudeste,BUTANTAN/SINOVAC,12292,8818,3474
Itaperuna,330220,RJ,Sudeste,PFIZER/BIONTECH,1822,1822,0
Itapetim,260770,PE,Nordeste,FIOCRUZ/ASTRAZENECA,4007,3617,390
Itapetim,260770,PE,Nordeste,BUTANTAN/SINOVAC,2991,1520,1471
Itapetim,260770,PE,Nordeste,PFIZER/BIONTECH,472,472,0
Itapetinga,291640,BA,Nordeste,FIOCRUZ/ASTRAZENECA,12521,11406,1115
Itapetinga,291640,BA,Nordeste,BUTANTAN/SINOVAC,10436,5211,5225
Itapetinga,291640,BA,Nordeste,PFIZER/BIONTECH,515,515,0
Itapetininga,352230,SP,Sudeste,BUTANTAN/SINOVAC,60991,32853,28138
Itapetininga,352230,SP,Sudeste,FIOCRUZ/ASTRAZENECA,51115,47725,3390
Itapetininga,352230,SP,Sudeste,PFIZER/BIONTECH,3577,3571,6
Itapeva,313360,MG,Sudeste,BUTANTAN/SINOVAC,1895,976,919
Itapeva,313360,MG,Sudeste,FIOCRUZ/ASTRAZENECA,1381,1266,115
Itapeva,313360,MG,Sudeste,PFIZER/BIONTECH,66,66,0
Itapeva,352240,SP,Sudeste,FIOCRUZ/ASTRAZENECA,21207,19793,1414
Itapeva,352240,SP,Sudeste,BUTANTAN/SINOVAC,20763,11550,9213
Itapeva,352240,SP,Sudeste,PFIZER/BIONTECH,1524,1524,0
Itapevi,352250,SP,Sudeste,FIOCRUZ/ASTRAZENECA,35042,33067,1975
Itapevi,352250,SP,Sudeste,BUTANTAN/SINOVAC,27892,14788,13104
Itapevi,352250,SP,Sudeste,PFIZER/BIONTECH,447,446,1
Itapicuru,291650,BA,Nordeste,BUTANTAN/SINOVAC,4012,2702,1310
Itapicuru,291650,BA,Nordeste,FIOCRUZ/ASTRAZENECA,2929,2814,115
Itapipoca,230640,CE,Nordeste,BUTANTAN/SINOVAC,13284,7279,6005
Itapipoca,230640,CE,Nordeste,FIOCRUZ/ASTRAZENECA,7814,6820,994
Itapipoca,230640,CE,Nordeste,PFIZER/BIONTECH,31,29,2
Itapira,352260,SP,Sudeste,BUTANTAN/SINOVAC,18945,10194,8751
Itapira,352260,SP,Sudeste,FIOCRUZ/ASTRAZENECA,16951,15144,1807
Itapira,352260,SP,Sudeste,PFIZER/BIONTECH,1986,1986,0
Itapiranga,130200,AM,Norte,BUTANTAN/SINOVAC,1581,826,755
Itapiranga,130200,AM,Norte,FIOCRUZ/ASTRAZENECA,1113,800,313
Itapiranga,420840,SC,Sul,FIOCRUZ/ASTRAZENECA,3924,3698,226
Itapiranga,420840,SC,Sul,BUTANTAN/SINOVAC,3117,1669,1448
Itapiranga,420840,SC,Sul,PFIZER/BIONTECH,442,442,0
Itapirapuã,521100,GO,Centro-Oeste,FIOCRUZ/ASTRAZENECA,1951,1848,103
Itapirapuã,521100,GO,Centro-Oeste,BUTANTAN/SINOVAC,1225,669,556
Itapirapuã Paulista,352265,SP,Sudeste,BUTANTAN/SINOVAC,864,471,393
Itapirapuã Paulista,352265,SP,Sudeste,FIOCRUZ/ASTRAZENECA,736,687,49
Itapirapuã Paulista,352265,SP,Sudeste,PFIZER/BIONTECH,87,87,0
Itapiratins,171090,TO,Norte,BUTANTAN/SINOVAC,817,430,387
Itapiratins,171090,TO,Norte,FIOCRUZ/ASTRAZENECA,814,779,35
Itapissuma,260775,PE,Nordeste,FIOCRUZ/ASTRAZENECA,3853,3653,200
Itapissuma,260775,PE,Nordeste,BUTANTAN/SINOVAC,3405,1904,1501
Itapissuma,260775,PE,Nordeste,PFIZER/BIONTECH,143,143,0
Itapitanga,291660,BA,Nordeste,FIOCRUZ/ASTRAZENECA,2075,1851,224
Itapitanga,291660,BA,Nordeste,BUTANTAN/SINOVAC,2032,1100,932
Itapitanga,291660,BA,Nordeste,PFIZER/BIONTECH,178,178,0
Itapiúna,230650,CE,Nordeste,BUTANTAN/SINOVAC,2892,1975,917
Itapiúna,230650,CE,Nordeste,FIOCRUZ/ASTRAZENECA,607,555,52
Itapiúna,230650,CE,Nordeste,PFIZER/BIONTECH,8,8,0
Itapoá,420845,SC,Sul,FIOCRUZ/ASTRAZENECA,8180,7219,961
Itapoá,420845,SC,Sul,BUTANTAN/SINOVAC,4427,2265,2162
Itapoá,420845,SC,Sul,PFIZER/BIONTECH,611,610,1
Itápolis,352270,SP,Sudeste,BUTANTAN/SINOVAC,11677,6683,4994
Itápolis,352270,SP,Sudeste,FIOCRUZ/ASTRAZENECA,10623,9845,778
Itápolis,352270,SP,Sudeste,PFIZER/BIONTECH,908,908,0
Itaporã,500450,MS,Centro-Oeste,FIOCRUZ/ASTRAZENECA,5911,4519,1392
Itaporã,500450,MS,Centro-Oeste,BUTANTAN/SINOVAC,5297,2770,2527
Itaporã,500450,MS,Centro-Oeste,PFIZER/BIONTECH,791,789,2
Itaporã Do Tocantins,171110,TO,Norte,BUTANTAN/SINOVAC,489,260,229
Itaporã Do Tocantins,171110,TO,Norte,FIOCRUZ/ASTRAZENECA,414,385,29
Itaporanga,250700,PB,Nordeste,BUTANTAN/SINOVAC,4652,2405,2247
Itaporanga,250700,PB,Nordeste,FIOCRUZ/ASTRAZENECA,4239,3892,347
Itaporanga,250700,PB,Nordeste,PFIZER/BIONTECH,594,594,0
Itaporanga,352280,SP,Sudeste,BUTANTAN/SINOVAC,3673,1974,1699
Itaporanga,352280,SP,Sudeste,FIOCRUZ/ASTRAZENECA,3390,3145,245
Itaporanga,352280,SP,Sudeste,PFIZER/BIONTECH,275,275,0
Itaporanga D'Ajuda,280320,SE,Nordeste,BUTANTAN/SINOVAC,5809,3119,2690
Itaporanga D'Ajuda,280320,SE,Nordeste,FIOCRUZ/ASTRAZENECA,4654,4400,254
Itaporanga D'Ajuda,280320,SE,Nordeste,PFIZER/BIONTECH,571,571,0
Itapororoca,250710,PB,Nordeste,BUTANTAN/SINOVAC,4130,2352,1778
Itapororoca,250710,PB,Nordeste,FIOCRUZ/ASTRAZENECA,1343,1224,119
Itapororoca,250710,PB,Nordeste,PFIZER/BIONTECH,46,46,0
Itapuã Do Oeste,110110,RO,Norte,BUTANTAN/SINOVAC,2771,1440,1331
Itapuã Do Oeste,110110,RO,Norte,FIOCRUZ/ASTRAZENECA,2557,2468,89
Itapuã Do Oeste,110110,RO,Norte,PFIZER/BIONTECH,241,241,0
Itapuca,431057,RS,Sul,BUTANTAN/SINOVAC,552,277,275
Itapuca,431057,RS,Sul,FIOCRUZ/ASTRAZENECA,490,447,43
Itapuca,431057,RS,Sul,PFIZER/BIONTECH,95,95,0
Itapuí,352290,SP,Sudeste,FIOCRUZ/ASTRAZENECA,2998,2763,235
Itapuí,352290,SP,Sudeste,BUTANTAN/SINOVAC,2635,1449,1186
Itapuí,352290,SP,Sudeste,PFIZER/BIONTECH,336,336,0
Itapura,352300,SP,Sudeste,BUTANTAN/SINOVAC,1570,924,646
Itapura,352300,SP,Sudeste,FIOCRUZ/ASTRAZENECA,1291,1190,101
Itapura,352300,SP,Sudeste,PFIZER/BIONTECH,69,69,0
Itapuranga,521120,GO,Centro-Oeste,FIOCRUZ/ASTRAZENECA,8676,8194,482
Itapuranga,521120,GO,Centro-Oeste,BUTANTAN/SINOVAC,5612,2924,2688
Itaquaquecetuba,352310,SP,Sudeste,FIOCRUZ/ASTRAZENECA,58777,56325,2452
Itaquaquecetuba,352310,SP,Sudeste,BUTANTAN/SINOVAC,39934,21623,18311
Itaquaquecetuba,352310,SP,Sudeste,PFIZER/BIONTECH,2641,2639,2
Itaquara,291670,BA,Nordeste,BUTANTAN/SINOVAC,1874,1066,808
Itaquara,291670,BA,Nordeste,FIOCRUZ/ASTRAZENECA,1304,1175,129
Itaquara,291670,BA,Nordeste,PFIZER/BIONTECH,17,17,0
Itaqui,431060,RS,Sul,FIOCRUZ/ASTRAZENECA,8891,8387,504
Itaqui,431060,RS,Sul,BUTANTAN/SINOVAC,7739,3976,3763
Itaqui,431060,RS,Sul,PFIZER/BIONTECH,1376,1374,2
Itaquiraí,500460,MS,Centro-Oeste,FIOCRUZ/ASTRAZENECA,4949,4373,576
Itaquiraí,500460,MS,Centro-Oeste,BUTANTAN/SINOVAC,3992,2210,1782
Itaquiraí,500460,MS,Centro-Oeste,PFIZER/BIONTECH,720,713,7
Itaquitinga,260780,PE,Nordeste,FIOCRUZ/ASTRAZENECA,2834,2651,183
Itaquitinga,260780,PE,Nordeste,BUTANTAN/SINOVAC,2350,1195,1155
Itaquitinga,260780,PE,Nordeste,PFIZER/BIONTECH,151,151,0
Itarana,320290,ES,Sudeste,BUTANTAN/SINOVAC,3479,1739,1740
Itarana,320290,ES,Sudeste,FIOCRUZ/ASTRAZENECA,2539,2383,156
Itarana,320290,ES,Sudeste,PFIZER/BIONTECH,151,151,0
Itarantim,291680,BA,Nordeste,BUTANTAN/SINOVAC,3923,2007,1916
Itarantim,291680,BA,Nordeste,FIOCRUZ/ASTRAZENECA,3156,2874,282
Itarantim,291680,BA,Nordeste,PFIZER/BIONTECH,1,1,0
Itararé,352320,SP,Sudeste,FIOCRUZ/ASTRAZENECA,12145,11093,1052
Itararé,352320,SP,Sudeste,BUTANTAN/SINOVAC,10781,5793,4988
Itararé,352320,SP,Sudeste,PFIZER/BIONTECH,1254,1253,1
Itarema,230655,CE,Nordeste,BUTANTAN/SINOVAC,6471,3473,2998
Itarema,230655,CE,Nordeste,FIOCRUZ/ASTRAZENECA,1315,1100,215
Itarema,230655,CE,Nordeste,PFIZER/BIONTECH,214,118,96
Itariri,352330,SP,Sudeste,BUTANTAN/SINOVAC,3492,1898,1594
Itariri,352330,SP,Sudeste,FIOCRUZ/ASTRAZENECA,3341,3098,243
Itariri,352330,SP,Sudeste,PFIZER/BIONTECH,223,221,2
Itarumã,521130,GO,Centro-Oeste,FIOCRUZ/ASTRAZENECA,1437,1330,107
Itarumã,521130,GO,Centro-Oeste,BUTANTAN/SINOVAC,1192,607,585
Itarumã,521130,GO,Centro-Oeste,PFIZER/BIONTECH,92,92,0
Itati,431065,RS,Sul,BUTANTAN/SINOVAC,1081,556,525
Itati,431065,RS,Sul,FIOCRUZ/ASTRAZENECA,925,848,77
Itati,431065,RS,Sul,PFIZER/BIONTECH,116,116,0
Itatiaia,330225,RJ,Sudeste,BUTANTAN/SINOVAC,5439,3565,1874
Itatiaia,330225,RJ,Sudeste,FIOCRUZ/ASTRAZENECA,3187,2949,238
Itatiaiuçu,313370,MG,Sudeste,FIOCRUZ/ASTRAZENECA,1418,1363,55
Itatiaiuçu,313370,MG,Sudeste,BUTANTAN/SINOVAC,1411,753,658
Itatiaiuçu,313370,MG,Sudeste,PFIZER/BIONTECH,105,105,0
Itatiba,352340,SP,Sudeste,FIOCRUZ/ASTRAZENECA,27503,25498,2005
Itatiba,352340,SP,Sudeste,BUTANTAN/SINOVAC,25137,13844,11293
Itatiba,352340,SP,Sudeste,PFIZER/BIONTECH,1835,1834,1
Itatiba Do Sul,431070,RS,Sul,BUTANTAN/SINOVAC,1140,581,559
Itatiba Do Sul,431070,RS,Sul,FIOCRUZ/ASTRAZENECA,1117,988,129
Itatiba Do Sul,431070,RS,Sul,PFIZER/BIONTECH,163,163,0
Itatim,291685,BA,Nordeste,FIOCRUZ/ASTRAZENECA,2767,2455,312
Itatim,291685,BA,Nordeste,BUTANTAN/SINOVAC,2442,1243,1199
Itatim,291685,BA,Nordeste,PFIZER/BIONTECH,359,359,0
Itatinga,352350,SP,Sudeste,FIOCRUZ/ASTRAZENECA,4071,3790,281
Itatinga,352350,SP,Sudeste,BUTANTAN/SINOVAC,3718,2144,1574
Itatinga,352350,SP,Sudeste,PFIZER/BIONTECH,422,422,0
Itatira,230660,CE,Nordeste,BUTANTAN/SINOVAC,3127,1660,1467
Itatira,230660,CE,Nordeste,FIOCRUZ/ASTRAZENECA,2043,1716,327
Itatira,230660,CE,Nordeste,PFIZER/BIONTECH,150,150,0
Itatuba,250720,PB,Nordeste,BUTANTAN/SINOVAC,2530,1284,1246
Itatuba,250720,PB,Nordeste,FIOCRUZ/ASTRAZENECA,1797,1638,159
Itatuba,250720,PB,Nordeste,PFIZER/BIONTECH,218,218,0
Itaú,240490,RN,Nordeste,BUTANTAN/SINOVAC,2200,1112,1088
Itaú,240490,RN,Nordeste,FIOCRUZ/ASTRAZENECA,1685,1606,79
Itaú,240490,RN,Nordeste,PFIZER/BIONTECH,246,246,0
Itaú De Minas,313375,MG,Sudeste,FIOCRUZ/ASTRAZENECA,4134,3900,234
Itaú De Minas,313375,MG,Sudeste,BUTANTAN/SINOVAC,3442,1801,1641
Itaú De Minas,313375,MG,Sudeste,PFIZER/BIONTECH,135,135,0
Itaúba,510455,MT,Centro-Oeste,FIOCRUZ/ASTRAZENECA,1091,940,151
Itaúba,510455,MT,Centro-Oeste,BUTANTAN/SINOVAC,886,463,423
Itaúba,510455,MT,Centro-Oeste,PFIZER/BIONTECH,50,50,0
Itaubal,160025,AP,Norte,BUTANTAN/SINOVAC,769,444,325
Itaubal,160025,AP,Norte,FIOCRUZ/ASTRAZENECA,504,412,92
Itaubal,160025,AP,Norte,PFIZER/BIONTECH,6,6,0
Itauçu,521140,GO,Centro-Oeste,FIOCRUZ/ASTRAZENECA,2390,2302,88
Itauçu,521140,GO,Centro-Oeste,BUTANTAN/SINOVAC,2039,1085,954
Itauçu,521140,GO,Centro-Oeste,PFIZER/BIONTECH,101,101,0
Itaueira,220510,PI,Nordeste,FIOCRUZ/ASTRAZENECA,2102,1947,155
Itaueira,220510,PI,Nordeste,BUTANTAN/SINOVAC,1989,1018,971
Itaueira,220510,PI,Nordeste,PFIZER/BIONTECH,48,48,0
Itaúna,313380,MG,Sudeste,BUTANTAN/SINOVAC,16697,8574,8123
Itaúna,313380,MG,Sudeste,FIOCRUZ/ASTRAZENECA,13245,12002,1243
Itaúna,313380,MG,Sudeste,PFIZER/BIONTECH,927,927,0
Itaúna Do Sul,411130,PR,Sul,FIOCRUZ/ASTRAZENECA,895,823,72
Itaúna Do Sul,411130,PR,Sul,BUTANTAN/SINOVAC,783,418,365
Itaúna Do Sul,411130,PR,Sul,PFIZER/BIONTECH,10,10,0
Itaverava,313390,MG,Sudeste,FIOCRUZ/ASTRAZENECA,1590,1432,158
Itaverava,313390,MG,Sudeste,BUTANTAN/SINOVAC,1121,572,549
Itaverava,313390,MG,Sudeste,PFIZER/BIONTECH,81,81,0
Itinga,313400,MG,Sudeste,BUTANTAN/SINOVAC,3120,1624,1496
Itinga,313400,MG,Sudeste,FIOCRUZ/ASTRAZENECA,2483,2235,248
Itinga,313400,MG,Sudeste,PFIZER/BIONTECH,97,97,0
Itinga Do Maranhão,210542,MA,Nordeste,FIOCRUZ/ASTRAZENECA,4481,4254,227
Itinga Do Maranhão,210542,MA,Nordeste,BUTANTAN/SINOVAC,3265,1705,1560
Itiquira,510460,MT,Centro-Oeste,FIOCRUZ/ASTRAZENECA,2257,2135,122
Itiquira,510460,MT,Centro-Oeste,BUTANTAN/SINOVAC,1721,902,819
Itiquira,510460,MT,Centro-Oeste,PFIZER/BIONTECH,269,269,0
Itirapina,352360,SP,Sudeste,FIOCRUZ/ASTRAZENECA,3459,3172,287
Itirapina,352360,SP,Sudeste,BUTANTAN/SINOVAC,3208,1825,1383
Itirapina,352360,SP,Sudeste,PFIZER/BIONTECH,184,184,0
Itirapuã,352370,SP,Sudeste,BUTANTAN/SINOVAC,1736,931,805
Itirapuã,352370,SP,Sudeste,FIOCRUZ/ASTRAZENECA,1307,1186,121
Itirapuã,352370,SP,Sudeste,PFIZER/BIONTECH,158,158,0
Itiruçu,291690,BA,Nordeste,BUTANTAN/SINOVAC,2559,1371,1188
Itiruçu,291690,BA,Nordeste,FIOCRUZ/ASTRAZENECA,2478,2219,259
Itiruçu,291690,BA,Nordeste,PFIZER/BIONTECH,136,136,0
Itiúba,291700,BA,Nordeste,BUTANTAN/SINOVAC,6563,3457,3106
Itiúba,291700,BA,Nordeste,FIOCRUZ/ASTRAZENECA,5486,5157,329
Itiúba,291700,BA,Nordeste,PFIZER/BIONTECH,92,92,0
Itobi,352380,SP,Sudeste,BUTANTAN/SINOVAC,2014,1077,937
Itobi,352380,SP,Sudeste,FIOCRUZ/ASTRAZENECA,1106,924,182
Itobi,352380,SP,Sudeste,PFIZER/BIONTECH,152,152,0
Itororó,291710,BA,Nordeste,FIOCRUZ/ASTRAZENECA,4517,3913,604
Itororó,291710,BA,Nordeste,BUTANTAN/SINOVAC,3887,2163,1724
Itororó,291710,BA,Nordeste,PFIZER/BIONTECH,186,184,2
Itu,352390,SP,Sudeste,FIOCRUZ/ASTRAZENECA,37883,35188,2695
Itu,352390,SP,Sudeste,BUTANTAN/SINOVAC,35669,19795,15874
Itu,352390,SP,Sudeste,PFIZER/BIONTECH,2120,2119,1
Ituaçu,291720,BA,Nordeste,FIOCRUZ/ASTRAZENECA,4544,4178,366
Ituaçu,291720,BA,Nordeste,BUTANTAN/SINOVAC,4445,2274,2171
Ituaçu,291720,BA,Nordeste,PFIZER/BIONTECH,273,273,0
Ituberá,291730,BA,Nordeste,FIOCRUZ/ASTRAZENECA,4288,4089,199
Ituberá,291730,BA,Nordeste,BUTANTAN/SINOVAC,3525,1872,1653
Ituberá,291730,BA,Nordeste,PFIZER/BIONTECH,29,29,0
Itueta,313410,MG,Sudeste,BUTANTAN/SINOVAC,1461,747,714
Itueta,313410,MG,Sudeste,FIOCRUZ/ASTRAZENECA,981,897,84
Ituiutaba,313420,MG,Sudeste,BUTANTAN/SINOVAC,19210,11456,7754
Ituiutaba,313420,MG,Sudeste,FIOCRUZ/ASTRAZENECA,5294,5260,34
Itumbiara,521150,GO,Centro-Oeste,FIOCRUZ/ASTRAZENECA,25600,22720,2880
Itumbiara,521150,GO,Centro-Oeste,BUTANTAN/SINOVAC,23303,11848,11455
Itumbiara,521150,GO,Centro-Oeste,PFIZER/BIONTECH,2398,2398,0
Itumirim,313430,MG,Sudeste,FIOCRUZ/ASTRAZENECA,1034,934,100
Itumirim,313430,MG,Sudeste,BUTANTAN/SINOVAC,857,429,428
Itumirim,313430,MG,Sudeste,PFIZER/BIONTECH,40,40,0
Itupeva,352400,SP,Sudeste,FIOCRUZ/ASTRAZENECA,10619,9995,624
Itupeva,352400,SP,Sudeste,BUTANTAN/SINOVAC,8229,4204,4025
Itupeva,352400,SP,Sudeste,PFIZER/BIONTECH,836,835,1
Itupiranga,150370,PA,Norte,FIOCRUZ/ASTRAZENECA,4656,4242,414
Itupiranga,150370,PA,Norte,BUTANTAN/SINOVAC,1892,1082,810
Ituporanga,420850,SC,Sul,FIOCRUZ/ASTRAZENECA,5837,5388,449
Ituporanga,420850,SC,Sul,BUTANTAN/SINOVAC,4447,2418,2029
Ituporanga,420850,SC,Sul,PFIZER/BIONTECH,653,653,0
Iturama,313440,MG,Sudeste,FIOCRUZ/ASTRAZENECA,7364,6819,545
Iturama,313440,MG,Sudeste,BUTANTAN/SINOVAC,6638,3445,3193
Iturama,313440,MG,Sudeste,PFIZER/BIONTECH,1163,1163,0
Itutinga,313450,MG,Sudeste,FIOCRUZ/ASTRAZENECA,1089,1020,69
Itutinga,313450,MG,Sudeste,BUTANTAN/SINOVAC,875,456,419
Itutinga,313450,MG,Sudeste,PFIZER/BIONTECH,52,52,0
Ituverava,352410,SP,Sudeste,BUTANTAN/SINOVAC,11713,6538,5175
Ituverava,352410,SP,Sudeste,FIOCRUZ/ASTRAZENECA,10310,9600,710
Ituverava,352410,SP,Sudeste,PFIZER/BIONTECH,441,440,1
Iuiu,291733,BA,Nordeste,FIOCRUZ/ASTRAZENECA,2184,1912,272
Iuiu,291733,BA,Nordeste,BUTANTAN/SINOVAC,1769,939,830
Iuiu,291733,BA,Nordeste,PFIZER/BIONTECH,254,253,1
Iúna,320300,ES,Sudeste,BUTANTAN/SINOVAC,7038,3769,3269
Iúna,320300,ES,Sudeste,FIOCRUZ/ASTRAZENECA,5866,5510,356
Iúna,320300,ES,Sudeste,PFIZER/BIONTECH,949,947,2
Ivaí,411140,PR,Sul,FIOCRUZ/ASTRAZENECA,3599,3455,144
Ivaí,411140,PR,Sul,BUTANTAN/SINOVAC,2284,1194,1090
Ivaí,411140,PR,Sul,PFIZER/BIONTECH,156,156,0
Ivaiporã,411150,PR,Sul,FIOCRUZ/ASTRAZENECA,8964,8328,636
Ivaiporã,411150,PR,Sul,BUTANTAN/SINOVAC,8707,4472,4235
Ivaiporã,411150,PR,Sul,PFIZER/BIONTECH,1069,1069,0
Ivaté,411155,PR,Sul,FIOCRUZ/ASTRAZENECA,1857,1777,80
Ivaté,411155,PR,Sul,BUTANTAN/SINOVAC,1460,770,690
Ivaté,411155,PR,Sul,PFIZER/BIONTECH,87,87,0
Ivatuba,411160,PR,Sul,FIOCRUZ/ASTRAZENECA,733,701,32
Ivatuba,411160,PR,Sul,BUTANTAN/SINOVAC,613,317,296
Ivatuba,411160,PR,Sul,PFIZER/BIONTECH,137,137,0
Ivinhema,500470,MS,Centro-Oeste,FIOCRUZ/ASTRAZENECA,6551,5535,1016
Ivinhema,500470,MS,Centro-Oeste,BUTANTAN/SINOVAC,6019,3116,2903
Ivinhema,500470,MS,Centro-Oeste,PFIZER/BIONTECH,880,880,0
Ivolândia,521160,GO,Centro-Oeste,FIOCRUZ/ASTRAZENECA,870,803,67
Ivolândia,521160,GO,Centro-Oeste,BUTANTAN/SINOVAC,731,374,357
Ivorá,431075,RS,Sul,BUTANTAN/SINOVAC,790,396,394
Ivorá,431075,RS,Sul,FIOCRUZ/ASTRAZENECA,639,566,73
Ivorá,431075,RS,Sul,PFIZER/BIONTECH,71,71,0
Ivoti,431080,RS,Sul,BUTANTAN/SINOVAC,5459,2772,2687
Ivoti,431080,RS,Sul,FIOCRUZ/ASTRAZENECA,5319,5098,221
Ivoti,431080,RS,Sul,PFIZER/BIONTECH,819,819,0
Jaboatão Dos Guararapes,260790,PE,Nordeste,BUTANTAN/SINOVAC,120745,63205,57540
Jaboatão Dos Guararapes,260790,PE,Nordeste,FIOCRUZ/ASTRAZENECA,74375,67081,7294
Jaboatão Dos Guararapes,260790,PE,Nordeste,PFIZER/BIONTECH,13345,13280,65
Jaborá,420860,SC,Sul,FIOCRUZ/ASTRAZENECA,1104,1037,67
Jaborá,420860,SC,Sul,BUTANTAN/SINOVAC,963,555,408
Jaborá,420860,SC,Sul,PFIZER/BIONTECH,122,122,0
Jaborandi,291735,BA,Nordeste,BUTANTAN/SINOVAC,2065,1059,1006
Jaborandi,291735,BA,Nordeste,FIOCRUZ/ASTRAZENECA,1990,1776,214
Jaborandi,291735,BA,Nordeste,PFIZER/BIONTECH,120,120,0
Jaborandi,352420,SP,Sudeste,FIOCRUZ/ASTRAZENECA,2825,2538,287
Jaborandi,352420,SP,Sudeste,BUTANTAN/SINOVAC,2598,1449,1149
Jaborandi,352420,SP,Sudeste,PFIZER/BIONTECH,244,244,0
Jaboti,411170,PR,Sul,FIOCRUZ/ASTRAZENECA,1418,1302,116
Jaboti,411170,PR,Sul,BUTANTAN/SINOVAC,1195,612,583
Jaboti,411170,PR,Sul,PFIZER/BIONTECH,30,30,0
Jaboticaba,431085,RS,Sul,BUTANTAN/SINOVAC,1204,610,594
Jaboticaba,431085,RS,Sul,FIOCRUZ/ASTRAZENECA,1120,998,122
Jaboticaba,431085,RS,Sul,PFIZER/BIONTECH,139,139,0
Jaboticabal,352430,SP,Sudeste,BUTANTAN/SINOVAC,18237,10068,8169
Jaboticabal,352430,SP,Sudeste,FIOCRUZ/ASTRAZENECA,17786,16598,1188
Jaboticabal,352430,SP,Sudeste,PFIZER/BIONTECH,1251,1250,1
Jaboticatubas,313460,MG,Sudeste,BUTANTAN/SINOVAC,4178,2097,2081
Jaboticatubas,313460,MG,Sudeste,FIOCRUZ/ASTRAZENECA,3801,3522,279
Jaboticatubas,313460,MG,Sudeste,PFIZER/BIONTECH,136,136,0
Jaçanã,240500,RN,Nordeste,BUTANTAN/SINOVAC,2079,1051,1028
Jaçanã,240500,RN,Nordeste,FIOCRUZ/ASTRAZENECA,1538,1416,122
Jaçanã,240500,RN,Nordeste,PFIZER/BIONTECH,273,273,0
Jacaraci,291740,BA,Nordeste,BUTANTAN/SINOVAC,4267,2186,2081
Jacaraci,291740,BA,Nordeste,FIOCRUZ/ASTRAZENECA,3166,3079,87
Jacaraci,291740,BA,Nordeste,PFIZER/BIONTECH,185,185,0
Jacaraú,250730,PB,Nordeste,BUTANTAN/SINOVAC,3808,1926,1882
Jacaraú,250730,PB,Nordeste,FIOCRUZ/ASTRAZENECA,2023,1762,261
Jacaraú,250730,PB,Nordeste,PFIZER/BIONTECH,151,151,0
Jacaré Dos Homens,270340,AL,Nordeste,FIOCRUZ/ASTRAZENECA,1897,1727,170
Jacaré Dos Homens,270340,AL,Nordeste,BUTANTAN/SINOVAC,956,482,474
Jacaré Dos Homens,270340,AL,Nordeste,PFIZER/BIONTECH,76,76,0
Jacareacanga,150375,PA,Norte,BUTANTAN/SINOVAC,2342,1745,597
Jacareacanga,150375,PA,Norte,FIOCRUZ/ASTRAZENECA,949,633,316
Jacareí,352440,SP,Sudeste,BUTANTAN/SINOVAC,52260,29315,22945
Jacareí,352440,SP,Sudeste,FIOCRUZ/ASTRAZENECA,48526,44534,3992
Jacareí,352440,SP,Sudeste,PFIZER/BIONTECH,4846,4839,7
Jacarezinho,411180,PR,Sul,FIOCRUZ/ASTRAZENECA,9145,8486,659
Jacarezinho,411180,PR,Sul,BUTANTAN/SINOVAC,8556,4742,3814
Jacarezinho,411180,PR,Sul,PFIZER/BIONTECH,3544,3543,1
Jaci,352450,SP,Sudeste,BUTANTAN/SINOVAC,1913,1048,865
Jaci,352450,SP,Sudeste,FIOCRUZ/ASTRAZENECA,1580,1441,139
Jaci,352450,SP,Sudeste,PFIZER/BIONTECH,131,131,0
Jaciara,510480,MT,Centro-Oeste,FIOCRUZ/ASTRAZENECA,6319,5968,351
Jaciara,510480,MT,Centro-Oeste,BUTANTAN/SINOVAC,5667,2903,2764
Jaciara,510480,MT,Centro-Oeste,PFIZER/BIONTECH,478,478,0
Jacinto,313470,MG,Sudeste,BUTANTAN/SINOVAC,3522,1838,1684
Jacinto,313470,MG,Sudeste,FIOCRUZ/ASTRAZENECA,2142,1927,215
Jacinto,313470,MG,Sudeste,PFIZER/BIONTECH,87,87,0
Jacinto Machado,420870,SC,Sul,FIOCRUZ/ASTRAZENECA,3437,3147,290
Jacinto Machado,420870,SC,Sul,BUTANTAN/SINOVAC,2492,1289,1203
Jacobina,291750,BA,Nordeste,FIOCRUZ/ASTRAZENECA,18225,15083,3142
Jacobina,291750,BA,Nordeste,BUTANTAN/SINOVAC,15882,8369,7513
Jacobina,291750,BA,Nordeste,PFIZER/BIONTECH,988,988,0
Jacobina Do Piauí,220515,PI,Nordeste,FIOCRUZ/ASTRAZENECA,1516,1292,224
Jacobina Do Piauí,220515,PI,Nordeste,BUTANTAN/SINOVAC,990,503,487
Jacobina Do Piauí,220515,PI,Nordeste,PFIZER/BIONTECH,141,141,0
Jacuí,313480,MG,Sudeste,BUTANTAN/SINOVAC,2037,1040,997
Jacuí,313480,MG,Sudeste,FIOCRUZ/ASTRAZENECA,1948,1808,140
Jacuí,313480,MG,Sudeste,PFIZER/BIONTECH,111,111,0
Jacuípe,270350,AL,Nordeste,FIOCRUZ/ASTRAZENECA,1050,981,69
Jacuípe,270350,AL,Nordeste,BUTANTAN/SINOVAC,949,479,470
Jacuizinho,431087,RS,Sul,FIOCRUZ/ASTRAZENECA,974,805,169
Jacuizinho,431087,RS,Sul,BUTANTAN/SINOVAC,719,364,355
Jacuizinho,431087,RS,Sul,PFIZER/BIONTECH,103,103,0
Jacundá,150380,PA,Norte,FIOCRUZ/ASTRAZENECA,7093,6636,457
Jacundá,150380,PA,Norte,BUTANTAN/SINOVAC,2366,1385,981
Jacupiranga,352460,SP,Sudeste,BUTANTAN/SINOVAC,5219,2723,2496
Jacupiranga,352460,SP,Sudeste,FIOCRUZ/ASTRAZENECA,4859,4552,307
Jacupiranga,352460,SP,Sudeste,PFIZER/BIONTECH,390,390,0
Jacutinga,313490,MG,Sudeste,BUTANTAN/SINOVAC,4078,2179,1899
Jacutinga,313490,MG,Sudeste,FIOCRUZ/ASTRAZENECA,1168,963,205
Jacutinga,431090,RS,Sul,BUTANTAN/SINOVAC,1432,717,715
Jacutinga,431090,RS,Sul,FIOCRUZ/ASTRAZENECA,1087,951,136
Jacutinga,431090,RS,Sul,PFIZER/BIONTECH,138,138,0
Jaguapitã,411190,PR,Sul,FIOCRUZ/ASTRAZENECA,3753,3505,248
Jaguapitã,411190,PR,Sul,BUTANTAN/SINOVAC,3079,1602,1477
Jaguapitã,411190,PR,Sul,PFIZER/BIONTECH,120,120,0
Jaguaquara,291760,BA,Nordeste,FIOCRUZ/ASTRAZENECA,9210,8219,991
Jaguaquara,291760,BA,Nordeste,BUTANTAN/SINOVAC,8692,4693,3999
Jaguaquara,291760,BA,Nordeste,PFIZER/BIONTECH,148,148,0
Jaguaraçu,313500,MG,Sudeste,BUTANTAN/SINOVAC,638,360,278
Jaguaraçu,313500,MG,Sudeste,FIOCRUZ/ASTRAZENECA,578,504,74
Jaguaraçu,313500,MG,Sudeste,PFIZER/BIONTECH,18,18,0
Jaguarão,431100,RS,Sul,BUTANTAN/SINOVAC,8180,4399,3781
Jaguarão,431100,RS,Sul,FIOCRUZ/ASTRAZENECA,7142,6513,629
Jaguarão,431100,RS,Sul,PFIZER/BIONTECH,750,747,3
Jaguarari,291770,BA,Nordeste,BUTANTAN/SINOVAC,5538,3211,2327
Jaguarari,291770,BA,Nordeste,FIOCRUZ/ASTRAZENECA,4369,4155,214
Jaguarari,291770,BA,Nordeste,PFIZER/BIONTECH,34,34,0
Jaguaré,320305,ES,Sudeste,BUTANTAN/SINOVAC,5639,2952,2687
Jaguaré,320305,ES,Sudeste,FIOCRUZ/ASTRAZENECA,5626,5467,159
Jaguaré,320305,ES,Sudeste,PFIZER/BIONTECH,874,874,0
Jaguaretama,230670,CE,Nordeste,BUTANTAN/SINOVAC,4152,2126,2026
Jaguaretama,230670,CE,Nordeste,FIOCRUZ/ASTRAZENECA,2217,1860,357
Jaguari,431110,RS,Sul,FIOCRUZ/ASTRAZENECA,4009,3393,616
Jaguari,431110,RS,Sul,BUTANTAN/SINOVAC,3877,1942,1935
Jaguari,431110,RS,Sul,PFIZER/BIONTECH,401,401,0
Jaguariaíva,411200,PR,Sul,FIOCRUZ/ASTRAZENECA,7361,7031,330
Jaguariaíva,411200,PR,Sul,BUTANTAN/SINOVAC,4981,2602,2379
Jaguariaíva,411200,PR,Sul,PFIZER/BIONTECH,43,43,0
Jaguaribara,230680,CE,Nordeste,BUTANTAN/SINOVAC,1382,745,637
Jaguaribara,230680,CE,Nordeste,FIOCRUZ/ASTRAZENECA,291,227,64
Jaguaribe,230690,CE,Nordeste,BUTANTAN/SINOVAC,7027,3589,3438
Jaguaribe,230690,CE,Nordeste,FIOCRUZ/ASTRAZENECA,6136,5453,683
Jaguaribe,230690,CE,Nordeste,PFIZER/BIONTECH,5,5,0
Jaguaripe,291780,BA,Nordeste,BUTANTAN/SINOVAC,1726,1295,431
Jaguaripe,291780,BA,Nordeste,FIOCRUZ/ASTRAZENECA,821,821,0
Jaguaripe,291780,BA,Nordeste,PFIZER/BIONTECH,48,48,0
Jaguariúna,352470,SP,Sudeste,BUTANTAN/SINOVAC,15117,8573,6544
Jaguariúna,352470,SP,Sudeste,FIOCRUZ/ASTRAZENECA,5858,5712,146
Jaguariúna,352470,SP,Sudeste,PFIZER/BIONTECH,35,35,0
Jaguaruana,230700,CE,Nordeste,BUTANTAN/SINOVAC,4201,1967,2234
Jaguaruana,230700,CE,Nordeste,FIOCRUZ/ASTRAZENECA,2695,2330,365
Jaguaruna,420880,SC,Sul,FIOCRUZ/ASTRAZENECA,4708,4393,315
Jaguaruna,420880,SC,Sul,BUTANTAN/SINOVAC,4562,2421,2141
Jaguaruna,420880,SC,Sul,PFIZER/BIONTECH,156,156,0
Jaíba,313505,MG,Sudeste,FIOCRUZ/ASTRAZENECA,4414,4088,326
Jaíba,313505,MG,Sudeste,BUTANTAN/SINOVAC,4156,2412,1744
Jaíba,313505,MG,Sudeste,PFIZER/BIONTECH,605,605,0
Jaicós,220520,PI,Nordeste,FIOCRUZ/ASTRAZENECA,4307,4056,251
Jaicós,220520,PI,Nordeste,BUTANTAN/SINOVAC,3534,1854,1680
Jaicós,220520,PI,Nordeste,PFIZER/BIONTECH,471,471,0
Jales,352480,SP,Sudeste,BUTANTAN/SINOVAC,16087,9991,6096
Jales,352480,SP,Sudeste,FIOCRUZ/ASTRAZENECA,12754,11452,1302
Jales,352480,SP,Sudeste,PFIZER/BIONTECH,1117,1115,2
Jambeiro,352490,SP,Sudeste,FIOCRUZ/ASTRAZENECA,1397,1294,103
Jambeiro,352490,SP,Sudeste,BUTANTAN/SINOVAC,1387,711,676
Jambeiro,352490,SP,Sudeste,PFIZER/BIONTECH,24,24,0
Jampruca,313507,MG,Sudeste,BUTANTAN/SINOVAC,965,552,413
Jampruca,313507,MG,Sudeste,FIOCRUZ/ASTRAZENECA,571,512,59
Jampruca,313507,MG,Sudeste,PFIZER/BIONTECH,47,47,0
Janaúba,313510,MG,Sudeste,BUTANTAN/SINOVAC,6839,3913,2926
Janaúba,313510,MG,Sudeste,FIOCRUZ/ASTRAZENECA,5491,5090,401
Janaúba,313510,MG,Sudeste,PFIZER/BIONTECH,472,470,2
Jandaia,521170,GO,Centro-Oeste,FIOCRUZ/ASTRAZENECA,2000,1893,107
Jandaia,521170,GO,Centro-Oeste,BUTANTAN/SINOVAC,1471,841,630
Jandaia Do Sul,411210,PR,Sul,FIOCRUZ/ASTRAZENECA,6327,5940,387
Jandaia Do Sul,411210,PR,Sul,BUTANTAN/SINOVAC,5815,3006,2809
Jandaia Do Sul,411210,PR,Sul,PFIZER/BIONTECH,785,785,0
Jandaíra,240510,RN,Nordeste,BUTANTAN/SINOVAC,1415,725,690
Jandaíra,240510,RN,Nordeste,FIOCRUZ/ASTRAZENECA,1159,1100,59
Jandaíra,240510,RN,Nordeste,PFIZER/BIONTECH,104,104,0
Jandaíra,291790,BA,Nordeste,BUTANTAN/SINOVAC,1103,683,420
Jandaíra,291790,BA,Nordeste,FIOCRUZ/ASTRAZENECA,855,819,36
Jandaíra,291790,BA,Nordeste,PFIZER/BIONTECH,38,38,0
Jandira,352500,SP,Sudeste,FIOCRUZ/ASTRAZENECA,18816,18353,463
Jandira,352500,SP,Sudeste,BUTANTAN/SINOVAC,15308,8859,6449
Jandira,352500,SP,Sudeste,PFIZER/BIONTECH,1745,1739,6
Janduís,240520,RN,Nordeste,FIOCRUZ/ASTRAZENECA,2382,2248,134
Janduís,240520,RN,Nordeste,BUTANTAN/SINOVAC,2330,1147,1183
Janduís,240520,RN,Nordeste,PFIZER/BIONTECH,316,315,1
Jangada,510490,MT,Centro-Oeste,BUTANTAN/SINOVAC,1693,871,822
Jangada,510490,MT,Centro-Oeste,FIOCRUZ/ASTRAZENECA,1467,1355,112
Jangada,510490,MT,Centro-Oeste,PFIZER/BIONTECH,14,14,0
Janiópolis,411220,PR,Sul,FIOCRUZ/ASTRAZENECA,1858,1725,133
Janiópolis,411220,PR,Sul,BUTANTAN/SINOVAC,1539,794,745
Janiópolis,411220,PR,Sul,PFIZER/BIONTECH,29,29,0
Januária,313520,MG,Sudeste,BUTANTAN/SINOVAC,8525,4348,4177
Januária,313520,MG,Sudeste,FIOCRUZ/ASTRAZENECA,7126,6800,326
Januária,313520,MG,Sudeste,PFIZER/BIONTECH,357,357,0
Januário Cicco,240530,RN,Nordeste,BUTANTAN/SINOVAC,1628,841,787
Januário Cicco,240530,RN,Nordeste,FIOCRUZ/ASTRAZENECA,1169,1054,115
Januário Cicco,240530,RN,Nordeste,PFIZER/BIONTECH,159,159,0
Japaraíba,313530,MG,Sudeste,FIOCRUZ/ASTRAZENECA,1167,1104,63
Japaraíba,313530,MG,Sudeste,BUTANTAN/SINOVAC,786,402,384
Japaraíba,313530,MG,Sudeste,PFIZER/BIONTECH,67,67,0
Japaratinga,270360,AL,Nordeste,BUTANTAN/SINOVAC,1085,556,529
Japaratinga,270360,AL,Nordeste,FIOCRUZ/ASTRAZENECA,984,931,53
Japaratuba,280330,SE,Nordeste,BUTANTAN/SINOVAC,3806,2229,1577
Japaratuba,280330,SE,Nordeste,FIOCRUZ/ASTRAZENECA,2891,2889,2
Japaratuba,280330,SE,Nordeste,PFIZER/BIONTECH,312,312,0
Japeri,330227,RJ,Sudeste,BUTANTAN/SINOVAC,20236,11474,8762
Japeri,330227,RJ,Sudeste,FIOCRUZ/ASTRAZENECA,12160,10512,1648
Japeri,330227,RJ,Sudeste,PFIZER/BIONTECH,91,91,0
Japi,240540,RN,Nordeste,FIOCRUZ/ASTRAZENECA,1057,1000,57
Japi,240540,RN,Nordeste,BUTANTAN/SINOVAC,1018,513,505
Japi,240540,RN,Nordeste,PFIZER/BIONTECH,116,116,0
Japira,411230,PR,Sul,FIOCRUZ/ASTRAZENECA,1309,1240,69
Japira,411230,PR,Sul,BUTANTAN/SINOVAC,1104,580,524
Japira,411230,PR,Sul,PFIZER/BIONTECH,24,24,0
Japoatã,280340,SE,Nordeste,FIOCRUZ/ASTRAZENECA,2598,2518,80
Japoatã,280340,SE,Nordeste,BUTANTAN/SINOVAC,2346,1206,1140
Japoatã,280340,SE,Nordeste,PFIZER/BIONTECH,62,62,0
Japonvar,313535,MG,Sudeste,FIOCRUZ/ASTRAZENECA,2024,1820,204
Japonvar,313535,MG,Sudeste,BUTANTAN/SINOVAC,1624,824,800
Japonvar,313535,MG,Sudeste,PFIZER/BIONTECH,142,142,0
Japorã,500480,MS,Centro-Oeste,BUTANTAN/SINOVAC,6141,3243,2898
Japorã,500480,MS,Centro-Oeste,FIOCRUZ/ASTRAZENECA,1404,1279,125
Japorã,500480,MS,Centro-Oeste,PFIZER/BIONTECH,134,134,0
Japurá,130210,AM,Norte,BUTANTAN/SINOVAC,930,576,354
Japurá,130210,AM,Norte,FIOCRUZ/ASTRAZENECA,546,485,61
Japurá,411240,PR,Sul,FIOCRUZ/ASTRAZENECA,3488,3332,156
Japurá,411240,PR,Sul,BUTANTAN/SINOVAC,2266,1156,1110
Japurá,411240,PR,Sul,PFIZER/BIONTECH,126,126,0
Jaqueira,260795,PE,Nordeste,FIOCRUZ/ASTRAZENECA,2216,2067,149
Jaqueira,260795,PE,Nordeste,BUTANTAN/SINOVAC,1699,855,844
Jaqueira,260795,PE,Nordeste,PFIZER/BIONTECH,269,269,0
Jaquirana,431112,RS,Sul,FIOCRUZ/ASTRAZENECA,1180,1004,176
Jaquirana,431112,RS,Sul,BUTANTAN/SINOVAC,959,477,482
Jaquirana,431112,RS,Sul,PFIZER/BIONTECH,150,150,0
Jaraguá,521180,GO,Centro-Oeste,FIOCRUZ/ASTRAZENECA,11693,11002,691
Jaraguá,521180,GO,Centro-Oeste,BUTANTAN/SINOVAC,5627,2885,2742
Jaraguá,521180,GO,Centro-Oeste,PFIZER/BIONTECH,493,491,2
Jaraguá Do Sul,420890,SC,Sul,FIOCRUZ/ASTRAZENECA,31861,28991,2870
Jaraguá Do Sul,420890,SC,Sul,BUTANTAN/SINOVAC,26568,13678,12890
Jaraguá Do Sul,420890,SC,Sul,PFIZER/BIONTECH,9208,9205,3
Jaraguari,500490,MS,Centro-Oeste,FIOCRUZ/ASTRAZENECA,2458,2038,420
Jaraguari,500490,MS,Centro-Oeste,BUTANTAN/SINOVAC,1980,1006,974
Jaraguari,500490,MS,Centro-Oeste,PFIZER/BIONTECH,209,209,0
Jaramataia,270370,AL,Nordeste,FIOCRUZ/ASTRAZENECA,896,858,38
Jaramataia,270370,AL,Nordeste,BUTANTAN/SINOVAC,772,392,380
Jardim,230710,CE,Nordeste,BUTANTAN/SINOVAC,4751,2423,2328
Jardim,230710,CE,Nordeste,FIOCRUZ/ASTRAZENECA,2937,2471,466
Jardim,500500,MS,Centro-Oeste,FIOCRUZ/ASTRAZENECA,7590,6697,893
Jardim,500500,MS,Centro-Oeste,BUTANTAN/SINOVAC,5997,3146,2851
Jardim,500500,MS,Centro-Oeste,PFIZER/BIONTECH,910,906,4
Jardim Alegre,411250,PR,Sul,FIOCRUZ/ASTRAZENECA,3404,3196,208
Jardim Alegre,411250,PR,Sul,BUTANTAN/SINOVAC,2908,1508,1400
Jardim Alegre,411250,PR,Sul,PFIZER/BIONTECH,116,116,0
Jardim De Angicos,240550,RN,Nordeste,BUTANTAN/SINOVAC,768,411,357
Jardim De Angicos,240550,RN,Nordeste,FIOCRUZ/ASTRAZENECA,693,574,119
Jardim De Angicos,240550,RN,Nordeste,PFIZER/BIONTECH,65,65,0
Jardim De Piranhas,240560,RN,Nordeste,BUTANTAN/SINOVAC,2849,1533,1316
Jardim De Piranhas,240560,RN,Nordeste,FIOCRUZ/ASTRAZENECA,2780,2671,109
Jardim De Piranhas,240560,RN,Nordeste,PFIZER/BIONTECH,246,246,0
Jardim Do Mulato,220525,PI,Nordeste,BUTANTAN/SINOVAC,1527,797,730
Jardim Do Mulato,220525,PI,Nordeste,FIOCRUZ/ASTRAZENECA,443,379,64
Jardim Do Mulato,220525,PI,Nordeste,PFIZER/BIONTECH,65,65,0
Jardim Do Seridó,240570,RN,Nordeste,FIOCRUZ/ASTRAZENECA,7105,6647,458
Jardim Do Seridó,240570,RN,Nordeste,BUTANTAN/SINOVAC,6931,3564,3367
Jardim Do Seridó,240570,RN,Nordeste,PFIZER/BIONTECH,416,416,0
Jardim Olinda,411260,PR,Sul,FIOCRUZ/ASTRAZENECA,503,452,51
Jardim Olinda,411260,PR,Sul,BUTANTAN/SINOVAC,359,195,164
Jardim Olinda,411260,PR,Sul,PFIZER/BIONTECH,12,12,0
Jardinópolis,352510,SP,Sudeste,FIOCRUZ/ASTRAZENECA,10500,9882,618
Jardinópolis,352510,SP,Sudeste,BUTANTAN/SINOVAC,8381,4877,3504
Jardinópolis,352510,SP,Sudeste,PFIZER/BIONTECH,766,766,0
Jardinópolis,420895,SC,Sul,BUTANTAN/SINOVAC,857,511,346
Jardinópolis,420895,SC,Sul,FIOCRUZ/ASTRAZENECA,629,567,62
Jardinópolis,420895,SC,Sul,PFIZER/BIONTECH,30,30,0
Jari,431113,RS,Sul,FIOCRUZ/ASTRAZENECA,941,834,107
Jari,431113,RS,Sul,BUTANTAN/SINOVAC,762,441,321
Jari,431113,RS,Sul,PFIZER/BIONTECH,100,100,0
Jarinu,352520,SP,Sudeste,BUTANTAN/SINOVAC,5993,3584,2409
Jarinu,352520,SP,Sudeste,FIOCRUZ/ASTRAZENECA,5479,5167,312
Jarinu,352520,SP,Sudeste,PFIZER/BIONTECH,733,733,0
Jaru,110011,RO,Norte,BUTANTAN/SINOVAC,9859,5084,4775
Jaru,110011,RO,Norte,FIOCRUZ/ASTRAZENECA,9512,9282,230
Jaru,110011,RO,Norte,PFIZER/BIONTECH,1905,1905,0
Jataí,521190,GO,Centro-Oeste,FIOCRUZ/ASTRAZENECA,21640,19769,1871
Jataí,521190,GO,Centro-Oeste,BUTANTAN/SINOVAC,17875,9026,8849
Jataí,521190,GO,Centro-Oeste,PFIZER/BIONTECH,2939,2938,1
Jataizinho,411270,PR,Sul,FIOCRUZ/ASTRAZENECA,3829,3619,210
Jataizinho,411270,PR,Sul,BUTANTAN/SINOVAC,2444,1239,1205
Jataizinho,411270,PR,Sul,PFIZER/BIONTECH,149,149,0
Jataúba,260800,PE,Nordeste,FIOCRUZ/ASTRAZENECA,2646,2516,130
Jataúba,260800,PE,Nordeste,BUTANTAN/SINOVAC,2595,1399,1196
Jataúba,260800,PE,Nordeste,PFIZER/BIONTECH,34,34,0
Jateí,500510,MS,Centro-Oeste,BUTANTAN/SINOVAC,1009,547,462
Jateí,500510,MS,Centro-Oeste,FIOCRUZ/ASTRAZENECA,973,859,114
Jateí,500510,MS,Centro-Oeste,PFIZER/BIONTECH,124,119,5
Jati,230720,CE,Nordeste,BUTANTAN/SINOVAC,1402,740,662
Jati,230720,CE,Nordeste,FIOCRUZ/ASTRAZENECA,810,727,83
Jatobá,210545,MA,Nordeste,FIOCRUZ/ASTRAZENECA,1763,1649,114
Jatobá,210545,MA,Nordeste,BUTANTAN/SINOVAC,1392,714,678
Jatobá,260805,PE,Nordeste,BUTANTAN/SINOVAC,6951,4203,2748
Jatobá,260805,PE,Nordeste,FIOCRUZ/ASTRAZENECA,1991,1897,94
Jatobá,260805,PE,Nordeste,PFIZER/BIONTECH,109,109,0
Jatobá Do Piauí,220527,PI,Nordeste,BUTANTAN/SINOVAC,898,533,365
Jatobá Do Piauí,220527,PI,Nordeste,FIOCRUZ/ASTRAZENECA,703,669,34
Jaú,352530,SP,Sudeste,BUTANTAN/SINOVAC,35714,19739,15975
Jaú,352530,SP,Sudeste,FIOCRUZ/ASTRAZENECA,26291,23419,2872
Jaú,352530,SP,Sudeste,PFIZER/BIONTECH,604,604,0
Jaú Do Tocantins,171150,TO,Norte,FIOCRUZ/ASTRAZENECA,905,875,30
Jaú Do Tocantins,171150,TO,Norte,BUTANTAN/SINOVAC,772,393,379
Jaupaci,521200,GO,Centro-Oeste,FIOCRUZ/ASTRAZENECA,822,767,55
Jaupaci,521200,GO,Centro-Oeste,BUTANTAN/SINOVAC,732,383,349
Jauru,510500,MT,Centro-Oeste,FIOCRUZ/ASTRAZENECA,2205,2084,121
Jauru,510500,MT,Centro-Oeste,BUTANTAN/SINOVAC,1738,874,864
Jauru,510500,MT,Centro-Oeste,PFIZER/BIONTECH,122,122,0
Jeceaba,313540,MG,Sudeste,FIOCRUZ/ASTRAZENECA,1506,1204,302
Jeceaba,313540,MG,Sudeste,BUTANTAN/SINOVAC,1317,697,620
Jeceaba,313540,MG,Sudeste,PFIZER/BIONTECH,75,75,0
Jenipapo De Minas,313545,MG,Sudeste,FIOCRUZ/ASTRAZENECA,1728,1592,136
Jenipapo De Minas,313545,MG,Sudeste,BUTANTAN/SINOVAC,1164,604,560
Jenipapo De Minas,313545,MG,Sudeste,PFIZER/BIONTECH,56,56,0
Jenipapo Dos Vieiras,210547,MA,Nordeste,FIOCRUZ/ASTRAZENECA,3077,2888,189
Jenipapo Dos Vieiras,210547,MA,Nordeste,BUTANTAN/SINOVAC,2456,1414,1042
Jequeri,313550,MG,Sudeste,BUTANTAN/SINOVAC,3030,1540,1490
Jequeri,313550,MG,Sudeste,FIOCRUZ/ASTRAZENECA,2089,1890,199
Jequeri,313550,MG,Sudeste,PFIZER/BIONTECH,202,202,0
Jequiá Da Praia,270375,AL,Nordeste,FIOCRUZ/ASTRAZENECA,1745,1515,230
Jequiá Da Praia,270375,AL,Nordeste,BUTANTAN/SINOVAC,1593,805,788
Jequiá Da Praia,270375,AL,Nordeste,PFIZER/BIONTECH,12,12,0
Jequié,291800,BA,Nordeste,BUTANTAN/SINOVAC,35510,18224,17286
Jequié,291800,BA,Nordeste,FIOCRUZ/ASTRAZENECA,33313,29846,3467
Jequié,291800,BA,Nordeste,PFIZER/BIONTECH,741,712,29
Jequitaí,313560,MG,Sudeste,FIOCRUZ/ASTRAZENECA,1891,1721,170
Jequitaí,313560,MG,Sudeste,BUTANTAN/SINOVAC,1539,747,792
Jequitaí,313560,MG,Sudeste,PFIZER/BIONTECH,61,61,0
Jequitibá,313570,MG,Sudeste,FIOCRUZ/ASTRAZENECA,1666,1546,120
Jequitibá,313570,MG,Sudeste,BUTANTAN/SINOVAC,1397,719,678
Jequitibá,313570,MG,Sudeste,PFIZER/BIONTECH,86,86,0
Jequitinhonha,313580,MG,Sudeste,BUTANTAN/SINOVAC,5283,2702,2581
Jequitinhonha,313580,MG,Sudeste,FIOCRUZ/ASTRAZENECA,4971,4592,379
Jequitinhonha,313580,MG,Sudeste,PFIZER/BIONTECH,237,237,0
Jeremoabo,291810,BA,Nordeste,FIOCRUZ/ASTRAZENECA,12026,11021,1005
Jeremoabo,291810,BA,Nordeste,BUTANTAN/SINOVAC,6992,3485,3507
Jeremoabo,291810,BA,Nordeste,PFIZER/BIONTECH,170,170,0
Jericó,250740,PB,Nordeste,BUTANTAN/SINOVAC,2133,1074,1059
Jericó,250740,PB,Nordeste,FIOCRUZ/ASTRAZENECA,1679,1528,151
Jericó,250740,PB,Nordeste,PFIZER/BIONTECH,84,84,0
Jeriquara,352540,SP,Sudeste,BUTANTAN/SINOVAC,786,435,351
Jeriquara,352540,SP,Sudeste,FIOCRUZ/ASTRAZENECA,768,691,77
Jeriquara,352540,SP,Sudeste,PFIZER/BIONTECH,93,92,1
Jerônimo Monteiro,320310,ES,Sudeste,BUTANTAN/SINOVAC,3746,1913,1833
Jerônimo Monteiro,320310,ES,Sudeste,FIOCRUZ/ASTRAZENECA,3156,2835,321
Jerônimo Monteiro,320310,ES,Sudeste,PFIZER/BIONTECH,541,541,0
Jerumenha,220530,PI,Nordeste,BUTANTAN/SINOVAC,967,527,440
Jerumenha,220530,PI,Nordeste,FIOCRUZ/ASTRAZENECA,892,838,54
Jerumenha,220530,PI,Nordeste,PFIZER/BIONTECH,94,94,0
Jesuânia,313590,MG,Sudeste,FIOCRUZ/ASTRAZENECA,1317,1207,110
Jesuânia,313590,MG,Sudeste,BUTANTAN/SINOVAC,1255,660,595
Jesuânia,313590,MG,Sudeste,PFIZER/BIONTECH,78,78,0
Jesuítas,411275,PR,Sul,FIOCRUZ/ASTRAZENECA,3755,3589,166
Jesuítas,411275,PR,Sul,BUTANTAN/SINOVAC,2406,1236,1170
Jesuítas,411275,PR,Sul,PFIZER/BIONTECH,120,120,0
Jesúpolis,521205,GO,Centro-Oeste,FIOCRUZ/ASTRAZENECA,557,507,50
Jesúpolis,521205,GO,Centro-Oeste,BUTANTAN/SINOVAC,553,279,274
Jesúpolis,521205,GO,Centro-Oeste,PFIZER/BIONTECH,41,41,0
Ji-Paraná,110012,RO,Norte,BUTANTAN/SINOVAC,14051,7698,6353
Ji-Paraná,110012,RO,Norte,FIOCRUZ/ASTRAZENECA,4270,3672,598
Ji-Paraná,110012,RO,Norte,PFIZER/BIONTECH,40,40,0
Jijoca De Jericoacoara,230725,CE,Nordeste,BUTANTAN/SINOVAC,2512,1276,1236
Jijoca De Jericoacoara,230725,CE,Nordeste,FIOCRUZ/ASTRAZENECA,1562,1412,150
Jiquiriçá,291820,BA,Nordeste,FIOCRUZ/ASTRAZENECA,3038,2656,382
Jiquiriçá,291820,BA,Nordeste,BUTANTAN/SINOVAC,2575,1346,1229
Jiquiriçá,291820,BA,Nordeste,PFIZER/BIONTECH,628,626,2
Jitaúna,291830,BA,Nordeste,FIOCRUZ/ASTRAZENECA,2228,2162,66
Jitaúna,291830,BA,Nordeste,BUTANTAN/SINOVAC,2149,1207,942
Jitaúna,291830,BA,Nordeste,PFIZER/BIONTECH,30,30,0
Joaçaba,420900,SC,Sul,FIOCRUZ/ASTRAZENECA,9917,8856,1061
Joaçaba,420900,SC,Sul,BUTANTAN/SINOVAC,6770,3885,2885
Joaçaba,420900,SC,Sul,PFIZER/BIONTECH,847,847,0
Joaíma,313600,MG,Sudeste,BUTANTAN/SINOVAC,3402,1731,1671
Joaíma,313600,MG,Sudeste,FIOCRUZ/ASTRAZENECA,3299,3038,261
Joaíma,313600,MG,Sudeste,PFIZER/BIONTECH,602,602,0
Joanésia,313610,MG,Sudeste,BUTANTAN/SINOVAC,1291,649,642
Joanésia,313610,MG,Sudeste,FIOCRUZ/ASTRAZENECA,1146,1035,111
Joanésia,313610,MG,Sudeste,PFIZER/BIONTECH,80,80,0
Joanópolis,352550,SP,Sudeste,BUTANTAN/SINOVAC,3422,1925,1497
Joanópolis,352550,SP,Sudeste,FIOCRUZ/ASTRAZENECA,2828,2601,227
Joanópolis,352550,SP,Sudeste,PFIZER/BIONTECH,290,290,0
João Alfredo,260810,PE,Nordeste,FIOCRUZ/ASTRAZENECA,7545,6945,600
João Alfredo,260810,PE,Nordeste,BUTANTAN/SINOVAC,5927,3066,2861
João Alfredo,260810,PE,Nordeste,PFIZER/BIONTECH,559,559,0
João Câmara,240580,RN,Nordeste,FIOCRUZ/ASTRAZENECA,8678,7222,1456
João Câmara,240580,RN,Nordeste,BUTANTAN/SINOVAC,4980,2609,2371
João Câmara,240580,RN,Nordeste,PFIZER/BIONTECH,747,747,0
João Costa,220535,PI,Nordeste,FIOCRUZ/ASTRAZENECA,778,736,42
João Costa,220535,PI,Nordeste,BUTANTAN/SINOVAC,521,268,253
João Costa,220535,PI,Nordeste,PFIZER/BIONTECH,23,23,0
João Dias,240590,RN,Nordeste,BUTANTAN/SINOVAC,631,343,288
João Dias,240590,RN,Nordeste,FIOCRUZ/ASTRAZENECA,627,589,38
João Dias,240590,RN,Nordeste,PFIZER/BIONTECH,105,105,0
João Dourado,291835,BA,Nordeste,FIOCRUZ/ASTRAZENECA,4645,4062,583
João Dourado,291835,BA,Nordeste,BUTANTAN/SINOVAC,3524,1825,1699
João Dourado,291835,BA,Nordeste,PFIZER/BIONTECH,139,139,0
João Lisboa,210550,MA,Nordeste,BUTANTAN/SINOVAC,3686,1977,1709
João Lisboa,210550,MA,Nordeste,FIOCRUZ/ASTRAZENECA,3580,3299,281
João Monlevade,313620,MG,Sudeste,BUTANTAN/SINOVAC,19249,9686,9563
João Monlevade,313620,MG,Sudeste,FIOCRUZ/ASTRAZENECA,13197,11572,1625
João Monlevade,313620,MG,Sudeste,PFIZER/BIONTECH,2087,2087,0
João Neiva,320313,ES,Sudeste,BUTANTAN/SINOVAC,5092,2644,2448
João Neiva,320313,ES,Sudeste,FIOCRUZ/ASTRAZENECA,3729,3538,191
João Neiva,320313,ES,Sudeste,PFIZER/BIONTECH,580,580,0
João Pessoa,250750,PB,Nordeste,BUTANTAN/SINOVAC,185493,95182,90311
João Pessoa,250750,PB,Nordeste,FIOCRUZ/ASTRAZENECA,178883,156193,22690
João Pessoa,250750,PB,Nordeste,PFIZER/BIONTECH,36136,36131,5
João Pinheiro,313630,MG,Sudeste,FIOCRUZ/ASTRAZENECA,9446,8222,1224
João Pinheiro,313630,MG,Sudeste,BUTANTAN/SINOVAC,8510,4324,4186
João Pinheiro,313630,MG,Sudeste,PFIZER/BIONTECH,427,426,1
João Ramalho,352560,SP,Sudeste,FIOCRUZ/ASTRAZENECA,1198,1111,87
João Ramalho,352560,SP,Sudeste,BUTANTAN/SINOVAC,903,509,394
João Ramalho,352560,SP,Sudeste,PFIZER/BIONTECH,103,103,0
Joaquim Felício,313640,MG,Sudeste,BUTANTAN/SINOVAC,1360,705,655
Joaquim Felício,313640,MG,Sudeste,FIOCRUZ/ASTRAZENECA,960,864,96
Joaquim Felício,313640,MG,Sudeste,PFIZER/BIONTECH,62,62,0
Joaquim Gomes,270380,AL,Nordeste,BUTANTAN/SINOVAC,4459,2313,2146
Joaquim Gomes,270380,AL,Nordeste,FIOCRUZ/ASTRAZENECA,2974,2813,161
Joaquim Nabuco,260820,PE,Nordeste,BUTANTAN/SINOVAC,1952,1138,814
Joaquim Nabuco,260820,PE,Nordeste,FIOCRUZ/ASTRAZENECA,1820,1755,65
Joaquim Nabuco,260820,PE,Nordeste,PFIZER/BIONTECH,37,37,0
Joaquim Pires,220540,PI,Nordeste,FIOCRUZ/ASTRAZENECA,2483,2331,152
Joaquim Pires,220540,PI,Nordeste,BUTANTAN/SINOVAC,1999,1055,944
Joaquim Pires,220540,PI,Nordeste,PFIZER/BIONTECH,257,257,0
Joaquim Távora,411280,PR,Sul,FIOCRUZ/ASTRAZENECA,2603,2404,199
Joaquim Távora,411280,PR,Sul,BUTANTAN/SINOVAC,2538,1321,1217
Joaquim Távora,411280,PR,Sul,PFIZER/BIONTECH,106,106,0
Joca Claudino,251365,PB,Nordeste,BUTANTAN/SINOVAC,783,414,369
Joca Claudino,251365,PB,Nordeste,FIOCRUZ/ASTRAZENECA,518,465,53
Joca Claudino,251365,PB,Nordeste,PFIZER/BIONTECH,52,52,0
Joca Marques,220545,PI,Nordeste,BUTANTAN/SINOVAC,662,431,231
Joca Marques,220545,PI,Nordeste,FIOCRUZ/ASTRAZENECA,575,546,29
Jóia,431115,RS,Sul,BUTANTAN/SINOVAC,2421,1245,1176
Jóia,431115,RS,Sul,FIOCRUZ/ASTRAZENECA,1577,1447,130
Jóia,431115,RS,Sul,PFIZER/BIONTECH,194,192,2
Joinville,420910,SC,Sul,FIOCRUZ/ASTRAZENECA,120377,111225,9152
Joinville,420910,SC,Sul,BUTANTAN/SINOVAC,102833,52522,50311
Joinville,420910,SC,Sul,PFIZER/BIONTECH,23845,23801,44
Jordânia,313650,MG,Sudeste,BUTANTAN/SINOVAC,2617,1331,1286
Jordânia,313650,MG,Sudeste,FIOCRUZ/ASTRAZENECA,1302,1117,185
Jordânia,313650,MG,Sudeste,PFIZER/BIONTECH,108,108,0
Jordão,120032,AC,Norte,BUTANTAN/SINOVAC,3576,2048,1528
Jordão,120032,AC,Norte,FIOCRUZ/ASTRAZENECA,704,672,32
Jordão,120032,AC,Norte,PFIZER/BIONTECH,105,104,1
José Boiteux,420915,SC,Sul,BUTANTAN/SINOVAC,2620,1383,1237
José Boiteux,420915,SC,Sul,FIOCRUZ/ASTRAZENECA,457,447,10
José Bonifácio,352570,SP,Sudeste,BUTANTAN/SINOVAC,8758,4881,3877
José Bonifácio,352570,SP,Sudeste,FIOCRUZ/ASTRAZENECA,8425,7772,653
José Bonifácio,352570,SP,Sudeste,PFIZER/BIONTECH,900,898,2
José Da Penha,240600,RN,Nordeste,BUTANTAN/SINOVAC,2165,1104,1061
José Da Penha,240600,RN,Nordeste,FIOCRUZ/ASTRAZENECA,1547,1420,127
José Da Penha,240600,RN,Nordeste,PFIZER/BIONTECH,167,167,0
José De Freitas,220550,PI,Nordeste,BUTANTAN/SINOVAC,6462,3870,2592
José De Freitas,220550,PI,Nordeste,FIOCRUZ/ASTRAZENECA,5316,4696,620
José De Freitas,220550,PI,Nordeste,PFIZER/BIONTECH,40,39,1
José Gonçalves De Minas,313652,MG,Sudeste,FIOCRUZ/ASTRAZENECA,1003,938,65
José Gonçalves De Minas,313652,MG,Sudeste,BUTANTAN/SINOVAC,503,270,233
José Gonçalves De Minas,313652,MG,Sudeste,PFIZER/BIONTECH,57,57,0
José Raydan,313655,MG,Sudeste,BUTANTAN/SINOVAC,991,601,390
José Raydan,313655,MG,Sudeste,FIOCRUZ/ASTRAZENECA,511,456,55
Joselândia,210560,MA,Nordeste,FIOCRUZ/ASTRAZENECA,3091,2914,177
Joselândia,210560,MA,Nordeste,BUTANTAN/SINOVAC,2383,1244,1139
Josenópolis,313657,MG,Sudeste,BUTANTAN/SINOVAC,597,331,266
Josenópolis,313657,MG,Sudeste,FIOCRUZ/ASTRAZENECA,320,297,23
Josenópolis,313657,MG,Sudeste,PFIZER/BIONTECH,8,8,0
Joviânia,521210,GO,Centro-Oeste,FIOCRUZ/ASTRAZENECA,1921,1784,137
Joviânia,521210,GO,Centro-Oeste,BUTANTAN/SINOVAC,1304,678,626
Juara,510510,MT,Centro-Oeste,FIOCRUZ/ASTRAZENECA,5980,5576,404
Juara,510510,MT,Centro-Oeste,BUTANTAN/SINOVAC,4422,2250,2172
Juara,510510,MT,Centro-Oeste,PFIZER/BIONTECH,455,455,0
Juarez Távora,250760,PB,Nordeste,FIOCRUZ/ASTRAZENECA,1641,1500,141
Juarez Távora,250760,PB,Nordeste,BUTANTAN/SINOVAC,1622,834,788
Juarez Távora,250760,PB,Nordeste,PFIZER/BIONTECH,118,118,0
Juarina,171180,TO,Norte,BUTANTAN/SINOVAC,425,223,202
Juarina,171180,TO,Norte,FIOCRUZ/ASTRAZENECA,307,297,10
Juatuba,313665,MG,Sudeste,BUTANTAN/SINOVAC,3505,2057,1448
Juatuba,313665,MG,Sudeste,FIOCRUZ/ASTRAZENECA,2787,2656,131
Juatuba,313665,MG,Sudeste,PFIZER/BIONTECH,22,22,0
Juazeirinho,250770,PB,Nordeste,BUTANTAN/SINOVAC,3106,1570,1536
Juazeirinho,250770,PB,Nordeste,FIOCRUZ/ASTRAZENECA,2262,2023,239
Juazeirinho,250770,PB,Nordeste,PFIZER/BIONTECH,136,136,0
Juazeiro,291840,BA,Nordeste,BUTANTAN/SINOVAC,26529,15618,10911
Juazeiro,291840,BA,Nordeste,FIOCRUZ/ASTRAZENECA,23380,20646,2734
Juazeiro,291840,BA,Nordeste,PFIZER/BIONTECH,1081,1081,0
Juazeiro Do Norte,230730,CE,Nordeste,BUTANTAN/SINOVAC,49887,25238,24649
Juazeiro Do Norte,230730,CE,Nordeste,FIOCRUZ/ASTRAZENECA,10740,8650,2090
Juazeiro Do Norte,230730,CE,Nordeste,PFIZER/BIONTECH,1,1,0
Juazeiro Do Piauí,220551,PI,Nordeste,BUTANTAN/SINOVAC,799,431,368
Juazeiro Do Piauí,220551,PI,Nordeste,FIOCRUZ/ASTRAZENECA,443,442,1
Jucás,230740,CE,Nordeste,BUTANTAN/SINOVAC,4862,2603,2259
Jucás,230740,CE,Nordeste,FIOCRUZ/ASTRAZENECA,2728,2251,477
Jucati,260825,PE,Nordeste,FIOCRUZ/ASTRAZENECA,2015,1840,175
Jucati,260825,PE,Nordeste,BUTANTAN/SINOVAC,1937,1025,912
Jucati,260825,PE,Nordeste,PFIZER/BIONTECH,199,199,0
Jucuruçu,291845,BA,Nordeste,BUTANTAN/SINOVAC,390,171,219
Jucuruçu,291845,BA,Nordeste,FIOCRUZ/ASTRAZENECA,316,303,13
Jucurutu,240610,RN,Nordeste,BUTANTAN/SINOVAC,4177,2094,2083
Jucurutu,240610,RN,Nordeste,FIOCRUZ/ASTRAZENECA,2814,2575,239
Jucurutu,240610,RN,Nordeste,PFIZER/BIONTECH,174,174,0
Juína,510515,MT,Centro-Oeste,BUTANTAN/SINOVAC,9683,5196,4487
Juína,510515,MT,Centro-Oeste,FIOCRUZ/ASTRAZENECA,6521,5979,542
Juína,510515,MT,Centro-Oeste,PFIZER/BIONTECH,356,354,2
Juiz De Fora,313670,MG,Sudeste,FIOCRUZ/ASTRAZENECA,108460,95942,12518
Juiz De Fora,313670,MG,Sudeste,BUTANTAN/SINOVAC,103909,46537,57372
Juiz De Fora,313670,MG,Sudeste,PFIZER/BIONTECH,6452,6444,8
Júlio Borges,220552,PI,Nordeste,BUTANTAN/SINOVAC,739,484,255
Júlio Borges,220552,PI,Nordeste,FIOCRUZ/ASTRAZENECA,684,668,16
Júlio De Castilhos,431120,RS,Sul,FIOCRUZ/ASTRAZENECA,5612,4870,742
Júlio De Castilhos,431120,RS,Sul,BUTANTAN/SINOVAC,5046,2542,2504
Júlio De Castilhos,431120,RS,Sul,PFIZER/BIONTECH,681,679,2
Júlio Mesquita,352580,SP,Sudeste,FIOCRUZ/ASTRAZENECA,1132,1039,93
Júlio Mesquita,352580,SP,Sudeste,BUTANTAN/SINOVAC,989,612,377
Júlio Mesquita,352580,SP,Sudeste,PFIZER/BIONTECH,45,45,0
Jumirim,352585,SP,Sudeste,BUTANTAN/SINOVAC,710,404,306
Jumirim,352585,SP,Sudeste,FIOCRUZ/ASTRAZENECA,707,639,68
Jumirim,352585,SP,Sudeste,PFIZER/BIONTECH,96,96,0
Junco Do Maranhão,210565,MA,Nordeste,FIOCRUZ/ASTRAZENECA,1238,1172,66
Junco Do Maranhão,210565,MA,Nordeste,BUTANTAN/SINOVAC,1000,582,418
Junco Do Seridó,250780,PB,Nordeste,BUTANTAN/SINOVAC,1435,721,714
Junco Do Seridó,250780,PB,Nordeste,FIOCRUZ/ASTRAZENECA,1047,942,105
Junco Do Seridó,250780,PB,Nordeste,PFIZER/BIONTECH,91,91,0
Jundiá,240615,RN,Nordeste,FIOCRUZ/ASTRAZENECA,936,793,143
Jundiá,240615,RN,Nordeste,BUTANTAN/SINOVAC,841,421,420
Jundiá,240615,RN,Nordeste,PFIZER/BIONTECH,45,45,0
Jundiá,270390,AL,Nordeste,BUTANTAN/SINOVAC,737,369,368
Jundiá,270390,AL,Nordeste,FIOCRUZ/ASTRAZENECA,666,584,82
Jundiaí,352590,SP,Sudeste,FIOCRUZ/ASTRAZENECA,103674,95983,7691
Jundiaí,352590,SP,Sudeste,BUTANTAN/SINOVAC,94383,51600,42783
Jundiaí,352590,SP,Sudeste,PFIZER/BIONTECH,8414,8404,10
Jundiaí Do Sul,411290,PR,Sul,FIOCRUZ/ASTRAZENECA,1035,985,50
Jundiaí Do Sul,411290,PR,Sul,BUTANTAN/SINOVAC,796,416,380
Jundiaí Do Sul,411290,PR,Sul,PFIZER/BIONTECH,10,10,0
Junqueiro,270400,AL,Nordeste,FIOCRUZ/ASTRAZENECA,4055,3773,282
Junqueiro,270400,AL,Nordeste,BUTANTAN/SINOVAC,3892,2084,1808
Junqueirópolis,352600,SP,Sudeste,BUTANTAN/SINOVAC,5938,3234,2704
Junqueirópolis,352600,SP,Sudeste,FIOCRUZ/ASTRAZENECA,5466,5057,409
Junqueirópolis,352600,SP,Sudeste,PFIZER/BIONTECH,384,384,0
Jupi,260830,PE,Nordeste,FIOCRUZ/ASTRAZENECA,3281,2996,285
Jupi,260830,PE,Nordeste,BUTANTAN/SINOVAC,2541,1287,1254
Jupi,260830,PE,Nordeste,PFIZER/BIONTECH,437,437,0
Jupiá,420917,SC,Sul,BUTANTAN/SINOVAC,615,330,285
Jupiá,420917,SC,Sul,FIOCRUZ/ASTRAZENECA,535,481,54
Jupiá,420917,SC,Sul,PFIZER/BIONTECH,42,42,0
Juquiá,352610,SP,Sudeste,FIOCRUZ/ASTRAZENECA,4652,4304,348
Juquiá,352610,SP,Sudeste,BUTANTAN/SINOVAC,4115,2202,1913
Juquiá,352610,SP,Sudeste,PFIZER/BIONTECH,223,223,0
Juquitiba,352620,SP,Sudeste,BUTANTAN/SINOVAC,5699,3073,2626
Juquitiba,352620,SP,Sudeste,FIOCRUZ/ASTRAZENECA,5660,5309,351
Juquitiba,352620,SP,Sudeste,PFIZER/BIONTECH,338,337,1
Juramento,313680,MG,Sudeste,BUTANTAN/SINOVAC,838,441,397
Juramento,313680,MG,Sudeste,FIOCRUZ/ASTRAZENECA,504,474,30
Juranda,411295,PR,Sul,FIOCRUZ/ASTRAZENECA,2328,2179,149
Juranda,411295,PR,Sul,BUTANTAN/SINOVAC,1610,840,770
Juranda,411295,PR,Sul,PFIZER/BIONTECH,120,120,0
Jurema,220553,PI,Nordeste,FIOCRUZ/ASTRAZENECA,764,703,61
Jurema,220553,PI,Nordeste,BUTANTAN/SINOVAC,762,390,372
Jurema,220553,PI,Nordeste,PFIZER/BIONTECH,90,90,0
Jurema,260840,PE,Nordeste,BUTANTAN/SINOVAC,2776,1436,1340
Jurema,260840,PE,Nordeste,FIOCRUZ/ASTRAZENECA,2670,2363,307
Jurema,260840,PE,Nordeste,PFIZER/BIONTECH,115,115,0
Juripiranga,250790,PB,Nordeste,BUTANTAN/SINOVAC,2164,1119,1045
Juripiranga,250790,PB,Nordeste,FIOCRUZ/ASTRAZENECA,1648,1484,164
Juripiranga,250790,PB,Nordeste,PFIZER/BIONTECH,206,206,0
Juru,250800,PB,Nordeste,BUTANTAN/SINOVAC,3027,1609,1418
Juru,250800,PB,Nordeste,FIOCRUZ/ASTRAZENECA,1925,1766,159
Juru,250800,PB,Nordeste,PFIZER/BIONTECH,142,141,1
Juruá,130220,AM,Norte,BUTANTAN/SINOVAC,592,381,211
Juruá,130220,AM,Norte,FIOCRUZ/ASTRAZENECA,403,402,1
Juruaia,313690,MG,Sudeste,BUTANTAN/SINOVAC,1942,980,962
Juruaia,313690,MG,Sudeste,FIOCRUZ/ASTRAZENECA,1852,1700,152
Juruaia,313690,MG,Sudeste,PFIZER/BIONTECH,76,76,0
Juruena,510517,MT,Centro-Oeste,BUTANTAN/SINOVAC,1433,731,702
Juruena,510517,MT,Centro-Oeste,FIOCRUZ/ASTRAZENECA,1018,802,216
Juruena,510517,MT,Centro-Oeste,PFIZER/BIONTECH,142,142,0
Juruti,150390,PA,Norte,FIOCRUZ/ASTRAZENECA,9429,7063,2366
Juruti,150390,PA,Norte,BUTANTAN/SINOVAC,1923,1031,892
Juscimeira,510520,MT,Centro-Oeste,FIOCRUZ/ASTRAZENECA,2566,2397,169
Juscimeira,510520,MT,Centro-Oeste,BUTANTAN/SINOVAC,2476,1314,1162
Juscimeira,510520,MT,Centro-Oeste,PFIZER/BIONTECH,331,331,0
Jussara,291850,BA,Nordeste,BUTANTAN/SINOVAC,3437,1821,1616
Jussara,291850,BA,Nordeste,FIOCRUZ/ASTRAZENECA,3386,3253,133
Jussara,291850,BA,Nordeste,PFIZER/BIONTECH,42,42,0
Jussara,411300,PR,Sul,FIOCRUZ/ASTRAZENECA,2042,1949,93
Jussara,411300,PR,Sul,BUTANTAN/SINOVAC,1342,683,659
Jussara,411300,PR,Sul,PFIZER/BIONTECH,42,42,0
Jussara,521220,GO,Centro-Oeste,FIOCRUZ/ASTRAZENECA,6601,6152,449
Jussara,521220,GO,Centro-Oeste,BUTANTAN/SINOVAC,5925,3305,2620
Jussara,521220,GO,Centro-Oeste,PFIZER/BIONTECH,22,10,12
Jussari,291855,BA,Nordeste,FIOCRUZ/ASTRAZENECA,1499,1319,180
Jussari,291855,BA,Nordeste,BUTANTAN/SINOVAC,1330,685,645
Jussari,291855,BA,Nordeste,PFIZER/BIONTECH,35,35,0
Jussiape,291860,BA,Nordeste,FIOCRUZ/ASTRAZENECA,2884,2619,265
Jussiape,291860,BA,Nordeste,BUTANTAN/SINOVAC,2365,1228,1137
Jussiape,291860,BA,Nordeste,PFIZER/BIONTECH,108,108,0
Jutaí,130230,AM,Norte,FIOCRUZ/ASTRAZENECA,486,486,0
Jutaí,130230,AM,Norte,BUTANTAN/SINOVAC,244,202,42
Juti,500515,MS,Centro-Oeste,BUTANTAN/SINOVAC,2368,1226,1142
Juti,500515,MS,Centro-Oeste,FIOCRUZ/ASTRAZENECA,2093,1899,194
Juti,500515,MS,Centro-Oeste,PFIZER/BIONTECH,273,273,0
Juvenília,313695,MG,Sudeste,FIOCRUZ/ASTRAZENECA,1689,1590,99
Juvenília,313695,MG,Sudeste,BUTANTAN/SINOVAC,943,463,480
Juvenília,313695,MG,Sudeste,PFIZER/BIONTECH,42,42,0
Kaloré,411310,PR,Sul,FIOCRUZ/ASTRAZENECA,1852,1749,103
Kaloré,411310,PR,Sul,BUTANTAN/SINOVAC,1438,750,688
Kaloré,411310,PR,Sul,PFIZER/BIONTECH,23,23,0
Lábrea,130240,AM,Norte,BUTANTAN/SINOVAC,10560,5580,4980
Lábrea,130240,AM,Norte,FIOCRUZ/ASTRAZENECA,8903,7412,1491
Lacerdópolis,420920,SC,Sul,BUTANTAN/SINOVAC,799,405,394
Lacerdópolis,420920,SC,Sul,FIOCRUZ/ASTRAZENECA,655,578,77
Lacerdópolis,420920,SC,Sul,PFIZER/BIONTECH,71,71,0
Ladainha,313700,MG,Sudeste,BUTANTAN/SINOVAC,3408,1684,1724
Ladainha,313700,MG,Sudeste,FIOCRUZ/ASTRAZENECA,2198,1918,280
Ladainha,313700,MG,Sudeste,PFIZER/BIONTECH,261,261,0
Ladário,500520,MS,Centro-Oeste,FIOCRUZ/ASTRAZENECA,6630,5728,902
Ladário,500520,MS,Centro-Oeste,BUTANTAN/SINOVAC,3297,1930,1367
Ladário,500520,MS,Centro-Oeste,PFIZER/BIONTECH,761,759,2
Lafaiete Coutinho,291870,BA,Nordeste,BUTANTAN/SINOVAC,940,534,406
Lafaiete Coutinho,291870,BA,Nordeste,FIOCRUZ/ASTRAZENECA,579,556,23
Lagamar,313710,MG,Sudeste,BUTANTAN/SINOVAC,2038,1069,969
Lagamar,313710,MG,Sudeste,FIOCRUZ/ASTRAZENECA,1752,1600,152
Lagamar,313710,MG,Sudeste,PFIZER/BIONTECH,243,243,0
Lagarto,280350,SE,Nordeste,BUTANTAN/SINOVAC,14500,8399,6101
Lagarto,280350,SE,Nordeste,FIOCRUZ/ASTRAZENECA,8549,7180,1369
Lages,420930,SC,Sul,FIOCRUZ/ASTRAZENECA,43828,40540,3288
Lages,420930,SC,Sul,BUTANTAN/SINOVAC,35333,19719,15614
Lages,420930,SC,Sul,PFIZER/BIONTECH,5227,5225,2
Lago Da Pedra,210570,MA,Nordeste,FIOCRUZ/ASTRAZENECA,8821,8050,771
Lago Da Pedra,210570,MA,Nordeste,BUTANTAN/SINOVAC,7496,3933,3563
Lago Do Junco,210580,MA,Nordeste,FIOCRUZ/ASTRAZENECA,2115,1976,139
Lago Do Junco,210580,MA,Nordeste,BUTANTAN/SINOVAC,1670,893,777
Lago Dos Rodrigues,210594,MA,Nordeste,FIOCRUZ/ASTRAZENECA,1845,1711,134
Lago Dos Rodrigues,210594,MA,Nordeste,BUTANTAN/SINOVAC,1621,847,774
Lago Verde,210590,MA,Nordeste,BUTANTAN/SINOVAC,3054,1810,1244
Lago Verde,210590,MA,Nordeste,FIOCRUZ/ASTRAZENECA,2947,2785,162
Lagoa,250810,PB,Nordeste,BUTANTAN/SINOVAC,1599,831,768
Lagoa,250810,PB,Nordeste,FIOCRUZ/ASTRAZENECA,928,858,70
Lagoa,250810,PB,Nordeste,PFIZER/BIONTECH,102,102,0
Lagoa Alegre,220555,PI,Nordeste,BUTANTAN/SINOVAC,1657,894,763
Lagoa Alegre,220555,PI,Nordeste,FIOCRUZ/ASTRAZENECA,1414,1304,110
Lagoa Bonita Do Sul,431123,RS,Sul,FIOCRUZ/ASTRAZENECA,638,594,44
Lagoa Bonita Do Sul,431123,RS,Sul,BUTANTAN/SINOVAC,636,317,319
Lagoa Bonita Do Sul,431123,RS,Sul,PFIZER/BIONTECH,102,102,0
Lagoa D'Anta,240620,RN,Nordeste,BUTANTAN/SINOVAC,1363,720,643
Lagoa D'Anta,240620,RN,Nordeste,FIOCRUZ/ASTRAZENECA,1271,1202,69
Lagoa D'Anta,240620,RN,Nordeste,PFIZER/BIONTECH,117,117,0
Lagoa Da Canoa,270410,AL,Nordeste,FIOCRUZ/ASTRAZENECA,3339,3037,302
Lagoa Da Canoa,270410,AL,Nordeste,BUTANTAN/SINOVAC,3300,1667,1633
Lagoa Da Confusão,171190,TO,Norte,BUTANTAN/SINOVAC,1638,864,774
Lagoa Da Confusão,171190,TO,Norte,FIOCRUZ/ASTRAZENECA,1392,1349,43
Lagoa Da Prata,313720,MG,Sudeste,FIOCRUZ/ASTRAZENECA,9216,8742,474
Lagoa Da Prata,313720,MG,Sudeste,BUTANTAN/SINOVAC,8541,4511,4030
Lagoa Da Prata,313720,MG,Sudeste,PFIZER/BIONTECH,1991,1991,0
Lagoa De Dentro,250820,PB,Nordeste,BUTANTAN/SINOVAC,1916,963,953
Lagoa De Dentro,250820,PB,Nordeste,FIOCRUZ/ASTRAZENECA,1553,1380,173
Lagoa De Dentro,250820,PB,Nordeste,PFIZER/BIONTECH,103,103,0
Lagoa De Itaenga,260850,PE,Nordeste,FIOCRUZ/ASTRAZENECA,3729,3485,244
Lagoa De Itaenga,260850,PE,Nordeste,BUTANTAN/SINOVAC,3360,1730,1630
Lagoa De Itaenga,260850,PE,Nordeste,PFIZER/BIONTECH,254,254,0
Lagoa De Pedras,240630,RN,Nordeste,BUTANTAN/SINOVAC,1865,933,932
Lagoa De Pedras,240630,RN,Nordeste,FIOCRUZ/ASTRAZENECA,1677,1595,82
Lagoa De Pedras,240630,RN,Nordeste,PFIZER/BIONTECH,203,203,0
Lagoa De São Francisco,220557,PI,Nordeste,FIOCRUZ/ASTRAZENECA,1742,1402,340
Lagoa De São Francisco,220557,PI,Nordeste,BUTANTAN/SINOVAC,1372,802,570
Lagoa De São Francisco,220557,PI,Nordeste,PFIZER/BIONTECH,99,99,0
Lagoa De Velhos,240640,RN,Nordeste,FIOCRUZ/ASTRAZENECA,604,566,38
Lagoa De Velhos,240640,RN,Nordeste,BUTANTAN/SINOVAC,599,311,288
Lagoa De Velhos,240640,RN,Nordeste,PFIZER/BIONTECH,90,90,0
Lagoa Do Barro Do Piauí,220556,PI,Nordeste,BUTANTAN/SINOVAC,888,452,436
Lagoa Do Barro Do Piauí,220556,PI,Nordeste,FIOCRUZ/ASTRAZENECA,723,650,73
Lagoa Do Carro,260845,PE,Nordeste,FIOCRUZ/ASTRAZENECA,3473,3224,249
Lagoa Do Carro,260845,PE,Nordeste,BUTANTAN/SINOVAC,2813,1456,1357
Lagoa Do Carro,260845,PE,Nordeste,PFIZER/BIONTECH,380,380,0
Lagoa Do Mato,210592,MA,Nordeste,FIOCRUZ/ASTRAZENECA,2143,2076,67
Lagoa Do Mato,210592,MA,Nordeste,BUTANTAN/SINOVAC,1596,867,729
Lagoa Do Ouro,260860,PE,Nordeste,FIOCRUZ/ASTRAZENECA,2652,2457,195
Lagoa Do Ouro,260860,PE,Nordeste,BUTANTAN/SINOVAC,2490,1274,1216
Lagoa Do Ouro,260860,PE,Nordeste,PFIZER/BIONTECH,138,138,0
Lagoa Do Piauí,220558,PI,Nordeste,BUTANTAN/SINOVAC,957,496,461
Lagoa Do Piauí,220558,PI,Nordeste,FIOCRUZ/ASTRAZENECA,876,852,24
Lagoa Do Piauí,220558,PI,Nordeste,PFIZER/BIONTECH,65,65,0
Lagoa Do Sítio,220559,PI,Nordeste,FIOCRUZ/ASTRAZENECA,1006,937,69
Lagoa Do Sítio,220559,PI,Nordeste,BUTANTAN/SINOVAC,716,412,304
Lagoa Do Tocantins,171195,TO,Norte,BUTANTAN/SINOVAC,802,414,388
Lagoa Do Tocantins,171195,TO,Norte,FIOCRUZ/ASTRAZENECA,294,276,18
Lagoa Dos Gatos,260870,PE,Nordeste,FIOCRUZ/ASTRAZENECA,3098,2742,356
Lagoa Dos Gatos,260870,PE,Nordeste,BUTANTAN/SINOVAC,2462,1290,1172
Lagoa Dos Gatos,260870,PE,Nordeste,PFIZER/BIONTECH,90,90,0
Lagoa Dos Patos,313730,MG,Sudeste,BUTANTAN/SINOVAC,916,466,450
Lagoa Dos Patos,313730,MG,Sudeste,FIOCRUZ/ASTRAZENECA,871,783,88
Lagoa Dos Patos,313730,MG,Sudeste,PFIZER/BIONTECH,60,59,1
Lagoa Dos Três Cantos,431127,RS,Sul,BUTANTAN/SINOVAC,764,384,380
Lagoa Dos Três Cantos,431127,RS,Sul,FIOCRUZ/ASTRAZENECA,497,405,92
Lagoa Dos Três Cantos,431127,RS,Sul,PFIZER/BIONTECH,75,75,0
Lagoa Dourada,313740,MG,Sudeste,FIOCRUZ/ASTRAZENECA,2609,2434,175
Lagoa Dourada,313740,MG,Sudeste,BUTANTAN/SINOVAC,2058,1044,1014
Lagoa Dourada,313740,MG,Sudeste,PFIZER/BIONTECH,382,382,0
Lagoa Formosa,313750,MG,Sudeste,BUTANTAN/SINOVAC,5550,2807,2743
Lagoa Formosa,313750,MG,Sudeste,FIOCRUZ/ASTRAZENECA,3893,3728,165
Lagoa Formosa,313750,MG,Sudeste,PFIZER/BIONTECH,201,201,0
Lagoa Grande,260875,PE,Nordeste,BUTANTAN/SINOVAC,3568,1828,1740
Lagoa Grande,260875,PE,Nordeste,FIOCRUZ/ASTRAZENECA,2919,2691,228
Lagoa Grande,260875,PE,Nordeste,PFIZER/BIONTECH,119,119,0
Lagoa Grande,313753,MG,Sudeste,FIOCRUZ/ASTRAZENECA,1886,1725,161
Lagoa Grande,313753,MG,Sudeste,BUTANTAN/SINOVAC,1779,935,844
Lagoa Grande,313753,MG,Sudeste,PFIZER/BIONTECH,256,256,0
Lagoa Grande Do Maranhão,210596,MA,Nordeste,BUTANTAN/SINOVAC,1173,652,521
Lagoa Grande Do Maranhão,210596,MA,Nordeste,FIOCRUZ/ASTRAZENECA,1012,971,41
Lagoa Nova,240650,RN,Nordeste,FIOCRUZ/ASTRAZENECA,4708,4487,221
Lagoa Nova,240650,RN,Nordeste,BUTANTAN/SINOVAC,3965,2004,1961
Lagoa Nova,240650,RN,Nordeste,PFIZER/BIONTECH,121,121,0
Lagoa Real,291875,BA,Nordeste,FIOCRUZ/ASTRAZENECA,2917,2723,194
Lagoa Real,291875,BA,Nordeste,BUTANTAN/SINOVAC,2842,1533,1309
Lagoa Real,291875,BA,Nordeste,PFIZER/BIONTECH,11,11,0
Lagoa Salgada,240660,RN,Nordeste,FIOCRUZ/ASTRAZENECA,1799,1659,140
Lagoa Salgada,240660,RN,Nordeste,BUTANTAN/SINOVAC,1584,843,741
Lagoa Salgada,240660,RN,Nordeste,PFIZER/BIONTECH,375,375,0
Lagoa Santa,313760,MG,Sudeste,BUTANTAN/SINOVAC,12298,6369,5929
Lagoa Santa,313760,MG,Sudeste,FIOCRUZ/ASTRAZENECA,10256,9162,1094
Lagoa Santa,313760,MG,Sudeste,PFIZER/BIONTECH,1265,1264,1
Lagoa Santa,521225,GO,Centro-Oeste,FIOCRUZ/ASTRAZENECA,391,361,30
Lagoa Santa,521225,GO,Centro-Oeste,BUTANTAN/SINOVAC,377,188,189
Lagoa Santa,521225,GO,Centro-Oeste,PFIZER/BIONTECH,29,29,0
Lagoa Seca,250830,PB,Nordeste,BUTANTAN/SINOVAC,5251,2667,2584
Lagoa Seca,250830,PB,Nordeste,FIOCRUZ/ASTRAZENECA,4220,3823,397
Lagoa Seca,250830,PB,Nordeste,PFIZER/BIONTECH,501,501,0
Lagoa Vermelha,431130,RS,Sul,FIOCRUZ/ASTRAZENECA,7518,6686,832
Lagoa Vermelha,431130,RS,Sul,BUTANTAN/SINOVAC,6989,3523,3466
Lagoa Vermelha,431130,RS,Sul,PFIZER/BIONTECH,909,909,0
Lagoão,431125,RS,Sul,FIOCRUZ/ASTRAZENECA,1644,1436,208
Lagoão,431125,RS,Sul,BUTANTAN/SINOVAC,1045,529,516
Lagoão,431125,RS,Sul,PFIZER/BIONTECH,105,105,0
Lagoinha,352630,SP,Sudeste,BUTANTAN/SINOVAC,1604,836,768
Lagoinha,352630,SP,Sudeste,FIOCRUZ/ASTRAZENECA,1543,1401,142
Lagoinha,352630,SP,Sudeste,PFIZER/BIONTECH,106,106,0
Lagoinha Do Piauí,220554,PI,Nordeste,BUTANTAN/SINOVAC,718,377,341
Lagoinha Do Piauí,220554,PI,Nordeste,FIOCRUZ/ASTRAZENECA,485,441,44
Laguna,420940,SC,Sul,FIOCRUZ/ASTRAZENECA,12376,11522,854
Laguna,420940,SC,Sul,BUTANTAN/SINOVAC,10946,5835,5111
Laguna,420940,SC,Sul,PFIZER/BIONTECH,839,838,1
Laguna Carapã,500525,MS,Centro-Oeste,BUTANTAN/SINOVAC,2665,1442,1223
Laguna Carapã,500525,MS,Centro-Oeste,FIOCRUZ/ASTRAZENECA,1604,1473,131
Laguna Carapã,500525,MS,Centro-Oeste,PFIZER/BIONTECH,188,188,0
Laje,291880,BA,Nordeste,BUTANTAN/SINOVAC,3412,1818,1594
Laje,291880,BA,Nordeste,FIOCRUZ/ASTRAZENECA,2920,2805,115
Laje,291880,BA,Nordeste,PFIZER/BIONTECH,228,228,0
Laje Do Muriaé,330230,RJ,Sudeste,BUTANTAN/SINOVAC,1798,959,839
Laje Do Muriaé,330230,RJ,Sudeste,FIOCRUZ/ASTRAZENECA,1415,1268,147
Lajeado,171200,TO,Norte,FIOCRUZ/ASTRAZENECA,823,736,87
Lajeado,171200,TO,Norte,BUTANTAN/SINOVAC,812,445,367
Lajeado,431140,RS,Sul,BUTANTAN/SINOVAC,18795,9762,9033
Lajeado,431140,RS,Sul,FIOCRUZ/ASTRAZENECA,16943,15520,1423
Lajeado,431140,RS,Sul,PFIZER/BIONTECH,1193,1193,0
Lajeado Do Bugre,431142,RS,Sul,BUTANTAN/SINOVAC,699,357,342
Lajeado Do Bugre,431142,RS,Sul,FIOCRUZ/ASTRAZENECA,592,545,47
Lajeado Do Bugre,431142,RS,Sul,PFIZER/BIONTECH,85,85,0
Lajeado Grande,420945,SC,Sul,BUTANTAN/SINOVAC,465,231,234
Lajeado Grande,420945,SC,Sul,FIOCRUZ/ASTRAZENECA,243,221,22
Lajeado Novo,210598,MA,Nordeste,BUTANTAN/SINOVAC,1150,617,533
Lajeado Novo,210598,MA,Nordeste,FIOCRUZ/ASTRAZENECA,1079,1031,48
Lajedão,291890,BA,Nordeste,BUTANTAN/SINOVAC,1520,813,707
Lajedão,291890,BA,Nordeste,FIOCRUZ/ASTRAZENECA,1186,1021,165
Lajedão,291890,BA,Nordeste,PFIZER/BIONTECH,30,30,0
Lajedinho,291900,BA,Nordeste,FIOCRUZ/ASTRAZENECA,1180,1090,90
Lajedinho,291900,BA,Nordeste,BUTANTAN/SINOVAC,647,331,316
Lajedinho,291900,BA,Nordeste,PFIZER/BIONTECH,9,9,0
Lajedo,260880,PE,Nordeste,FIOCRUZ/ASTRAZENECA,7582,6971,611
Lajedo,260880,PE,Nordeste,BUTANTAN/SINOVAC,6621,3462,3159
Lajedo,260880,PE,Nordeste,PFIZER/BIONTECH,634,634,0
Lajedo Do Tabocal,291905,BA,Nordeste,BUTANTAN/SINOVAC,1790,1017,773
Lajedo Do Tabocal,291905,BA,Nordeste,FIOCRUZ/ASTRAZENECA,1223,1123,100
Lajedo Do Tabocal,291905,BA,Nordeste,PFIZER/BIONTECH,35,35,0
Lajes,240670,RN,Nordeste,FIOCRUZ/ASTRAZENECA,1719,1638,81
Lajes,240670,RN,Nordeste,BUTANTAN/SINOVAC,1619,815,804
Lajes,240670,RN,Nordeste,PFIZER/BIONTECH,150,150,0
Lajes Pintadas,240680,RN,Nordeste,FIOCRUZ/ASTRAZENECA,1565,1409,156
Lajes Pintadas,240680,RN,Nordeste,BUTANTAN/SINOVAC,1438,738,700
Lajes Pintadas,240680,RN,Nordeste,PFIZER/BIONTECH,220,219,1
Lajinha,313770,MG,Sudeste,BUTANTAN/SINOVAC,3430,1877,1553
Lajinha,313770,MG,Sudeste,FIOCRUZ/ASTRAZENECA,2858,2661,197
Lajinha,313770,MG,Sudeste,PFIZER/BIONTECH,43,43,0
Lamarão,291910,BA,Nordeste,BUTANTAN/SINOVAC,1392,811,581
Lamarão,291910,BA,Nordeste,FIOCRUZ/ASTRAZENECA,1073,1055,18
Lamarão,291910,BA,Nordeste,PFIZER/BIONTECH,216,215,1
Lambari,313780,MG,Sudeste,FIOCRUZ/ASTRAZENECA,4919,4557,362
Lambari,313780,MG,Sudeste,BUTANTAN/SINOVAC,3938,2031,1907
Lambari,313780,MG,Sudeste,PFIZER/BIONTECH,226,226,0
Lambari D'Oeste,510523,MT,Centro-Oeste,FIOCRUZ/ASTRAZENECA,1178,1126,52
Lambari D'Oeste,510523,MT,Centro-Oeste,BUTANTAN/SINOVAC,715,371,344
Lambari D'Oeste,510523,MT,Centro-Oeste,PFIZER/BIONTECH,88,88,0
Lamim,313790,MG,Sudeste,FIOCRUZ/ASTRAZENECA,1521,1130,391
Lamim,313790,MG,Sudeste,BUTANTAN/SINOVAC,874,442,432
Lamim,313790,MG,Sudeste,PFIZER/BIONTECH,45,45,0
Landri Sales,220560,PI,Nordeste,FIOCRUZ/ASTRAZENECA,1503,1420,83
Landri Sales,220560,PI,Nordeste,BUTANTAN/SINOVAC,1130,588,542
Landri Sales,220560,PI,Nordeste,PFIZER/BIONTECH,105,105,0
Lapa,411320,PR,Sul,BUTANTAN/SINOVAC,9059,4703,4356
Lapa,411320,PR,Sul,FIOCRUZ/ASTRAZENECA,8597,8097,500
Lapa,411320,PR,Sul,PFIZER/BIONTECH,663,663,0
Lapão,291915,BA,Nordeste,FIOCRUZ/ASTRAZENECA,6539,6488,51
Lapão,291915,BA,Nordeste,BUTANTAN/SINOVAC,2645,1446,1199
Laranja Da Terra,320316,ES,Sudeste,BUTANTAN/SINOVAC,3801,1920,1881
Laranja Da Terra,320316,ES,Sudeste,FIOCRUZ/ASTRAZENECA,2762,2626,136
Laranja Da Terra,320316,ES,Sudeste,PFIZER/BIONTECH,456,456,0
Laranjal,313800,MG,Sudeste,FIOCRUZ/ASTRAZENECA,2021,1883,138
Laranjal,313800,MG,Sudeste,BUTANTAN/SINOVAC,1502,799,703
Laranjal,313800,MG,Sudeste,PFIZER/BIONTECH,81,81,0
Laranjal,411325,PR,Sul,FIOCRUZ/ASTRAZENECA,1527,1463,64
Laranjal,411325,PR,Sul,BUTANTAN/SINOVAC,900,466,434
Laranjal,411325,PR,Sul,PFIZER/BIONTECH,30,30,0
Laranjal Do Jari,160027,AP,Norte,FIOCRUZ/ASTRAZENECA,7137,6619,518
Laranjal Do Jari,160027,AP,Norte,BUTANTAN/SINOVAC,5627,2879,2748
Laranjal Do Jari,160027,AP,Norte,PFIZER/BIONTECH,1589,1587,2
Laranjal Paulista,352640,SP,Sudeste,FIOCRUZ/ASTRAZENECA,6366,5925,441
Laranjal Paulista,352640,SP,Sudeste,BUTANTAN/SINOVAC,5994,3356,2638
Laranjal Paulista,352640,SP,Sudeste,PFIZER/BIONTECH,481,481,0
Laranjeiras,280360,SE,Nordeste,FIOCRUZ/ASTRAZENECA,3728,3726,2
Laranjeiras,280360,SE,Nordeste,BUTANTAN/SINOVAC,3330,1745,1585
Laranjeiras,280360,SE,Nordeste,PFIZER/BIONTECH,122,122,0
Laranjeiras Do Sul,411330,PR,Sul,FIOCRUZ/ASTRAZENECA,9549,9134,415
Laranjeiras Do Sul,411330,PR,Sul,BUTANTAN/SINOVAC,6333,3306,3027
Laranjeiras Do Sul,411330,PR,Sul,PFIZER/BIONTECH,423,423,0
Lassance,313810,MG,Sudeste,FIOCRUZ/ASTRAZENECA,1802,1701,101
Lassance,313810,MG,Sudeste,BUTANTAN/SINOVAC,1300,655,645
Lassance,313810,MG,Sudeste,PFIZER/BIONTECH,220,220,0
Lastro,250840,PB,Nordeste,FIOCRUZ/ASTRAZENECA,728,672,56
Lastro,250840,PB,Nordeste,BUTANTAN/SINOVAC,700,351,349
Lastro,250840,PB,Nordeste,PFIZER/BIONTECH,53,53,0
Laurentino,420950,SC,Sul,FIOCRUZ/ASTRAZENECA,1468,1394,74
Laurentino,420950,SC,Sul,BUTANTAN/SINOVAC,1275,663,612
Laurentino,420950,SC,Sul,PFIZER/BIONTECH,176,176,0
Lauro De Freitas,291920,BA,Nordeste,FIOCRUZ/ASTRAZENECA,37918,34472,3446
Lauro De Freitas,291920,BA,Nordeste,BUTANTAN/SINOVAC,37240,19471,17769
Lauro De Freitas,291920,BA,Nordeste,PFIZER/BIONTECH,7559,7552,7
Lauro Müller,420960,SC,Sul,FIOCRUZ/ASTRAZENECA,2653,2477,176
Lauro Müller,420960,SC,Sul,BUTANTAN/SINOVAC,2560,1334,1226
Lavandeira,171215,TO,Norte,BUTANTAN/SINOVAC,464,232,232
Lavandeira,171215,TO,Norte,FIOCRUZ/ASTRAZENECA,365,347,18
Lavínia,352650,SP,Sudeste,BUTANTAN/SINOVAC,2311,1379,932
Lavínia,352650,SP,Sudeste,FIOCRUZ/ASTRAZENECA,1813,1682,131
Lavínia,352650,SP,Sudeste,PFIZER/BIONTECH,156,156,0
Lavras,313820,MG,Sudeste,BUTANTAN/SINOVAC,20919,10715,10204
Lavras,313820,MG,Sudeste,FIOCRUZ/ASTRAZENECA,11307,10673,634
Lavras,313820,MG,Sudeste,PFIZER/BIONTECH,5,5,0
Lavras Da Mangabeira,230750,CE,Nordeste,BUTANTAN/SINOVAC,5625,3032,2593
Lavras Da Mangabeira,230750,CE,Nordeste,FIOCRUZ/ASTRAZENECA,3587,3201,386
Lavras Da Mangabeira,230750,CE,Nordeste,PFIZER/BIONTECH,30,30,0
Lavras Do Sul,431150,RS,Sul,FIOCRUZ/ASTRAZENECA,2258,2061,197
Lavras Do Sul,431150,RS,Sul,BUTANTAN/SINOVAC,1737,941,796
Lavras Do Sul,431150,RS,Sul,PFIZER/BIONTECH,252,252,0
Lavrinhas,352660,SP,Sudeste,FIOCRUZ/ASTRAZENECA,1212,1143,69
Lavrinhas,352660,SP,Sudeste,BUTANTAN/SINOVAC,1172,652,520
Leandro Ferreira,313830,MG,Sudeste,BUTANTAN/SINOVAC,944,476,468
Leandro Ferreira,313830,MG,Sudeste,FIOCRUZ/ASTRAZENECA,646,571,75
Lebon Régis,420970,SC,Sul,FIOCRUZ/ASTRAZENECA,2731,2580,151
Lebon Régis,420970,SC,Sul,BUTANTAN/SINOVAC,2105,1176,929
Lebon Régis,420970,SC,Sul,PFIZER/BIONTECH,300,300,0
Leme,352670,SP,Sudeste,FIOCRUZ/ASTRAZENECA,22056,20235,1821
Leme,352670,SP,Sudeste,BUTANTAN/SINOVAC,20844,12287,8557
Leme,352670,SP,Sudeste,PFIZER/BIONTECH,2416,2416,0
Leme Do Prado,313835,MG,Sudeste,FIOCRUZ/ASTRAZENECA,1542,1451,91
Leme Do Prado,313835,MG,Sudeste,BUTANTAN/SINOVAC,920,469,451
Leme Do Prado,313835,MG,Sudeste,PFIZER/BIONTECH,66,66,0
Lençóis,291930,BA,Nordeste,FIOCRUZ/ASTRAZENECA,2391,2186,205
Lençóis,291930,BA,Nordeste,BUTANTAN/SINOVAC,1554,821,733
Lençóis,291930,BA,Nordeste,PFIZER/BIONTECH,97,97,0
Lençóis Paulista,352680,SP,Sudeste,FIOCRUZ/ASTRAZENECA,15826,14880,946
Lençóis Paulista,352680,SP,Sudeste,BUTANTAN/SINOVAC,11706,5920,5786
Lençóis Paulista,352680,SP,Sudeste,PFIZER/BIONTECH,1338,1337,1
Leoberto Leal,420980,SC,Sul,FIOCRUZ/ASTRAZENECA,1078,911,167
Leoberto Leal,420980,SC,Sul,BUTANTAN/SINOVAC,641,352,289
Leopoldina,313840,MG,Sudeste,BUTANTAN/SINOVAC,13795,6955,6840
Leopoldina,313840,MG,Sudeste,FIOCRUZ/ASTRAZENECA,10149,9163,986
Leopoldina,313840,MG,Sudeste,PFIZER/BIONTECH,773,773,0
Leopoldo De Bulhões,521230,GO,Centro-Oeste,FIOCRUZ/ASTRAZENECA,2140,2037,103
Leopoldo De Bulhões,521230,GO,Centro-Oeste,BUTANTAN/SINOVAC,1277,669,608
Leopoldo De Bulhões,521230,GO,Centro-Oeste,PFIZER/BIONTECH,102,102,0
Leópolis,411340,PR,Sul,FIOCRUZ/ASTRAZENECA,1520,1448,72
Leópolis,411340,PR,Sul,BUTANTAN/SINOVAC,997,506,491
Leópolis,411340,PR,Sul,PFIZER/BIONTECH,24,24,0
Liberato Salzano,431160,RS,Sul,BUTANTAN/SINOVAC,2075,1052,1023
Liberato Salzano,431160,RS,Sul,FIOCRUZ/ASTRAZENECA,1356,1222,134
Liberato Salzano,431160,RS,Sul,PFIZER/BIONTECH,150,150,0
Liberdade,313850,MG,Sudeste,BUTANTAN/SINOVAC,1442,772,670
Liberdade,313850,MG,Sudeste,FIOCRUZ/ASTRAZENECA,669,604,65
Licínio De Almeida,291940,BA,Nordeste,BUTANTAN/SINOVAC,2741,1425,1316
Licínio De Almeida,291940,BA,Nordeste,FIOCRUZ/ASTRAZENECA,2415,2214,201
Licínio De Almeida,291940,BA,Nordeste,PFIZER/BIONTECH,157,157,0
Lidianópolis,411342,PR,Sul,FIOCRUZ/ASTRAZENECA,1514,1430,84
Lidianópolis,411342,PR,Sul,BUTANTAN/SINOVAC,1102,571,531
Lidianópolis,411342,PR,Sul,PFIZER/BIONTECH,24,24,0
Lima Campos,210600,MA,Nordeste,FIOCRUZ/ASTRAZENECA,4127,3179,948
Lima Campos,210600,MA,Nordeste,BUTANTAN/SINOVAC,2210,1178,1032
Lima Duarte,313860,MG,Sudeste,BUTANTAN/SINOVAC,3203,1926,1277
Lima Duarte,313860,MG,Sudeste,FIOCRUZ/ASTRAZENECA,2310,2284,26
Limeira,352690,SP,Sudeste,FIOCRUZ/ASTRAZENECA,61587,56812,4775
Limeira,352690,SP,Sudeste,BUTANTAN/SINOVAC,59929,34487,25442
Limeira,352690,SP,Sudeste,PFIZER/BIONTECH,5528,5524,4
Limeira Do Oeste,313862,MG,Sudeste,FIOCRUZ/ASTRAZENECA,1926,1789,137
Limeira Do Oeste,313862,MG,Sudeste,BUTANTAN/SINOVAC,1263,661,602
Limeira Do Oeste,313862,MG,Sudeste,PFIZER/BIONTECH,112,112,0
Limoeiro,260890,PE,Nordeste,FIOCRUZ/ASTRAZENECA,15011,13916,1095
Limoeiro,260890,PE,Nordeste,BUTANTAN/SINOVAC,12189,6276,5913
Limoeiro,260890,PE,Nordeste,PFIZER/BIONTECH,1523,1523,0
Limoeiro De Anadia,270420,AL,Nordeste,BUTANTAN/SINOVAC,5812,3105,2707
Limoeiro De Anadia,270420,AL,Nordeste,FIOCRUZ/ASTRAZENECA,4604,3939,665
Limoeiro Do Ajuru,150400,PA,Norte,FIOCRUZ/ASTRAZENECA,3141,2821,320
Limoeiro Do Ajuru,150400,PA,Norte,BUTANTAN/SINOVAC,2182,1185,997
Limoeiro Do Norte,230760,CE,Nordeste,BUTANTAN/SINOVAC,9916,5084,4832
Limoeiro Do Norte,230760,CE,Nordeste,FIOCRUZ/ASTRAZENECA,6656,5841,815
Lindoeste,411345,PR,Sul,BUTANTAN/SINOVAC,1667,856,811
Lindoeste,411345,PR,Sul,FIOCRUZ/ASTRAZENECA,1163,1094,69
Lindoeste,411345,PR,Sul,PFIZER/BIONTECH,20,20,0
Lindóia,352700,SP,Sudeste,FIOCRUZ/ASTRAZENECA,1874,1707,167
Lindóia,352700,SP,Sudeste,BUTANTAN/SINOVAC,1855,990,865
Lindóia,352700,SP,Sudeste,PFIZER/BIONTECH,185,185,0
Lindóia Do Sul,420985,SC,Sul,BUTANTAN/SINOVAC,1444,732,712
Lindóia Do Sul,420985,SC,Sul,FIOCRUZ/ASTRAZENECA,1278,1145,133
Lindóia Do Sul,420985,SC,Sul,PFIZER/BIONTECH,132,132,0
Lindolfo Collor,431162,RS,Sul,FIOCRUZ/ASTRAZENECA,1073,1024,49
Lindolfo Collor,431162,RS,Sul,BUTANTAN/SINOVAC,920,464,456
Lindolfo Collor,431162,RS,Sul,PFIZER/BIONTECH,117,117,0
Linha Nova,431164,RS,Sul,BUTANTAN/SINOVAC,540,270,270
Linha Nova,431164,RS,Sul,FIOCRUZ/ASTRAZENECA,497,416,81
Linha Nova,431164,RS,Sul,PFIZER/BIONTECH,72,72,0
Linhares,320320,ES,Sudeste,FIOCRUZ/ASTRAZENECA,38175,34920,3255
Linhares,320320,ES,Sudeste,BUTANTAN/SINOVAC,32438,17698,14740
Linhares,320320,ES,Sudeste,PFIZER/BIONTECH,4298,4283,15
Lins,352710,SP,Sudeste,BUTANTAN/SINOVAC,21685,11692,9993
Lins,352710,SP,Sudeste,FIOCRUZ/ASTRAZENECA,20460,18548,1912
Lins,352710,SP,Sudeste,PFIZER/BIONTECH,1681,1678,3
Livramento,250850,PB,Nordeste,BUTANTAN/SINOVAC,1634,821,813
Livramento,250850,PB,Nordeste,FIOCRUZ/ASTRAZENECA,1016,891,125
Livramento,250850,PB,Nordeste,PFIZER/BIONTECH,66,66,0
Livramento De Nossa Senhora,291950,BA,Nordeste,FIOCRUZ/ASTRAZENECA,11665,10237,1428
Livramento De Nossa Senhora,291950,BA,Nordeste,BUTANTAN/SINOVAC,9958,5187,4771
Livramento De Nossa Senhora,291950,BA,Nordeste,PFIZER/BIONTECH,864,864,0
Lizarda,171240,TO,Norte,BUTANTAN/SINOVAC,676,348,328
Lizarda,171240,TO,Norte,FIOCRUZ/ASTRAZENECA,653,641,12
Loanda,411350,PR,Sul,FIOCRUZ/ASTRAZENECA,6723,6395,328
Loanda,411350,PR,Sul,BUTANTAN/SINOVAC,5089,2641,2448
Loanda,411350,PR,Sul,PFIZER/BIONTECH,777,777,0
Lobato,411360,PR,Sul,FIOCRUZ/ASTRAZENECA,1368,1300,68
Lobato,411360,PR,Sul,BUTANTAN/SINOVAC,939,480,459
Logradouro,250855,PB,Nordeste,BUTANTAN/SINOVAC,949,487,462
Logradouro,250855,PB,Nordeste,FIOCRUZ/ASTRAZENECA,767,683,84
Logradouro,250855,PB,Nordeste,PFIZER/BIONTECH,96,96,0
Londrina,411370,PR,Sul,BUTANTAN/SINOVAC,145815,73543,72272
Londrina,411370,PR,Sul,FIOCRUZ/ASTRAZENECA,121957,107891,14066
Londrina,411370,PR,Sul,PFIZER/BIONTECH,18690,18678,12
Lontra,313865,MG,Sudeste,BUTANTAN/SINOVAC,1887,951,936
Lontra,313865,MG,Sudeste,FIOCRUZ/ASTRAZENECA,1764,1610,154
Lontra,313865,MG,Sudeste,PFIZER/BIONTECH,119,119,0
Lontras,420990,SC,Sul,FIOCRUZ/ASTRAZENECA,2445,2260,185
Lontras,420990,SC,Sul,BUTANTAN/SINOVAC,1865,1018,847
Lontras,420990,SC,Sul,PFIZER/BIONTECH,217,217,0
Lorena,352720,SP,Sudeste,BUTANTAN/SINOVAC,18747,10020,8727
Lorena,352720,SP,Sudeste,FIOCRUZ/ASTRAZENECA,18340,17107,1233
Lorena,352720,SP,Sudeste,PFIZER/BIONTECH,733,732,1
Loreto,210610,MA,Nordeste,FIOCRUZ/ASTRAZENECA,2536,2407,129
Loreto,210610,MA,Nordeste,BUTANTAN/SINOVAC,1687,911,776
Lourdes,352725,SP,Sudeste,BUTANTAN/SINOVAC,1051,572,479
Lourdes,352725,SP,Sudeste,FIOCRUZ/ASTRAZENECA,773,675,98
Lourdes,352725,SP,Sudeste,PFIZER/BIONTECH,96,95,1
Louveira,352730,SP,Sudeste,FIOCRUZ/ASTRAZENECA,9490,9095,395
Louveira,352730,SP,Sudeste,BUTANTAN/SINOVAC,8245,4784,3461
Louveira,352730,SP,Sudeste,PFIZER/BIONTECH,971,971,0
Lucas Do Rio Verde,510525,MT,Centro-Oeste,FIOCRUZ/ASTRAZENECA,7761,7185,576
Lucas Do Rio Verde,510525,MT,Centro-Oeste,BUTANTAN/SINOVAC,5097,2832,2265
Lucas Do Rio Verde,510525,MT,Centro-Oeste,PFIZER/BIONTECH,338,338,0
Lucélia,352740,SP,Sudeste,BUTANTAN/SINOVAC,5515,3022,2493
Lucélia,352740,SP,Sudeste,FIOCRUZ/ASTRAZENECA,4377,3886,491
Lucélia,352740,SP,Sudeste,PFIZER/BIONTECH,217,216,1
Lucena,250860,PB,Nordeste,BUTANTAN/SINOVAC,2190,1080,1110
Lucena,250860,PB,Nordeste,FIOCRUZ/ASTRAZENECA,1266,1155,111
Lucianópolis,352750,SP,Sudeste,BUTANTAN/SINOVAC,721,372,349
Lucianópolis,352750,SP,Sudeste,FIOCRUZ/ASTRAZENECA,703,639,64
Lucianópolis,352750,SP,Sudeste,PFIZER/BIONTECH,79,79,0
Luciara,510530,MT,Centro-Oeste,FIOCRUZ/ASTRAZENECA,497,457,40
Luciara,510530,MT,Centro-Oeste,BUTANTAN/SINOVAC,459,252,207
Luciara,510530,MT,Centro-Oeste,PFIZER/BIONTECH,66,66,0
Lucrécia,240690,RN,Nordeste,FIOCRUZ/ASTRAZENECA,1576,1466,110
Lucrécia,240690,RN,Nordeste,BUTANTAN/SINOVAC,1548,799,749
Lucrécia,240690,RN,Nordeste,PFIZER/BIONTECH,165,164,1
Luís Antônio,352760,SP,Sudeste,FIOCRUZ/ASTRAZENECA,3152,2978,174
Luís Antônio,352760,SP,Sudeste,BUTANTAN/SINOVAC,2231,1252,979
Luís Antônio,352760,SP,Sudeste,PFIZER/BIONTECH,190,190,0
Luís Correia,220570,PI,Nordeste,BUTANTAN/SINOVAC,3732,1938,1794
Luís Correia,220570,PI,Nordeste,FIOCRUZ/ASTRAZENECA,3567,3324,243
Luís Domingues,210620,MA,Nordeste,FIOCRUZ/ASTRAZENECA,1211,1114,97
Luís Domingues,210620,MA,Nordeste,BUTANTAN/SINOVAC,955,529,426
Luís Eduardo Magalhães,291955,BA,Nordeste,FIOCRUZ/ASTRAZENECA,7782,7445,337
Luís Eduardo Magalhães,291955,BA,Nordeste,BUTANTAN/SINOVAC,6049,3166,2883
Luís Eduardo Magalhães,291955,BA,Nordeste,PFIZER/BIONTECH,454,453,1
Luís Gomes,240700,RN,Nordeste,FIOCRUZ/ASTRAZENECA,2711,2587,124
Luís Gomes,240700,RN,Nordeste,BUTANTAN/SINOVAC,2418,1215,1203
Luís Gomes,240700,RN,Nordeste,PFIZER/BIONTECH,292,291,1
Luisburgo,313867,MG,Sudeste,BUTANTAN/SINOVAC,1082,546,536
Luisburgo,313867,MG,Sudeste,FIOCRUZ/ASTRAZENECA,767,706,61
Luisburgo,313867,MG,Sudeste,PFIZER/BIONTECH,29,29,0
Luislândia,313868,MG,Sudeste,BUTANTAN/SINOVAC,1060,575,485
Luislândia,313868,MG,Sudeste,FIOCRUZ/ASTRAZENECA,703,639,64
Luislândia,313868,MG,Sudeste,PFIZER/BIONTECH,18,18,0
Luiz Alves,421000,SC,Sul,BUTANTAN/SINOVAC,2138,1126,1012
Luiz Alves,421000,SC,Sul,FIOCRUZ/ASTRAZENECA,2012,1949,63
Luiz Alves,421000,SC,Sul,PFIZER/BIONTECH,497,497,0
Luiziana,411373,PR,Sul,FIOCRUZ/ASTRAZENECA,2270,2174,96
Luiziana,411373,PR,Sul,BUTANTAN/SINOVAC,1326,679,647
Luiziânia,352770,SP,Sudeste,BUTANTAN/SINOVAC,1291,775,516
Luiziânia,352770,SP,Sudeste,FIOCRUZ/ASTRAZENECA,964,863,101
Luiziânia,352770,SP,Sudeste,PFIZER/BIONTECH,196,196,0
Luminárias,313870,MG,Sudeste,BUTANTAN/SINOVAC,1121,586,535
Luminárias,313870,MG,Sudeste,FIOCRUZ/ASTRAZENECA,1107,1020,87
Luminárias,313870,MG,Sudeste,PFIZER/BIONTECH,47,47,0
Lunardelli,411375,PR,Sul,FIOCRUZ/ASTRAZENECA,1449,1354,95
Lunardelli,411375,PR,Sul,BUTANTAN/SINOVAC,1218,632,586
Lupércio,352780,SP,Sudeste,FIOCRUZ/ASTRAZENECA,1155,1046,109
Lupércio,352780,SP,Sudeste,BUTANTAN/SINOVAC,1123,621,502
Lupércio,352780,SP,Sudeste,PFIZER/BIONTECH,36,36,0
Lupionópolis,411380,PR,Sul,FIOCRUZ/ASTRAZENECA,1397,1269,128
Lupionópolis,411380,PR,Sul,BUTANTAN/SINOVAC,1181,600,581
Lupionópolis,411380,PR,Sul,PFIZER/BIONTECH,25,25,0
Lutécia,352790,SP,Sudeste,BUTANTAN/SINOVAC,1160,637,523
Lutécia,352790,SP,Sudeste,FIOCRUZ/ASTRAZENECA,764,692,72
Lutécia,352790,SP,Sudeste,PFIZER/BIONTECH,65,65,0
Luz,313880,MG,Sudeste,BUTANTAN/SINOVAC,4221,2174,2047
Luz,313880,MG,Sudeste,FIOCRUZ/ASTRAZENECA,3790,3442,348
Luzerna,421003,SC,Sul,BUTANTAN/SINOVAC,1858,951,907
Luzerna,421003,SC,Sul,FIOCRUZ/ASTRAZENECA,1749,1651,98
Luzerna,421003,SC,Sul,PFIZER/BIONTECH,202,202,0
Luziânia,521250,GO,Centro-Oeste,FIOCRUZ/ASTRAZENECA,32163,30096,2067
Luziânia,521250,GO,Centro-Oeste,BUTANTAN/SINOVAC,22932,11706,11226
Luziânia,521250,GO,Centro-Oeste,PFIZER/BIONTECH,3741,3739,2
Luzilândia,220580,PI,Nordeste,FIOCRUZ/ASTRAZENECA,3939,3599,340
Luzilândia,220580,PI,Nordeste,BUTANTAN/SINOVAC,3937,2019,1918
Luzilândia,220580,PI,Nordeste,PFIZER/BIONTECH,251,251,0
Luzinópolis,171245,TO,Norte,BUTANTAN/SINOVAC,646,328,318
Luzinópolis,171245,TO,Norte,FIOCRUZ/ASTRAZENECA,403,382,21
Macaé,330240,RJ,Sudeste,FIOCRUZ/ASTRAZENECA,19559,19164,395
Macaé,330240,RJ,Sudeste,BUTANTAN/SINOVAC,19335,12456,6879
Macaé,330240,RJ,Sudeste,PFIZER/BIONTECH,2000,2000,0
Macaíba,240710,RN,Nordeste,FIOCRUZ/ASTRAZENECA,11758,10604,1154
Macaíba,240710,RN,Nordeste,BUTANTAN/SINOVAC,10992,5632,5360
Macaíba,240710,RN,Nordeste,PFIZER/BIONTECH,1730,1727,3
Macajuba,291960,BA,Nordeste,BUTANTAN/SINOVAC,2091,1118,973
Macajuba,291960,BA,Nordeste,FIOCRUZ/ASTRAZENECA,607,543,64
Macajuba,291960,BA,Nordeste,PFIZER/BIONTECH,11,11,0
Maçambará,431171,RS,Sul,BUTANTAN/SINOVAC,945,478,467
Maçambará,431171,RS,Sul,FIOCRUZ/ASTRAZENECA,933,859,74
Maçambará,431171,RS,Sul,PFIZER/BIONTECH,187,187,0
Macambira,280370,SE,Nordeste,BUTANTAN/SINOVAC,1740,934,806
Macambira,280370,SE,Nordeste,FIOCRUZ/ASTRAZENECA,1067,1066,1
Macambira,280370,SE,Nordeste,PFIZER/BIONTECH,185,185,0
Macapá,160030,AP,Norte,BUTANTAN/SINOVAC,72686,38820,33866
Macapá,160030,AP,Norte,FIOCRUZ/ASTRAZENECA,67069,62508,4561
Macapá,160030,AP,Norte,PFIZER/BIONTECH,5397,5389,8
Macaparana,260900,PE,Nordeste,FIOCRUZ/ASTRAZENECA,5070,4668,402
Macaparana,260900,PE,Nordeste,BUTANTAN/SINOVAC,4267,2177,2090
Macaparana,260900,PE,Nordeste,PFIZER/BIONTECH,515,515,0
Macarani,291970,BA,Nordeste,FIOCRUZ/ASTRAZENECA,3930,3567,363
Macarani,291970,BA,Nordeste,BUTANTAN/SINOVAC,3086,1629,1457
Macarani,291970,BA,Nordeste,PFIZER/BIONTECH,350,350,0
Macatuba,352800,SP,Sudeste,FIOCRUZ/ASTRAZENECA,4333,3979,354
Macatuba,352800,SP,Sudeste,BUTANTAN/SINOVAC,4226,2270,1956
Macatuba,352800,SP,Sudeste,PFIZER/BIONTECH,489,489,0
Macau,240720,RN,Nordeste,BUTANTAN/SINOVAC,303,275,28
Macau,240720,RN,Nordeste,FIOCRUZ/ASTRAZENECA,11,11,0
Macaubal,352810,SP,Sudeste,BUTANTAN/SINOVAC,2542,1478,1064
Macaubal,352810,SP,Sudeste,FIOCRUZ/ASTRAZENECA,1953,1786,167
Macaubal,352810,SP,Sudeste,PFIZER/BIONTECH,158,158,0
Macaúbas,291980,BA,Nordeste,BUTANTAN/SINOVAC,7272,4526,2746
Macaúbas,291980,BA,Nordeste,FIOCRUZ/ASTRAZENECA,4331,4080,251
Macaúbas,291980,BA,Nordeste,PFIZER/BIONTECH,96,95,1
Macedônia,352820,SP,Sudeste,BUTANTAN/SINOVAC,1462,791,671
Macedônia,352820,SP,Sudeste,FIOCRUZ/ASTRAZENECA,1302,1199,103
Macedônia,352820,SP,Sudeste,PFIZER/BIONTECH,104,104,0
Maceió,270430,AL,Nordeste,FIOCRUZ/ASTRAZENECA,209634,171015,38619
Maceió,270430,AL,Nordeste,BUTANTAN/SINOVAC,187989,95293,92696
Maceió,270430,AL,Nordeste,PFIZER/BIONTECH,73501,73307,194
Machacalis,313890,MG,Sudeste,BUTANTAN/SINOVAC,1733,925,808
Machacalis,313890,MG,Sudeste,FIOCRUZ/ASTRAZENECA,1000,883,117
Machacalis,313890,MG,Sudeste,PFIZER/BIONTECH,53,53,0
Machadinho,431170,RS,Sul,BUTANTAN/SINOVAC,2029,1054,975
Machadinho,431170,RS,Sul,FIOCRUZ/ASTRAZENECA,1435,1315,120
Machadinho,431170,RS,Sul,PFIZER/BIONTECH,110,110,0
Machadinho D'Oeste,110013,RO,Norte,FIOCRUZ/ASTRAZENECA,5680,5444,236
Machadinho D'Oeste,110013,RO,Norte,BUTANTAN/SINOVAC,4708,2510,2198
Machadinho D'Oeste,110013,RO,Norte,PFIZER/BIONTECH,768,768,0
Machado,313900,MG,Sudeste,BUTANTAN/SINOVAC,7512,3825,3687
Machado,313900,MG,Sudeste,FIOCRUZ/ASTRAZENECA,6824,6169,655
Machado,313900,MG,Sudeste,PFIZER/BIONTECH,972,972,0
Machados,260910,PE,Nordeste,BUTANTAN/SINOVAC,2445,1494,951
Machados,260910,PE,Nordeste,FIOCRUZ/ASTRAZENECA,2102,1939,163
Machados,260910,PE,Nordeste,PFIZER/BIONTECH,285,285,0
Macieira,421005,SC,Sul,FIOCRUZ/ASTRAZENECA,459,417,42
Macieira,421005,SC,Sul,BUTANTAN/SINOVAC,434,229,205
Macieira,421005,SC,Sul,PFIZER/BIONTECH,48,47,1
Macuco,330245,RJ,Sudeste,FIOCRUZ/ASTRAZENECA,2398,2167,231
Macuco,330245,RJ,Sudeste,BUTANTAN/SINOVAC,2313,1224,1089
Macururé,291990,BA,Nordeste,BUTANTAN/SINOVAC,1716,878,838
Macururé,291990,BA,Nordeste,FIOCRUZ/ASTRAZENECA,1697,1557,140
Macururé,291990,BA,Nordeste,PFIZER/BIONTECH,48,48,0
Madalena,230763,CE,Nordeste,BUTANTAN/SINOVAC,3910,1993,1917
Madalena,230763,CE,Nordeste,FIOCRUZ/ASTRAZENECA,1683,1366,317
Madeiro,220585,PI,Nordeste,FIOCRUZ/ASTRAZENECA,1428,1176,252
Madeiro,220585,PI,Nordeste,BUTANTAN/SINOVAC,1027,546,481
Madeiro,220585,PI,Nordeste,PFIZER/BIONTECH,82,82,0
Madre De Deus,291992,BA,Nordeste,FIOCRUZ/ASTRAZENECA,3658,3487,171
Madre De Deus,291992,BA,Nordeste,BUTANTAN/SINOVAC,3454,1851,1603
Madre De Deus,291992,BA,Nordeste,PFIZER/BIONTECH,826,825,1
Madre De Deus De Minas,313910,MG,Sudeste,FIOCRUZ/ASTRAZENECA,1650,1533,117
Madre De Deus De Minas,313910,MG,Sudeste,BUTANTAN/SINOVAC,1200,611,589
Madre De Deus De Minas,313910,MG,Sudeste,PFIZER/BIONTECH,70,70,0
Mãe D'Água,250870,PB,Nordeste,BUTANTAN/SINOVAC,983,493,490
Mãe D'Água,250870,PB,Nordeste,FIOCRUZ/ASTRAZENECA,734,668,66
Mãe D'Água,250870,PB,Nordeste,PFIZER/BIONTECH,51,51,0
Mãe Do Rio,150405,PA,Norte,FIOCRUZ/ASTRAZENECA,5126,4354,772
Mãe Do Rio,150405,PA,Norte,BUTANTAN/SINOVAC,3180,1649,1531
Maetinga,291995,BA,Nordeste,BUTANTAN/SINOVAC,1566,830,736
Maetinga,291995,BA,Nordeste,FIOCRUZ/ASTRAZENECA,1342,1231,111
Maetinga,291995,BA,Nordeste,PFIZER/BIONTECH,37,37,0
Mafra,421010,SC,Sul,FIOCRUZ/ASTRAZENECA,14692,13583,1109
Mafra,421010,SC,Sul,BUTANTAN/SINOVAC,11299,6171,5128
Mafra,421010,SC,Sul,PFIZER/BIONTECH,1369,1369,0
Magalhães Barata,150410,PA,Norte,FIOCRUZ/ASTRAZENECA,1832,1320,512
Magalhães Barata,150410,PA,Norte,BUTANTAN/SINOVAC,1389,748,641
Magalhães De Almeida,210630,MA,Nordeste,BUTANTAN/SINOVAC,2286,1250,1036
Magalhães De Almeida,210630,MA,Nordeste,FIOCRUZ/ASTRAZENECA,2225,2074,151
Magda,352830,SP,Sudeste,BUTANTAN/SINOVAC,1120,626,494
Magda,352830,SP,Sudeste,FIOCRUZ/ASTRAZENECA,797,725,72
Magda,352830,SP,Sudeste,PFIZER/BIONTECH,90,90,0
Magé,330250,RJ,Sudeste,BUTANTAN/SINOVAC,43722,23804,19918
Magé,330250,RJ,Sudeste,FIOCRUZ/ASTRAZENECA,31446,27289,4157
Magé,330250,RJ,Sudeste,PFIZER/BIONTECH,8716,8697,19
Maiquinique,292000,BA,Nordeste,BUTANTAN/SINOVAC,1231,732,499
Maiquinique,292000,BA,Nordeste,FIOCRUZ/ASTRAZENECA,356,281,75
Mairi,292010,BA,Nordeste,BUTANTAN/SINOVAC,4752,2507,2245
Mairi,292010,BA,Nordeste,FIOCRUZ/ASTRAZENECA,4409,3623,786
Mairi,292010,BA,Nordeste,PFIZER/BIONTECH,386,386,0
Mairinque,352840,SP,Sudeste,BUTANTAN/SINOVAC,9929,5477,4452
Mairinque,352840,SP,Sudeste,FIOCRUZ/ASTRAZENECA,9806,9168,638
Mairinque,352840,SP,Sudeste,PFIZER/BIONTECH,228,228,0
Mairiporã,352850,SP,Sudeste,FIOCRUZ/ASTRAZENECA,19217,18518,699
Mairiporã,352850,SP,Sudeste,BUTANTAN/SINOVAC,15151,8312,6839
Mairiporã,352850,SP,Sudeste,PFIZER/BIONTECH,903,903,0
Mairipotaba,521260,GO,Centro-Oeste,FIOCRUZ/ASTRAZENECA,1187,1129,58
Mairipotaba,521260,GO,Centro-Oeste,BUTANTAN/SINOVAC,755,382,373
Mairipotaba,521260,GO,Centro-Oeste,PFIZER/BIONTECH,12,12,0
Major Gercino,421020,SC,Sul,FIOCRUZ/ASTRAZENECA,1219,1076,143
Major Gercino,421020,SC,Sul,BUTANTAN/SINOVAC,652,373,279
Major Isidoro,270440,AL,Nordeste,FIOCRUZ/ASTRAZENECA,4458,4151,307
Major Isidoro,270440,AL,Nordeste,BUTANTAN/SINOVAC,3157,1652,1505
Major Sales,240725,RN,Nordeste,BUTANTAN/SINOVAC,2085,1122,963
Major Sales,240725,RN,Nordeste,FIOCRUZ/ASTRAZENECA,1377,1275,102
Major Sales,240725,RN,Nordeste,PFIZER/BIONTECH,133,133,0
Major Vieira,421030,SC,Sul,FIOCRUZ/ASTRAZENECA,1530,1389,141
Major Vieira,421030,SC,Sul,BUTANTAN/SINOVAC,1482,762,720
Major Vieira,421030,SC,Sul,PFIZER/BIONTECH,192,192,0
Malacacheta,313920,MG,Sudeste,BUTANTAN/SINOVAC,5361,2729,2632
Malacacheta,313920,MG,Sudeste,FIOCRUZ/ASTRAZENECA,3504,3230,274
Malacacheta,313920,MG,Sudeste,PFIZER/BIONTECH,89,89,0
Malhada,292020,BA,Nordeste,FIOCRUZ/ASTRAZENECA,2751,2667,84
Malhada,292020,BA,Nordeste,BUTANTAN/SINOVAC,636,431,205
Malhada De Pedras,292030,BA,Nordeste,BUTANTAN/SINOVAC,1985,985,1000
Malhada De Pedras,292030,BA,Nordeste,FIOCRUZ/ASTRAZENECA,1916,1696,220
Malhada De Pedras,292030,BA,Nordeste,PFIZER/BIONTECH,144,143,1
Malhada Dos Bois,280380,SE,Nordeste,BUTANTAN/SINOVAC,632,361,271
Malhada Dos Bois,280380,SE,Nordeste,FIOCRUZ/ASTRAZENECA,439,412,27
Malhada Dos Bois,280380,SE,Nordeste,PFIZER/BIONTECH,68,68,0
Malhador,280390,SE,Nordeste,BUTANTAN/SINOVAC,2417,1257,1160
Malhador,280390,SE,Nordeste,FIOCRUZ/ASTRAZENECA,2154,2154,0
Malhador,280390,SE,Nordeste,PFIZER/BIONTECH,285,285,0
Mallet,411390,PR,Sul,BUTANTAN/SINOVAC,2719,1396,1323
Mallet,411390,PR,Sul,FIOCRUZ/ASTRAZENECA,2693,2497,196
Mallet,411390,PR,Sul,PFIZER/BIONTECH,110,110,0
Malta,250880,PB,Nordeste,BUTANTAN/SINOVAC,1425,724,701
Malta,250880,PB,Nordeste,FIOCRUZ/ASTRAZENECA,1158,1058,100
Malta,250880,PB,Nordeste,PFIZER/BIONTECH,150,150,0
Mamanguape,250890,PB,Nordeste,BUTANTAN/SINOVAC,6598,3931,2667
Mamanguape,250890,PB,Nordeste,FIOCRUZ/ASTRAZENECA,4105,3767,338
Mamanguape,250890,PB,Nordeste,PFIZER/BIONTECH,60,60,0
Mambaí,521270,GO,Centro-Oeste,FIOCRUZ/ASTRAZENECA,2370,2005,365
Mambaí,521270,GO,Centro-Oeste,BUTANTAN/SINOVAC,529,300,229
Mamborê,411400,PR,Sul,FIOCRUZ/ASTRAZENECA,4530,4283,247
Mamborê,411400,PR,Sul,BUTANTAN/SINOVAC,2889,1463,1426
Mamborê,411400,PR,Sul,PFIZER/BIONTECH,88,88,0
Mamonas,313925,MG,Sudeste,BUTANTAN/SINOVAC,1659,866,793
Mamonas,313925,MG,Sudeste,FIOCRUZ/ASTRAZENECA,1380,1280,100
Mamonas,313925,MG,Sudeste,PFIZER/BIONTECH,81,81,0
Mampituba,431173,RS,Sul,FIOCRUZ/ASTRAZENECA,914,817,97
Mampituba,431173,RS,Sul,BUTANTAN/SINOVAC,642,324,318
Mampituba,431173,RS,Sul,PFIZER/BIONTECH,111,111,0
Manacapuru,130250,AM,Norte,FIOCRUZ/ASTRAZENECA,26859,23606,3253
Manacapuru,130250,AM,Norte,BUTANTAN/SINOVAC,8046,4132,3914
Manaíra,250900,PB,Nordeste,BUTANTAN/SINOVAC,2737,1386,1351
Manaíra,250900,PB,Nordeste,FIOCRUZ/ASTRAZENECA,1792,1626,166
Manaíra,250900,PB,Nordeste,PFIZER/BIONTECH,58,58,0
Manaquiri,130255,AM,Norte,FIOCRUZ/ASTRAZENECA,5529,4640,889
Manaquiri,130255,AM,Norte,BUTANTAN/SINOVAC,3195,1708,1487
Manari,260915,PE,Nordeste,BUTANTAN/SINOVAC,2516,1345,1171
Manari,260915,PE,Nordeste,FIOCRUZ/ASTRAZENECA,2445,2270,175
Manari,260915,PE,Nordeste,PFIZER/BIONTECH,213,213,0
Manaus,130260,AM,Norte,FIOCRUZ/ASTRAZENECA,594804,477723,117081
Manaus,130260,AM,Norte,BUTANTAN/SINOVAC,402157,207322,194835
Manaus,130260,AM,Norte,PFIZER/BIONTECH,44865,44856,9
Mâncio Lima,120033,AC,Norte,FIOCRUZ/ASTRAZENECA,4378,3667,711
Mâncio Lima,120033,AC,Norte,BUTANTAN/SINOVAC,3320,1741,1579
Mandaguaçu,411410,PR,Sul,FIOCRUZ/ASTRAZENECA,5132,4940,192
Mandaguaçu,411410,PR,Sul,BUTANTAN/SINOVAC,4070,2043,2027
Mandaguaçu,411410,PR,Sul,PFIZER/BIONTECH,40,40,0
Mandaguari,411420,PR,Sul,BUTANTAN/SINOVAC,8306,4331,3975
Mandaguari,411420,PR,Sul,FIOCRUZ/ASTRAZENECA,6801,6301,500
Mandaguari,411420,PR,Sul,PFIZER/BIONTECH,776,776,0
Mandirituba,411430,PR,Sul,FIOCRUZ/ASTRAZENECA,5643,5456,187
Mandirituba,411430,PR,Sul,BUTANTAN/SINOVAC,4082,2210,1872
Mandirituba,411430,PR,Sul,PFIZER/BIONTECH,280,280,0
Manduri,352860,SP,Sudeste,BUTANTAN/SINOVAC,2522,1370,1152
Manduri,352860,SP,Sudeste,FIOCRUZ/ASTRAZENECA,1991,1855,136
Manduri,352860,SP,Sudeste,PFIZER/BIONTECH,254,254,0
Manfrinópolis,411435,PR,Sul,FIOCRUZ/ASTRAZENECA,863,825,38
Manfrinópolis,411435,PR,Sul,BUTANTAN/SINOVAC,629,334,295
Manfrinópolis,411435,PR,Sul,PFIZER/BIONTECH,12,12,0
Manga,313930,MG,Sudeste,FIOCRUZ/ASTRAZENECA,5073,4111,962
Manga,313930,MG,Sudeste,BUTANTAN/SINOVAC,3743,1967,1776
Manga,313930,MG,Sudeste,PFIZER/BIONTECH,30,30,0
Mangaratiba,330260,RJ,Sudeste,BUTANTAN/SINOVAC,10332,5376,4956
Mangaratiba,330260,RJ,Sudeste,FIOCRUZ/ASTRAZENECA,8946,8111,835
Mangaratiba,330260,RJ,Sudeste,PFIZER/BIONTECH,277,277,0
Mangueirinha,411440,PR,Sul,BUTANTAN/SINOVAC,4065,2098,1967
Mangueirinha,411440,PR,Sul,FIOCRUZ/ASTRAZENECA,3585,3400,185
Mangueirinha,411440,PR,Sul,PFIZER/BIONTECH,169,169,0
Manhuaçu,313940,MG,Sudeste,FIOCRUZ/ASTRAZENECA,15687,14232,1455
Manhuaçu,313940,MG,Sudeste,BUTANTAN/SINOVAC,14812,7835,6977
Manhuaçu,313940,MG,Sudeste,PFIZER/BIONTECH,1654,1652,2
Manhumirim,313950,MG,Sudeste,BUTANTAN/SINOVAC,4611,2364,2247
Manhumirim,313950,MG,Sudeste,FIOCRUZ/ASTRAZENECA,3131,2892,239
Manhumirim,313950,MG,Sudeste,PFIZER/BIONTECH,1,1,0
Manicoré,130270,AM,Norte,FIOCRUZ/ASTRAZENECA,13903,12821,1082
Manicoré,130270,AM,Norte,BUTANTAN/SINOVAC,3728,2027,1701
Manoel Emídio,220590,PI,Nordeste,FIOCRUZ/ASTRAZENECA,1032,961,71
Manoel Emídio,220590,PI,Nordeste,BUTANTAN/SINOVAC,918,508,410
Manoel Ribas,411450,PR,Sul,BUTANTAN/SINOVAC,4610,2456,2154
Manoel Ribas,411450,PR,Sul,FIOCRUZ/ASTRAZENECA,3080,2867,213
Manoel Ribas,411450,PR,Sul,PFIZER/BIONTECH,191,190,1
Manoel Urbano,120034,AC,Norte,FIOCRUZ/ASTRAZENECA,2212,1935,277
Manoel Urbano,120034,AC,Norte,BUTANTAN/SINOVAC,1484,828,656
Manoel Urbano,120034,AC,Norte,PFIZER/BIONTECH,28,28,0
Manoel Viana,431175,RS,Sul,BUTANTAN/SINOVAC,2207,1115,1092
Manoel Viana,431175,RS,Sul,FIOCRUZ/ASTRAZENECA,2011,1769,242
Manoel Viana,431175,RS,Sul,PFIZER/BIONTECH,266,266,0
Manoel Vitorino,292040,BA,Nordeste,FIOCRUZ/ASTRAZENECA,3192,2796,396
Manoel Vitorino,292040,BA,Nordeste,BUTANTAN/SINOVAC,3082,1561,1521
Manoel Vitorino,292040,BA,Nordeste,PFIZER/BIONTECH,119,119,0
Mansidão,292045,BA,Nordeste,BUTANTAN/SINOVAC,2031,1039,992
Mansidão,292045,BA,Nordeste,FIOCRUZ/ASTRAZENECA,1984,1879,105
Mansidão,292045,BA,Nordeste,PFIZER/BIONTECH,70,70,0
Mantena,313960,MG,Sudeste,BUTANTAN/SINOVAC,5131,3099,2032
Mantena,313960,MG,Sudeste,FIOCRUZ/ASTRAZENECA,4075,3832,243
Mantena,313960,MG,Sudeste,PFIZER/BIONTECH,106,106,0
Mantenópolis,320330,ES,Sudeste,BUTANTAN/SINOVAC,4402,2407,1995
Mantenópolis,320330,ES,Sudeste,FIOCRUZ/ASTRAZENECA,3185,3016,169
Mantenópolis,320330,ES,Sudeste,PFIZER/BIONTECH,525,522,3
Maquiné,431177,RS,Sul,FIOCRUZ/ASTRAZENECA,2222,1988,234
Maquiné,431177,RS,Sul,BUTANTAN/SINOVAC,2143,1101,1042
Maquiné,431177,RS,Sul,PFIZER/BIONTECH,269,269,0
Mar De Espanha,313980,MG,Sudeste,BUTANTAN/SINOVAC,2750,1398,1352
Mar De Espanha,313980,MG,Sudeste,FIOCRUZ/ASTRAZENECA,2740,2507,233
Mar De Espanha,313980,MG,Sudeste,PFIZER/BIONTECH,151,151,0
Mar Vermelho,270490,AL,Nordeste,BUTANTAN/SINOVAC,817,411,406
Mar Vermelho,270490,AL,Nordeste,FIOCRUZ/ASTRAZENECA,810,667,143
Mar Vermelho,270490,AL,Nordeste,PFIZER/BIONTECH,41,41,0
Mara Rosa,521280,GO,Centro-Oeste,FIOCRUZ/ASTRAZENECA,3033,2911,122
Mara Rosa,521280,GO,Centro-Oeste,BUTANTAN/SINOVAC,1656,934,722
Maraã,130280,AM,Norte,BUTANTAN/SINOVAC,1740,964,776
Maraã,130280,AM,Norte,FIOCRUZ/ASTRAZENECA,1173,891,282
Marabá,150420,PA,Norte,FIOCRUZ/ASTRAZENECA,35830,32214,3616
Marabá,150420,PA,Norte,BUTANTAN/SINOVAC,16598,9356,7242
Marabá,150420,PA,Norte,PFIZER/BIONTECH,5339,5328,11
Marabá Paulista,352870,SP,Sudeste,BUTANTAN/SINOVAC,1171,704,467
Marabá Paulista,352870,SP,Sudeste,FIOCRUZ/ASTRAZENECA,1165,1093,72
Marabá Paulista,352870,SP,Sudeste,PFIZER/BIONTECH,153,153,0
Maracaçumé,210632,MA,Nordeste,FIOCRUZ/ASTRAZENECA,3520,3310,210
Maracaçumé,210632,MA,Nordeste,BUTANTAN/SINOVAC,2541,1328,1213
Maracaí,352880,SP,Sudeste,FIOCRUZ/ASTRAZENECA,3662,3406,256
Maracaí,352880,SP,Sudeste,BUTANTAN/SINOVAC,3444,1941,1503
Maracaí,352880,SP,Sudeste,PFIZER/BIONTECH,507,507,0
Maracajá,421040,SC,Sul,FIOCRUZ/ASTRAZENECA,1969,1853,116
Maracajá,421040,SC,Sul,BUTANTAN/SINOVAC,1539,786,753
Maracajá,421040,SC,Sul,PFIZER/BIONTECH,175,175,0
Maracaju,500540,MS,Centro-Oeste,FIOCRUZ/ASTRAZENECA,9534,8081,1453
Maracaju,500540,MS,Centro-Oeste,BUTANTAN/SINOVAC,7657,4207,3450
Maracaju,500540,MS,Centro-Oeste,PFIZER/BIONTECH,1724,1720,4
Maracanã,150430,PA,Norte,BUTANTAN/SINOVAC,3233,2011,1222
Maracanã,150430,PA,Norte,FIOCRUZ/ASTRAZENECA,2287,1878,409
Maracanaú,230765,CE,Nordeste,BUTANTAN/SINOVAC,32670,17425,15245
Maracanaú,230765,CE,Nordeste,FIOCRUZ/ASTRAZENECA,31193,30392,801
Maracanaú,230765,CE,Nordeste,PFIZER/BIONTECH,2455,2453,2
Maracás,292050,BA,Nordeste,BUTANTAN/SINOVAC,5103,2641,2462
Maracás,292050,BA,Nordeste,FIOCRUZ/ASTRAZENECA,5028,4631,397
Maracás,292050,BA,Nordeste,PFIZER/BIONTECH,160,160,0
Maragogi,270450,AL,Nordeste,BUTANTAN/SINOVAC,4410,2264,2146
Maragogi,270450,AL,Nordeste,FIOCRUZ/ASTRAZENECA,4331,4039,292
Maragogi,270450,AL,Nordeste,PFIZER/BIONTECH,186,186,0
Maragogipe,292060,BA,Nordeste,FIOCRUZ/ASTRAZENECA,6995,6014,981
Maragogipe,292060,BA,Nordeste,BUTANTAN/SINOVAC,5348,3217,2131
Maragogipe,292060,BA,Nordeste,PFIZER/BIONTECH,371,371,0
Maraial,260920,PE,Nordeste,FIOCRUZ/ASTRAZENECA,1733,1610,123
Maraial,260920,PE,Nordeste,BUTANTAN/SINOVAC,1715,887,828
Maraial,260920,PE,Nordeste,PFIZER/BIONTECH,179,177,2
Marajá Do Sena,210635,MA,Nordeste,FIOCRUZ/ASTRAZENECA,927,875,52
Marajá Do Sena,210635,MA,Nordeste,BUTANTAN/SINOVAC,490,259,231
Maranguape,230770,CE,Nordeste,BUTANTAN/SINOVAC,5857,4552,1305
Maranguape,230770,CE,Nordeste,FIOCRUZ/ASTRAZENECA,1630,1628,2
Maranhãozinho,210637,MA,Nordeste,FIOCRUZ/ASTRAZENECA,1985,1892,93
Maranhãozinho,210637,MA,Nordeste,BUTANTAN/SINOVAC,1326,695,631
Marapanim,150440,PA,Norte,FIOCRUZ/ASTRAZENECA,5215,3677,1538
Marapanim,150440,PA,Norte,BUTANTAN/SINOVAC,4326,2355,1971
Marapoama,352885,SP,Sudeste,BUTANTAN/SINOVAC,940,520,420
Marapoama,352885,SP,Sudeste,FIOCRUZ/ASTRAZENECA,908,805,103
Marapoama,352885,SP,Sudeste,PFIZER/BIONTECH,124,124,0
Maratá,431179,RS,Sul,BUTANTAN/SINOVAC,2056,1115,941
Maratá,431179,RS,Sul,FIOCRUZ/ASTRAZENECA,1136,1005,131
Maratá,431179,RS,Sul,PFIZER/BIONTECH,128,128,0
Marataízes,320332,ES,Sudeste,BUTANTAN/SINOVAC,10303,5407,4896
Marataízes,320332,ES,Sudeste,FIOCRUZ/ASTRAZENECA,9281,8975,306
Marataízes,320332,ES,Sudeste,PFIZER/BIONTECH,1310,1310,0
Marau,431180,RS,Sul,FIOCRUZ/ASTRAZENECA,10886,10291,595
Marau,431180,RS,Sul,BUTANTAN/SINOVAC,7915,3981,3934
Marau,431180,RS,Sul,PFIZER/BIONTECH,1025,1025,0
Maraú,292070,BA,Nordeste,FIOCRUZ/ASTRAZENECA,5390,5280,110
Maraú,292070,BA,Nordeste,BUTANTAN/SINOVAC,2396,1242,1154
Maraú,292070,BA,Nordeste,PFIZER/BIONTECH,24,24,0
Maravilha,270460,AL,Nordeste,FIOCRUZ/ASTRAZENECA,2064,1968,96
Maravilha,270460,AL,Nordeste,BUTANTAN/SINOVAC,1654,841,813
Maravilha,421050,SC,Sul,FIOCRUZ/ASTRAZENECA,7047,6456,591
Maravilha,421050,SC,Sul,BUTANTAN/SINOVAC,5773,3123,2650
Maravilha,421050,SC,Sul,PFIZER/BIONTECH,654,654,0
Maravilhas,313970,MG,Sudeste,FIOCRUZ/ASTRAZENECA,1469,1363,106
Maravilhas,313970,MG,Sudeste,BUTANTAN/SINOVAC,1256,642,614
Maravilhas,313970,MG,Sudeste,PFIZER/BIONTECH,155,155,0
Marcação,250905,PB,Nordeste,BUTANTAN/SINOVAC,8189,4443,3746
Marcação,250905,PB,Nordeste,FIOCRUZ/ASTRAZENECA,1180,1101,79
Marcação,250905,PB,Nordeste,PFIZER/BIONTECH,12,12,0
Marcelândia,510558,MT,Centro-Oeste,FIOCRUZ/ASTRAZENECA,3311,2440,871
Marcelândia,510558,MT,Centro-Oeste,BUTANTAN/SINOVAC,1833,953,880
Marcelândia,510558,MT,Centro-Oeste,PFIZER/BIONTECH,12,12,0
Marcelino Ramos,431190,RS,Sul,BUTANTAN/SINOVAC,1526,767,759
Marcelino Ramos,431190,RS,Sul,FIOCRUZ/ASTRAZENECA,1459,1297,162
Marcelino Ramos,431190,RS,Sul,PFIZER/BIONTECH,176,176,0
Marcelino Vieira,240730,RN,Nordeste,BUTANTAN/SINOVAC,1873,960,913
Marcelino Vieira,240730,RN,Nordeste,FIOCRUZ/ASTRAZENECA,1685,1584,101
Marcelino Vieira,240730,RN,Nordeste,PFIZER/BIONTECH,243,243,0
Marcionílio Souza,292080,BA,Nordeste,BUTANTAN/SINOVAC,1863,959,904
Marcionílio Souza,292080,BA,Nordeste,FIOCRUZ/ASTRAZENECA,1713,1608,105
Marcionílio Souza,292080,BA,Nordeste,PFIZER/BIONTECH,4,4,0
Marco,230780,CE,Nordeste,BUTANTAN/SINOVAC,3134,1680,1454
Marco,230780,CE,Nordeste,FIOCRUZ/ASTRAZENECA,1569,1339,230
Marcolândia,220595,PI,Nordeste,FIOCRUZ/ASTRAZENECA,1250,1233,17
Marcolândia,220595,PI,Nordeste,BUTANTAN/SINOVAC,1204,627,577
Marcos Parente,220600,PI,Nordeste,BUTANTAN/SINOVAC,912,469,443
Marcos Parente,220600,PI,Nordeste,FIOCRUZ/ASTRAZENECA,809,738,71
Marcos Parente,220600,PI,Nordeste,PFIZER/BIONTECH,95,95,0
Marechal Cândido Rondon,411460,PR,Sul,BUTANTAN/SINOVAC,11305,5755,5550
Marechal Cândido Rondon,411460,PR,Sul,FIOCRUZ/ASTRAZENECA,10571,9772,799
Marechal Cândido Rondon,411460,PR,Sul,PFIZER/BIONTECH,2558,2558,0
Marechal Deodoro,270470,AL,Nordeste,FIOCRUZ/ASTRAZENECA,10609,10090,519
Marechal Deodoro,270470,AL,Nordeste,BUTANTAN/SINOVAC,7957,4157,3800
Marechal Deodoro,270470,AL,Nordeste,PFIZER/BIONTECH,3470,3467,3
Marechal Floriano,320334,ES,Sudeste,BUTANTAN/SINOVAC,4382,2393,1989
Marechal Floriano,320334,ES,Sudeste,FIOCRUZ/ASTRAZENECA,3666,3527,139
Marechal Floriano,320334,ES,Sudeste,PFIZER/BIONTECH,537,537,0
Marechal Thaumaturgo,120035,AC,Norte,BUTANTAN/SINOVAC,5997,3601,2396
Marechal Thaumaturgo,120035,AC,Norte,FIOCRUZ/ASTRAZENECA,1192,1027,165
Marema,421055,SC,Sul,FIOCRUZ/ASTRAZENECA,679,643,36
Marema,421055,SC,Sul,BUTANTAN/SINOVAC,596,331,265
Marema,421055,SC,Sul,PFIZER/BIONTECH,65,65,0
Mari,250910,PB,Nordeste,BUTANTAN/SINOVAC,4952,2485,2467
Mari,250910,PB,Nordeste,FIOCRUZ/ASTRAZENECA,3873,3519,354
Mari,250910,PB,Nordeste,PFIZER/BIONTECH,451,451,0
Maria Da Fé,313990,MG,Sudeste,FIOCRUZ/ASTRAZENECA,3123,2926,197
Maria Da Fé,313990,MG,Sudeste,BUTANTAN/SINOVAC,3095,1579,1516
Maria Da Fé,313990,MG,Sudeste,PFIZER/BIONTECH,124,124,0
Maria Helena,411470,PR,Sul,FIOCRUZ/ASTRAZENECA,1579,1469,110
Maria Helena,411470,PR,Sul,BUTANTAN/SINOVAC,1285,652,633
Marialva,411480,PR,Sul,FIOCRUZ/ASTRAZENECA,8856,8467,389
Marialva,411480,PR,Sul,BUTANTAN/SINOVAC,7392,3819,3573
Marialva,411480,PR,Sul,PFIZER/BIONTECH,364,364,0
Mariana,314000,MG,Sudeste,FIOCRUZ/ASTRAZENECA,12837,11688,1149
Mariana,314000,MG,Sudeste,BUTANTAN/SINOVAC,10239,5309,4930
Mariana,314000,MG,Sudeste,PFIZER/BIONTECH,2109,2108,1
Mariana Pimentel,431198,RS,Sul,BUTANTAN/SINOVAC,1531,790,741
Mariana Pimentel,431198,RS,Sul,FIOCRUZ/ASTRAZENECA,913,818,95
Mariana Pimentel,431198,RS,Sul,PFIZER/BIONTECH,134,134,0
Mariano Moro,431200,RS,Sul,BUTANTAN/SINOVAC,777,390,387
Mariano Moro,431200,RS,Sul,FIOCRUZ/ASTRAZENECA,689,632,57
Mariano Moro,431200,RS,Sul,PFIZER/BIONTECH,96,96,0
Marianópolis Do Tocantins,171250,TO,Norte,BUTANTAN/SINOVAC,692,365,327
Marianópolis Do Tocantins,171250,TO,Norte,FIOCRUZ/ASTRAZENECA,522,486,36
Mariápolis,352890,SP,Sudeste,FIOCRUZ/ASTRAZENECA,1073,975,98
Mariápolis,352890,SP,Sudeste,BUTANTAN/SINOVAC,905,452,453
Mariápolis,352890,SP,Sudeste,PFIZER/BIONTECH,134,134,0
Maribondo,270480,AL,Nordeste,FIOCRUZ/ASTRAZENECA,3233,3000,233
Maribondo,270480,AL,Nordeste,BUTANTAN/SINOVAC,2318,1176,1142
Maricá,330270,RJ,Sudeste,BUTANTAN/SINOVAC,29113,20635,8478
Maricá,330270,RJ,Sudeste,FIOCRUZ/ASTRAZENECA,4265,4246,19
Marilac,314010,MG,Sudeste,BUTANTAN/SINOVAC,906,455,451
Marilac,314010,MG,Sudeste,FIOCRUZ/ASTRAZENECA,803,699,104
Marilac,314010,MG,Sudeste,PFIZER/BIONTECH,58,58,0
Marilândia,320335,ES,Sudeste,BUTANTAN/SINOVAC,3734,1864,1870
Marilândia,320335,ES,Sudeste,FIOCRUZ/ASTRAZENECA,2869,2719,150
Marilândia,320335,ES,Sudeste,PFIZER/BIONTECH,464,464,0
Marilândia Do Sul,411490,PR,Sul,FIOCRUZ/ASTRAZENECA,2852,2718,134
Marilândia Do Sul,411490,PR,Sul,BUTANTAN/SINOVAC,1808,997,811
Marilândia Do Sul,411490,PR,Sul,PFIZER/BIONTECH,99,99,0
Marilena,411500,PR,Sul,FIOCRUZ/ASTRAZENECA,2056,1928,128
Marilena,411500,PR,Sul,BUTANTAN/SINOVAC,1813,960,853
Marilena,411500,PR,Sul,PFIZER/BIONTECH,30,30,0
Marília,352900,SP,Sudeste,FIOCRUZ/ASTRAZENECA,68204,62190,6014
Marília,352900,SP,Sudeste,BUTANTAN/SINOVAC,61361,33642,27719
Marília,352900,SP,Sudeste,PFIZER/BIONTECH,5753,5746,7
Mariluz,411510,PR,Sul,BUTANTAN/SINOVAC,1896,1045,851
Mariluz,411510,PR,Sul,FIOCRUZ/ASTRAZENECA,1830,1750,80
Maringá,411520,PR,Sul,FIOCRUZ/ASTRAZENECA,140083,130975,9108
Maringá,411520,PR,Sul,BUTANTAN/SINOVAC,139443,72826,66617
Maringá,411520,PR,Sul,PFIZER/BIONTECH,27009,27007,2
Marinópolis,352910,SP,Sudeste,BUTANTAN/SINOVAC,1309,713,596
Marinópolis,352910,SP,Sudeste,FIOCRUZ/ASTRAZENECA,936,841,95
Marinópolis,352910,SP,Sudeste,PFIZER/BIONTECH,81,81,0
Mário Campos,314015,MG,Sudeste,BUTANTAN/SINOVAC,1431,957,474
Mário Campos,314015,MG,Sudeste,FIOCRUZ/ASTRAZENECA,1281,1254,27
Mário Campos,314015,MG,Sudeste,PFIZER/BIONTECH,74,74,0
Mariópolis,411530,PR,Sul,BUTANTAN/SINOVAC,1775,902,873
Mariópolis,411530,PR,Sul,FIOCRUZ/ASTRAZENECA,1489,1408,81
Maripá,411535,PR,Sul,BUTANTAN/SINOVAC,1522,774,748
Maripá,411535,PR,Sul,FIOCRUZ/ASTRAZENECA,1383,1278,105
Maripá,411535,PR,Sul,PFIZER/BIONTECH,30,30,0
Maripá De Minas,314020,MG,Sudeste,BUTANTAN/SINOVAC,397,317,80
Maripá De Minas,314020,MG,Sudeste,FIOCRUZ/ASTRAZENECA,356,353,3
Maripá De Minas,314020,MG,Sudeste,PFIZER/BIONTECH,30,30,0
Marituba,150442,PA,Norte,BUTANTAN/SINOVAC,16162,8428,7734
Marituba,150442,PA,Norte,FIOCRUZ/ASTRAZENECA,11077,10869,208
Marituba,150442,PA,Norte,PFIZER/BIONTECH,2099,2099,0
Marizópolis,250915,PB,Nordeste,BUTANTAN/SINOVAC,2194,1195,999
Marizópolis,250915,PB,Nordeste,FIOCRUZ/ASTRAZENECA,1242,1127,115
Marizópolis,250915,PB,Nordeste,PFIZER/BIONTECH,30,29,1
Marliéria,314030,MG,Sudeste,FIOCRUZ/ASTRAZENECA,1189,1025,164
Marliéria,314030,MG,Sudeste,BUTANTAN/SINOVAC,989,501,488
Marliéria,314030,MG,Sudeste,PFIZER/BIONTECH,132,132,0
Marmeleiro,411540,PR,Sul,FIOCRUZ/ASTRAZENECA,3585,3329,256
Marmeleiro,411540,PR,Sul,BUTANTAN/SINOVAC,3167,1621,1546
Marmeleiro,411540,PR,Sul,PFIZER/BIONTECH,130,130,0
Marmelópolis,314040,MG,Sudeste,BUTANTAN/SINOVAC,746,389,357
Marmelópolis,314040,MG,Sudeste,FIOCRUZ/ASTRAZENECA,651,604,47
Marmelópolis,314040,MG,Sudeste,PFIZER/BIONTECH,94,94,0
Marques De Souza,431205,RS,Sul,BUTANTAN/SINOVAC,1575,800,775
Marques De Souza,431205,RS,Sul,FIOCRUZ/ASTRAZENECA,1147,988,159
Marques De Souza,431205,RS,Sul,PFIZER/BIONTECH,118,118,0
Marquinho,411545,PR,Sul,FIOCRUZ/ASTRAZENECA,959,896,63
Marquinho,411545,PR,Sul,BUTANTAN/SINOVAC,783,410,373
Martinho Campos,314050,MG,Sudeste,BUTANTAN/SINOVAC,3012,1537,1475
Martinho Campos,314050,MG,Sudeste,FIOCRUZ/ASTRAZENECA,2964,2717,247
Martinho Campos,314050,MG,Sudeste,PFIZER/BIONTECH,280,280,0
Martinópole,230790,CE,Nordeste,BUTANTAN/SINOVAC,2133,1169,964
Martinópole,230790,CE,Nordeste,FIOCRUZ/ASTRAZENECA,952,773,179
Martinópole,230790,CE,Nordeste,PFIZER/BIONTECH,12,12,0
Martinópolis,352920,SP,Sudeste,BUTANTAN/SINOVAC,6965,4094,2871
Martinópolis,352920,SP,Sudeste,FIOCRUZ/ASTRAZENECA,6549,6005,544
Martinópolis,352920,SP,Sudeste,PFIZER/BIONTECH,525,525,0
Martins,240740,RN,Nordeste,FIOCRUZ/ASTRAZENECA,2480,2349,131
Martins,240740,RN,Nordeste,BUTANTAN/SINOVAC,2423,1087,1336
Martins,240740,RN,Nordeste,PFIZER/BIONTECH,285,285,0
Martins Soares,314053,MG,Sudeste,FIOCRUZ/ASTRAZENECA,1532,1441,91
Martins Soares,314053,MG,Sudeste,BUTANTAN/SINOVAC,1407,739,668
Martins Soares,314053,MG,Sudeste,PFIZER/BIONTECH,271,271,0
Maruim,280400,SE,Nordeste,BUTANTAN/SINOVAC,2765,1426,1339
Maruim,280400,SE,Nordeste,FIOCRUZ/ASTRAZENECA,2178,2177,1
Maruim,280400,SE,Nordeste,PFIZER/BIONTECH,277,277,0
Marumbi,411550,PR,Sul,FIOCRUZ/ASTRAZENECA,1592,1499,93
Marumbi,411550,PR,Sul,BUTANTAN/SINOVAC,1112,584,528
Marumbi,411550,PR,Sul,PFIZER/BIONTECH,18,18,0
Marzagão,521290,GO,Centro-Oeste,FIOCRUZ/ASTRAZENECA,809,758,51
Marzagão,521290,GO,Centro-Oeste,BUTANTAN/SINOVAC,418,222,196
Marzagão,521290,GO,Centro-Oeste,PFIZER/BIONTECH,13,13,0
Mascote,292090,BA,Nordeste,BUTANTAN/SINOVAC,2700,1466,1234
Mascote,292090,BA,Nordeste,FIOCRUZ/ASTRAZENECA,1542,1428,114
Mascote,292090,BA,Nordeste,PFIZER/BIONTECH,13,13,0
Massapê,230800,CE,Nordeste,BUTANTAN/SINOVAC,5737,2925,2812
Massapê,230800,CE,Nordeste,FIOCRUZ/ASTRAZENECA,3755,3221,534
Massapê Do Piauí,220605,PI,Nordeste,BUTANTAN/SINOVAC,1387,761,626
Massapê Do Piauí,220605,PI,Nordeste,FIOCRUZ/ASTRAZENECA,1009,894,115
Massaranduba,250920,PB,Nordeste,BUTANTAN/SINOVAC,2931,1476,1455
Massaranduba,250920,PB,Nordeste,FIOCRUZ/ASTRAZENECA,2134,1908,226
Massaranduba,250920,PB,Nordeste,PFIZER/BIONTECH,122,122,0
Massaranduba,421060,SC,Sul,FIOCRUZ/ASTRAZENECA,4239,3938,301
Massaranduba,421060,SC,Sul,BUTANTAN/SINOVAC,3632,1895,1737
Massaranduba,421060,SC,Sul,PFIZER/BIONTECH,296,296,0
Mata,431210,RS,Sul,BUTANTAN/SINOVAC,1587,806,781
Mata,431210,RS,Sul,FIOCRUZ/ASTRAZENECA,1425,1189,236
Mata,431210,RS,Sul,PFIZER/BIONTECH,175,175,0
Mata De São João,292100,BA,Nordeste,FIOCRUZ/ASTRAZENECA,8582,7552,1030
Mata De São João,292100,BA,Nordeste,BUTANTAN/SINOVAC,6563,3434,3129
Mata De São João,292100,BA,Nordeste,PFIZER/BIONTECH,2335,2331,4
Mata Grande,270500,AL,Nordeste,FIOCRUZ/ASTRAZENECA,4070,3479,591
Mata Grande,270500,AL,Nordeste,BUTANTAN/SINOVAC,3846,1926,1920
Mata Roma,210640,MA,Nordeste,FIOCRUZ/ASTRAZENECA,3703,2687,1016
Mata Roma,210640,MA,Nordeste,BUTANTAN/SINOVAC,2121,1115,1006
Mata Verde,314055,MG,Sudeste,BUTANTAN/SINOVAC,1796,953,843
Mata Verde,314055,MG,Sudeste,FIOCRUZ/ASTRAZENECA,1699,1503,196
Mata Verde,314055,MG,Sudeste,PFIZER/BIONTECH,40,40,0
Matão,352930,SP,Sudeste,FIOCRUZ/ASTRAZENECA,21591,20256,1335
Matão,352930,SP,Sudeste,BUTANTAN/SINOVAC,19935,11169,8766
Matão,352930,SP,Sudeste,PFIZER/BIONTECH,1277,1277,0
Mataraca,250930,PB,Nordeste,BUTANTAN/SINOVAC,1099,575,524
Mataraca,250930,PB,Nordeste,FIOCRUZ/ASTRAZENECA,711,681,30
Mateiros,171270,TO,Norte,FIOCRUZ/ASTRAZENECA,764,709,55
Mateiros,171270,TO,Norte,BUTANTAN/SINOVAC,299,178,121
Matelândia,411560,PR,Sul,FIOCRUZ/ASTRAZENECA,3723,3455,268
Matelândia,411560,PR,Sul,BUTANTAN/SINOVAC,3521,1887,1634
Matelândia,411560,PR,Sul,PFIZER/BIONTECH,197,197,0
Materlândia,314060,MG,Sudeste,FIOCRUZ/ASTRAZENECA,1904,1800,104
Materlândia,314060,MG,Sudeste,BUTANTAN/SINOVAC,1172,601,571
Materlândia,314060,MG,Sudeste,PFIZER/BIONTECH,64,64,0
Mateus Leme,314070,MG,Sudeste,FIOCRUZ/ASTRAZENECA,6331,5813,518
Mateus Leme,314070,MG,Sudeste,BUTANTAN/SINOVAC,6141,3166,2975
Mateus Leme,314070,MG,Sudeste,PFIZER/BIONTECH,960,960,0
Mathias Lobato,317150,MG,Sudeste,FIOCRUZ/ASTRAZENECA,783,733,50
Mathias Lobato,317150,MG,Sudeste,BUTANTAN/SINOVAC,648,335,313
Mathias Lobato,317150,MG,Sudeste,PFIZER/BIONTECH,54,54,0
Matias Barbosa,314080,MG,Sudeste,BUTANTAN/SINOVAC,2233,1112,1121
Matias Barbosa,314080,MG,Sudeste,FIOCRUZ/ASTRAZENECA,1207,1130,77
Matias Barbosa,314080,MG,Sudeste,PFIZER/BIONTECH,18,18,0
Matias Cardoso,314085,MG,Sudeste,FIOCRUZ/ASTRAZENECA,2360,2268,92
Matias Cardoso,314085,MG,Sudeste,BUTANTAN/SINOVAC,1224,702,522
Matias Olímpio,220610,PI,Nordeste,BUTANTAN/SINOVAC,1646,965,681
Matias Olímpio,220610,PI,Nordeste,FIOCRUZ/ASTRAZENECA,1575,1476,99
Matias Olímpio,220610,PI,Nordeste,PFIZER/BIONTECH,125,125,0
Matina,292105,BA,Nordeste,FIOCRUZ/ASTRAZENECA,2365,2156,209
Matina,292105,BA,Nordeste,BUTANTAN/SINOVAC,2245,1175,1070
Matina,292105,BA,Nordeste,PFIZER/BIONTECH,43,43,0
Matinha,210650,MA,Nordeste,FIOCRUZ/ASTRAZENECA,6552,5997,555
Matinha,210650,MA,Nordeste,BUTANTAN/SINOVAC,3164,1691,1473
Matinhas,250933,PB,Nordeste,BUTANTAN/SINOVAC,961,521,440
Matinhas,250933,PB,Nordeste,FIOCRUZ/ASTRAZENECA,594,532,62
Matinhas,250933,PB,Nordeste,PFIZER/BIONTECH,21,21,0
Matinhos,411570,PR,Sul,FIOCRUZ/ASTRAZENECA,10352,10132,220
Matinhos,411570,PR,Sul,BUTANTAN/SINOVAC,8090,4289,3801
Matipó,314090,MG,Sudeste,BUTANTAN/SINOVAC,2170,1193,977
Matipó,314090,MG,Sudeste,FIOCRUZ/ASTRAZENECA,1997,1841,156
Mato Castelhano,431213,RS,Sul,BUTANTAN/SINOVAC,771,392,379
Mato Castelhano,431213,RS,Sul,FIOCRUZ/ASTRAZENECA,585,534,51
Mato Castelhano,431213,RS,Sul,PFIZER/BIONTECH,126,122,4
Mato Grosso,250937,PB,Nordeste,BUTANTAN/SINOVAC,628,318,310
Mato Grosso,250937,PB,Nordeste,FIOCRUZ/ASTRAZENECA,588,535,53
Mato Grosso,250937,PB,Nordeste,PFIZER/BIONTECH,47,47,0
Mato Leitão,431215,RS,Sul,FIOCRUZ/ASTRAZENECA,1282,1130,152
Mato Leitão,431215,RS,Sul,BUTANTAN/SINOVAC,1140,569,571
Mato Leitão,431215,RS,Sul,PFIZER/BIONTECH,191,191,0
Mato Queimado,431217,RS,Sul,BUTANTAN/SINOVAC,674,337,337
Mato Queimado,431217,RS,Sul,FIOCRUZ/ASTRAZENECA,510,427,83
Mato Queimado,431217,RS,Sul,PFIZER/BIONTECH,45,45,0
Mato Rico,411573,PR,Sul,FIOCRUZ/ASTRAZENECA,991,932,59
Mato Rico,411573,PR,Sul,BUTANTAN/SINOVAC,726,374,352
Mato Verde,314100,MG,Sudeste,BUTANTAN/SINOVAC,3014,1754,1260
Mato Verde,314100,MG,Sudeste,FIOCRUZ/ASTRAZENECA,2951,2787,164
Mato Verde,314100,MG,Sudeste,PFIZER/BIONTECH,54,54,0
Matões,210660,MA,Nordeste,FIOCRUZ/ASTRAZENECA,8498,7460,1038
Matões,210660,MA,Nordeste,BUTANTAN/SINOVAC,4463,2408,2055
Matões Do Norte,210663,MA,Nordeste,FIOCRUZ/ASTRAZENECA,2905,2835,70
Matões Do Norte,210663,MA,Nordeste,BUTANTAN/SINOVAC,1429,796,633
Matos Costa,421070,SC,Sul,FIOCRUZ/ASTRAZENECA,566,505,61
Matos Costa,421070,SC,Sul,BUTANTAN/SINOVAC,529,300,229
Matos Costa,421070,SC,Sul,PFIZER/BIONTECH,30,30,0
Matozinhos,314110,MG,Sudeste,FIOCRUZ/ASTRAZENECA,6709,6212,497
Matozinhos,314110,MG,Sudeste,BUTANTAN/SINOVAC,5471,2880,2591
Matozinhos,314110,MG,Sudeste,PFIZER/BIONTECH,1563,1563,0
Matrinchã,521295,GO,Centro-Oeste,BUTANTAN/SINOVAC,1329,698,631
Matrinchã,521295,GO,Centro-Oeste,FIOCRUZ/ASTRAZENECA,1148,1081,67
Matriz De Camaragibe,270510,AL,Nordeste,FIOCRUZ/ASTRAZENECA,3953,3696,257
Matriz De Camaragibe,270510,AL,Nordeste,BUTANTAN/SINOVAC,3322,1717,1605
Matriz De Camaragibe,270510,AL,Nordeste,PFIZER/BIONTECH,23,23,0
Matupá,510560,MT,Centro-Oeste,FIOCRUZ/ASTRAZENECA,2534,2394,140
Matupá,510560,MT,Centro-Oeste,BUTANTAN/SINOVAC,2254,1181,1073
Matupá,510560,MT,Centro-Oeste,PFIZER/BIONTECH,110,110,0
Maturéia,250939,PB,Nordeste,BUTANTAN/SINOVAC,1372,696,676
Maturéia,250939,PB,Nordeste,FIOCRUZ/ASTRAZENECA,1113,1026,87
Maturéia,250939,PB,Nordeste,PFIZER/BIONTECH,142,142,0
Matutina,314120,MG,Sudeste,BUTANTAN/SINOVAC,2415,1221,1194
Matutina,314120,MG,Sudeste,FIOCRUZ/ASTRAZENECA,1142,1011,131
Matutina,314120,MG,Sudeste,PFIZER/BIONTECH,106,105,1
Mauá,352940,SP,Sudeste,FIOCRUZ/ASTRAZENECA,72362,68507,3855
Mauá,352940,SP,Sudeste,BUTANTAN/SINOVAC,70913,38697,32216
Mauá,352940,SP,Sudeste,PFIZER/BIONTECH,8653,8645,8
Mauá Da Serra,411575,PR,Sul,FIOCRUZ/ASTRAZENECA,2414,2291,123
Mauá Da Serra,411575,PR,Sul,BUTANTAN/SINOVAC,1658,879,779
Mauá Da Serra,411575,PR,Sul,PFIZER/BIONTECH,131,131,0
Maués,130290,AM,Norte,FIOCRUZ/ASTRAZENECA,11303,9145,2158
Maués,130290,AM,Norte,BUTANTAN/SINOVAC,8181,5478,2703
Maurilândia,521300,GO,Centro-Oeste,FIOCRUZ/ASTRAZENECA,2358,2199,159
Maurilândia,521300,GO,Centro-Oeste,BUTANTAN/SINOVAC,1406,724,682
Maurilândia,521300,GO,Centro-Oeste,PFIZER/BIONTECH,1,1,0
Maurilândia Do Tocantins,171280,TO,Norte,BUTANTAN/SINOVAC,735,386,349
Maurilândia Do Tocantins,171280,TO,Norte,FIOCRUZ/ASTRAZENECA,291,281,10
Mauriti,230810,CE,Nordeste,BUTANTAN/SINOVAC,3947,3302,645
Mauriti,230810,CE,Nordeste,FIOCRUZ/ASTRAZENECA,2609,2607,2
Mauriti,230810,CE,Nordeste,PFIZER/BIONTECH,1,1,0
Maxaranguape,240750,RN,Nordeste,BUTANTAN/SINOVAC,1474,857,617
Maxaranguape,240750,RN,Nordeste,FIOCRUZ/ASTRAZENECA,885,788,97
Maxaranguape,240750,RN,Nordeste,PFIZER/BIONTECH,38,38,0
Maximiliano De Almeida,431220,RS,Sul,FIOCRUZ/ASTRAZENECA,1406,1207,199
Maximiliano De Almeida,431220,RS,Sul,BUTANTAN/SINOVAC,1296,649,647
Maximiliano De Almeida,431220,RS,Sul,PFIZER/BIONTECH,183,183,0
Mazagão,160040,AP,Norte,FIOCRUZ/ASTRAZENECA,4396,4218,178
Mazagão,160040,AP,Norte,BUTANTAN/SINOVAC,1921,980,941
Mazagão,160040,AP,Norte,PFIZER/BIONTECH,238,238,0
Medeiros,314130,MG,Sudeste,FIOCRUZ/ASTRAZENECA,863,799,64
Medeiros,314130,MG,Sudeste,BUTANTAN/SINOVAC,781,400,381
Medeiros,314130,MG,Sudeste,PFIZER/BIONTECH,153,153,0
Medeiros Neto,292110,BA,Nordeste,BUTANTAN/SINOVAC,4655,2489,2166
Medeiros Neto,292110,BA,Nordeste,FIOCRUZ/ASTRAZENECA,4317,3950,367
Medeiros Neto,292110,BA,Nordeste,PFIZER/BIONTECH,36,36,0
Medianeira,411580,PR,Sul,FIOCRUZ/ASTRAZENECA,10833,10058,775
Medianeira,411580,PR,Sul,BUTANTAN/SINOVAC,8217,4182,4035
Medianeira,411580,PR,Sul,PFIZER/BIONTECH,1159,1159,0
Medicilândia,150445,PA,Norte,BUTANTAN/SINOVAC,3051,1577,1474
Medicilândia,150445,PA,Norte,FIOCRUZ/ASTRAZENECA,3000,2188,812
Medina,314140,MG,Sudeste,BUTANTAN/SINOVAC,4697,2375,2322
Medina,314140,MG,Sudeste,FIOCRUZ/ASTRAZENECA,3551,3190,361
Medina,314140,MG,Sudeste,PFIZER/BIONTECH,101,101,0
Meleiro,421080,SC,Sul,FIOCRUZ/ASTRAZENECA,1714,1523,191
Meleiro,421080,SC,Sul,BUTANTAN/SINOVAC,1691,886,805
Meleiro,421080,SC,Sul,PFIZER/BIONTECH,212,212,0
Melgaço,150450,PA,Norte,FIOCRUZ/ASTRAZENECA,5221,4606,615
Melgaço,150450,PA,Norte,BUTANTAN/SINOVAC,939,520,419
Mendes,330280,RJ,Sudeste,BUTANTAN/SINOVAC,4716,2529,2187
Mendes,330280,RJ,Sudeste,FIOCRUZ/ASTRAZENECA,4553,4203,350
Mendes Pimentel,314150,MG,Sudeste,BUTANTAN/SINOVAC,1536,773,763
Mendes Pimentel,314150,MG,Sudeste,FIOCRUZ/ASTRAZENECA,1502,1354,148
Mendes Pimentel,314150,MG,Sudeste,PFIZER/BIONTECH,201,201,0
Mendonça,352950,SP,Sudeste,BUTANTAN/SINOVAC,1954,1083,871
Mendonça,352950,SP,Sudeste,FIOCRUZ/ASTRAZENECA,1761,1606,155
Mendonça,352950,SP,Sudeste,PFIZER/BIONTECH,111,111,0
Mercedes,411585,PR,Sul,FIOCRUZ/ASTRAZENECA,1403,1304,99
Mercedes,411585,PR,Sul,BUTANTAN/SINOVAC,1223,638,585
Mercedes,411585,PR,Sul,PFIZER/BIONTECH,18,18,0
Mercês,314160,MG,Sudeste,FIOCRUZ/ASTRAZENECA,3117,2827,290
Mercês,314160,MG,Sudeste,BUTANTAN/SINOVAC,2697,1351,1346
Meridiano,352960,SP,Sudeste,BUTANTAN/SINOVAC,1164,626,538
Meridiano,352960,SP,Sudeste,FIOCRUZ/ASTRAZENECA,1030,931,99
Meridiano,352960,SP,Sudeste,PFIZER/BIONTECH,132,132,0
Meruoca,230820,CE,Nordeste,BUTANTAN/SINOVAC,2677,1456,1221
Meruoca,230820,CE,Nordeste,FIOCRUZ/ASTRAZENECA,1952,1800,152
Mesópolis,352965,SP,Sudeste,BUTANTAN/SINOVAC,615,327,288
Mesópolis,352965,SP,Sudeste,FIOCRUZ/ASTRAZENECA,480,430,50
Mesópolis,352965,SP,Sudeste,PFIZER/BIONTECH,22,22,0
Mesquita,314170,MG,Sudeste,FIOCRUZ/ASTRAZENECA,1553,1446,107
Mesquita,314170,MG,Sudeste,BUTANTAN/SINOVAC,1553,790,763
Mesquita,314170,MG,Sudeste,PFIZER/BIONTECH,51,51,0
Mesquita,330285,RJ,Sudeste,BUTANTAN/SINOVAC,39605,20998,18607
Mesquita,330285,RJ,Sudeste,FIOCRUZ/ASTRAZENECA,32739,30206,2533
Mesquita,330285,RJ,Sudeste,PFIZER/BIONTECH,6474,6472,2
Messias,270520,AL,Nordeste,BUTANTAN/SINOVAC,2633,1467,1166
Messias,270520,AL,Nordeste,FIOCRUZ/ASTRAZENECA,2225,2082,143
Messias Targino,240760,RN,Nordeste,BUTANTAN/SINOVAC,1041,532,509
Messias Targino,240760,RN,Nordeste,FIOCRUZ/ASTRAZENECA,933,884,49
Messias Targino,240760,RN,Nordeste,PFIZER/BIONTECH,168,168,0
Miguel Alves,220620,PI,Nordeste,FIOCRUZ/ASTRAZENECA,6495,6079,416
Miguel Alves,220620,PI,Nordeste,BUTANTAN/SINOVAC,4854,2606,2248
Miguel Alves,220620,PI,Nordeste,PFIZER/BIONTECH,610,610,0
Miguel Calmon,292120,BA,Nordeste,FIOCRUZ/ASTRAZENECA,6335,5593,742
Miguel Calmon,292120,BA,Nordeste,BUTANTAN/SINOVAC,5733,2965,2768
Miguel Calmon,292120,BA,Nordeste,PFIZER/BIONTECH,548,548,0
Miguel Leão,220630,PI,Nordeste,BUTANTAN/SINOVAC,635,358,277
Miguel Leão,220630,PI,Nordeste,FIOCRUZ/ASTRAZENECA,630,580,50
Miguel Leão,220630,PI,Nordeste,PFIZER/BIONTECH,22,22,0
Miguel Pereira,330290,RJ,Sudeste,FIOCRUZ/ASTRAZENECA,6749,6151,598
Miguel Pereira,330290,RJ,Sudeste,BUTANTAN/SINOVAC,6300,3284,3016
Miguel Pereira,330290,RJ,Sudeste,PFIZER/BIONTECH,675,674,1
Miguelópolis,352970,SP,Sudeste,FIOCRUZ/ASTRAZENECA,4959,4565,394
Miguelópolis,352970,SP,Sudeste,BUTANTAN/SINOVAC,4389,2307,2082
Miguelópolis,352970,SP,Sudeste,PFIZER/BIONTECH,179,179,0
Milagres,230830,CE,Nordeste,BUTANTAN/SINOVAC,5333,2771,2562
Milagres,230830,CE,Nordeste,FIOCRUZ/ASTRAZENECA,3412,2862,550
Milagres,292130,BA,Nordeste,BUTANTAN/SINOVAC,1201,908,293
Milagres,292130,BA,Nordeste,FIOCRUZ/ASTRAZENECA,875,874,1
Milagres,292130,BA,Nordeste,PFIZER/BIONTECH,130,130,0
Milagres Do Maranhão,210667,MA,Nordeste,FIOCRUZ/ASTRAZENECA,1457,1382,75
Milagres Do Maranhão,210667,MA,Nordeste,BUTANTAN/SINOVAC,1104,564,540
Milhã,230835,CE,Nordeste,BUTANTAN/SINOVAC,3145,1583,1562
Milhã,230835,CE,Nordeste,FIOCRUZ/ASTRAZENECA,1746,1463,283
Milton Brandão,220635,PI,Nordeste,FIOCRUZ/ASTRAZENECA,908,908,0
Milton Brandão,220635,PI,Nordeste,BUTANTAN/SINOVAC,519,276,243
Mimoso De Goiás,521305,GO,Centro-Oeste,FIOCRUZ/ASTRAZENECA,1067,965,102
Mimoso De Goiás,521305,GO,Centro-Oeste,BUTANTAN/SINOVAC,420,221,199
Mimoso De Goiás,521305,GO,Centro-Oeste,PFIZER/BIONTECH,20,20,0
Mimoso Do Sul,320340,ES,Sudeste,BUTANTAN/SINOVAC,7916,4534,3382
Mimoso Do Sul,320340,ES,Sudeste,FIOCRUZ/ASTRAZENECA,5170,4983,187
Mimoso Do Sul,320340,ES,Sudeste,PFIZER/BIONTECH,719,719,0
Minaçu,521308,GO,Centro-Oeste,FIOCRUZ/ASTRAZENECA,10292,9641,651
Minaçu,521308,GO,Centro-Oeste,BUTANTAN/SINOVAC,7627,4010,3617
Minaçu,521308,GO,Centro-Oeste,PFIZER/BIONTECH,1,0,1
Minador Do Negrão,270530,AL,Nordeste,FIOCRUZ/ASTRAZENECA,1295,1199,96
Minador Do Negrão,270530,AL,Nordeste,BUTANTAN/SINOVAC,1178,626,552
Minas Do Leão,431225,RS,Sul,FIOCRUZ/ASTRAZENECA,1719,1668,51
Minas Do Leão,431225,RS,Sul,BUTANTAN/SINOVAC,1690,917,773
Minas Do Leão,431225,RS,Sul,PFIZER/BIONTECH,269,268,1
Minas Novas,314180,MG,Sudeste,FIOCRUZ/ASTRAZENECA,5803,5500,303
Minas Novas,314180,MG,Sudeste,BUTANTAN/SINOVAC,4129,2127,2002
Minas Novas,314180,MG,Sudeste,PFIZER/BIONTECH,1114,1114,0
Minduri,314190,MG,Sudeste,FIOCRUZ/ASTRAZENECA,679,641,38
Minduri,314190,MG,Sudeste,BUTANTAN/SINOVAC,597,347,250
Minduri,314190,MG,Sudeste,PFIZER/BIONTECH,28,28,0
Mineiros,521310,GO,Centro-Oeste,FIOCRUZ/ASTRAZENECA,12433,11208,1225
Mineiros,521310,GO,Centro-Oeste,BUTANTAN/SINOVAC,11175,5719,5456
Mineiros Do Tietê,352980,SP,Sudeste,FIOCRUZ/ASTRAZENECA,3011,2769,242
Mineiros Do Tietê,352980,SP,Sudeste,BUTANTAN/SINOVAC,2966,1685,1281
Mineiros Do Tietê,352980,SP,Sudeste,PFIZER/BIONTECH,341,341,0
Ministro Andreazza,110120,RO,Norte,BUTANTAN/SINOVAC,1760,941,819
Ministro Andreazza,110120,RO,Norte,FIOCRUZ/ASTRAZENECA,1595,1541,54
Ministro Andreazza,110120,RO,Norte,PFIZER/BIONTECH,190,190,0
Mira Estrela,353000,SP,Sudeste,BUTANTAN/SINOVAC,982,540,442
Mira Estrela,353000,SP,Sudeste,FIOCRUZ/ASTRAZENECA,950,865,85
Mira Estrela,353000,SP,Sudeste,PFIZER/BIONTECH,100,100,0
Mirabela,314200,MG,Sudeste,BUTANTAN/SINOVAC,2796,1417,1379
Mirabela,314200,MG,Sudeste,FIOCRUZ/ASTRAZENECA,2747,2546,201
Mirabela,314200,MG,Sudeste,PFIZER/BIONTECH,51,51,0
Miracatu,352990,SP,Sudeste,BUTANTAN/SINOVAC,5386,3235,2151
Miracatu,352990,SP,Sudeste,FIOCRUZ/ASTRAZENECA,4059,3758,301
Miracatu,352990,SP,Sudeste,PFIZER/BIONTECH,461,461,0
Miracema,330300,RJ,Sudeste,FIOCRUZ/ASTRAZENECA,5419,4947,472
Miracema,330300,RJ,Sudeste,BUTANTAN/SINOVAC,4960,2754,2206
Miracema,330300,RJ,Sudeste,PFIZER/BIONTECH,875,875,0
Miracema Do Tocantins,171320,TO,Norte,BUTANTAN/SINOVAC,3559,1823,1736
Miracema Do Tocantins,171320,TO,Norte,FIOCRUZ/ASTRAZENECA,3484,3243,241
Mirador,210670,MA,Nordeste,FIOCRUZ/ASTRAZENECA,3471,3275,196
Mirador,210670,MA,Nordeste,BUTANTAN/SINOVAC,2574,1345,1229
Mirador,411590,PR,Sul,FIOCRUZ/ASTRAZENECA,624,585,39
Mirador,411590,PR,Sul,BUTANTAN/SINOVAC,561,296,265
Mirador,411590,PR,Sul,PFIZER/BIONTECH,5,5,0
Miradouro,314210,MG,Sudeste,BUTANTAN/SINOVAC,2122,1066,1056
Miradouro,314210,MG,Sudeste,FIOCRUZ/ASTRAZENECA,2042,1885,157
Miradouro,314210,MG,Sudeste,PFIZER/BIONTECH,226,226,0
Miraguaí,431230,RS,Sul,BUTANTAN/SINOVAC,1491,749,742
Miraguaí,431230,RS,Sul,FIOCRUZ/ASTRAZENECA,1316,1216,100
Miraguaí,431230,RS,Sul,PFIZER/BIONTECH,143,143,0
Miraí,314220,MG,Sudeste,BUTANTAN/SINOVAC,3831,1935,1896
Miraí,314220,MG,Sudeste,FIOCRUZ/ASTRAZENECA,2765,2547,218
Miraí,314220,MG,Sudeste,PFIZER/BIONTECH,166,166,0
Miraíma,230837,CE,Nordeste,BUTANTAN/SINOVAC,2149,1093,1056
Miraíma,230837,CE,Nordeste,FIOCRUZ/ASTRAZENECA,1004,791,213
Miranda,500560,MS,Centro-Oeste,BUTANTAN/SINOVAC,13438,7693,5745
Miranda,500560,MS,Centro-Oeste,FIOCRUZ/ASTRAZENECA,5256,5048,208
Miranda,500560,MS,Centro-Oeste,PFIZER/BIONTECH,917,917,0
Miranda Do Norte,210675,MA,Nordeste,FIOCRUZ/ASTRAZENECA,4525,4287,238
Miranda Do Norte,210675,MA,Nordeste,BUTANTAN/SINOVAC,3095,1683,1412
Mirandiba,260930,PE,Nordeste,FIOCRUZ/ASTRAZENECA,4564,4264,300
Mirandiba,260930,PE,Nordeste,BUTANTAN/SINOVAC,2860,1579,1281
Mirandiba,260930,PE,Nordeste,PFIZER/BIONTECH,200,199,1
Mirandópolis,353010,SP,Sudeste,BUTANTAN/SINOVAC,7855,4351,3504
Mirandópolis,353010,SP,Sudeste,FIOCRUZ/ASTRAZENECA,7424,6708,716
Mirandópolis,353010,SP,Sudeste,PFIZER/BIONTECH,586,586,0
Mirangaba,292140,BA,Nordeste,FIOCRUZ/ASTRAZENECA,5008,4670,338
Mirangaba,292140,BA,Nordeste,BUTANTAN/SINOVAC,3201,1679,1522
Mirangaba,292140,BA,Nordeste,PFIZER/BIONTECH,67,67,0
Miranorte,171330,TO,Norte,FIOCRUZ/ASTRAZENECA,2528,2427,101
Miranorte,171330,TO,Norte,BUTANTAN/SINOVAC,2305,1176,1129
Mirante,292145,BA,Nordeste,BUTANTAN/SINOVAC,2469,1368,1101
Mirante,292145,BA,Nordeste,FIOCRUZ/ASTRAZENECA,1763,1633,130
Mirante,292145,BA,Nordeste,PFIZER/BIONTECH,22,22,0
Mirante Da Serra,110130,RO,Norte,BUTANTAN/SINOVAC,2575,1344,1231
Mirante Da Serra,110130,RO,Norte,FIOCRUZ/ASTRAZENECA,1697,1616,81
Mirante Da Serra,110130,RO,Norte,PFIZER/BIONTECH,97,97,0
Mirante Do Paranapanema,353020,SP,Sudeste,BUTANTAN/SINOVAC,4699,2407,2292
Mirante Do Paranapanema,353020,SP,Sudeste,FIOCRUZ/ASTRAZENECA,3992,3751,241
Mirante Do Paranapanema,353020,SP,Sudeste,PFIZER/BIONTECH,670,670,0
Miraselva,411600,PR,Sul,FIOCRUZ/ASTRAZENECA,732,659,73
Miraselva,411600,PR,Sul,BUTANTAN/SINOVAC,617,324,293
Miraselva,411600,PR,Sul,PFIZER/BIONTECH,1,1,0
Mirassol,353030,SP,Sudeste,BUTANTAN/SINOVAC,14515,8795,5720
Mirassol,353030,SP,Sudeste,FIOCRUZ/ASTRAZENECA,14034,13036,998
Mirassol,353030,SP,Sudeste,PFIZER/BIONTECH,1453,1453,0
Mirassol D'Oeste,510562,MT,Centro-Oeste,FIOCRUZ/ASTRAZENECA,4602,4147,455
Mirassol D'Oeste,510562,MT,Centro-Oeste,BUTANTAN/SINOVAC,3977,2092,1885
Mirassol D'Oeste,510562,MT,Centro-Oeste,PFIZER/BIONTECH,165,165,0
Mirassolândia,353040,SP,Sudeste,BUTANTAN/SINOVAC,1238,693,545
Mirassolândia,353040,SP,Sudeste,FIOCRUZ/ASTRAZENECA,436,377,59
Mirassolândia,353040,SP,Sudeste,PFIZER/BIONTECH,5,5,0
Miravânia,314225,MG,Sudeste,BUTANTAN/SINOVAC,1023,531,492
Miravânia,314225,MG,Sudeste,FIOCRUZ/ASTRAZENECA,965,647,318
Miravânia,314225,MG,Sudeste,PFIZER/BIONTECH,40,40,0
Mirim Doce,421085,SC,Sul,FIOCRUZ/ASTRAZENECA,712,666,46
Mirim Doce,421085,SC,Sul,BUTANTAN/SINOVAC,704,387,317
Mirinzal,210680,MA,Nordeste,FIOCRUZ/ASTRAZENECA,7969,5729,2240
Mirinzal,210680,MA,Nordeste,BUTANTAN/SINOVAC,1871,1037,834
Missal,411605,PR,Sul,BUTANTAN/SINOVAC,2833,1460,1373
Missal,411605,PR,Sul,FIOCRUZ/ASTRAZENECA,2322,2197,125
Missal,411605,PR,Sul,PFIZER/BIONTECH,102,102,0
Missão Velha,230840,CE,Nordeste,BUTANTAN/SINOVAC,5841,3041,2800
Missão Velha,230840,CE,Nordeste,FIOCRUZ/ASTRAZENECA,2841,2559,282
Mocajuba,150460,PA,Norte,FIOCRUZ/ASTRAZENECA,4803,4150,653
Mocajuba,150460,PA,Norte,BUTANTAN/SINOVAC,2928,1544,1384
Mococa,353050,SP,Sudeste,BUTANTAN/SINOVAC,18701,10140,8561
Mococa,353050,SP,Sudeste,FIOCRUZ/ASTRAZENECA,16394,15081,1313
Mococa,353050,SP,Sudeste,PFIZER/BIONTECH,1343,1342,1
Modelo,421090,SC,Sul,FIOCRUZ/ASTRAZENECA,1794,1595,199
Modelo,421090,SC,Sul,BUTANTAN/SINOVAC,1280,613,667
Modelo,421090,SC,Sul,PFIZER/BIONTECH,95,95,0
Moeda,314230,MG,Sudeste,FIOCRUZ/ASTRAZENECA,1350,1238,112
Moeda,314230,MG,Sudeste,BUTANTAN/SINOVAC,1200,610,590
Moeda,314230,MG,Sudeste,PFIZER/BIONTECH,69,69,0
Moema,314240,MG,Sudeste,FIOCRUZ/ASTRAZENECA,1908,1851,57
Moema,314240,MG,Sudeste,BUTANTAN/SINOVAC,1594,903,691
Moema,314240,MG,Sudeste,PFIZER/BIONTECH,129,129,0
Mogeiro,250940,PB,Nordeste,BUTANTAN/SINOVAC,2941,1514,1427
Mogeiro,250940,PB,Nordeste,FIOCRUZ/ASTRAZENECA,2152,1999,153
Mogeiro,250940,PB,Nordeste,PFIZER/BIONTECH,271,271,0
Mogi Das Cruzes,353060,SP,Sudeste,FIOCRUZ/ASTRAZENECA,81933,75958,5975
Mogi Das Cruzes,353060,SP,Sudeste,BUTANTAN/SINOVAC,73355,42572,30783
Mogi Das Cruzes,353060,SP,Sudeste,PFIZER/BIONTECH,8618,8612,6
Mogi Guaçu,353070,SP,Sudeste,BUTANTAN/SINOVAC,35181,19351,15830
Mogi Guaçu,353070,SP,Sudeste,FIOCRUZ/ASTRAZENECA,31911,29781,2130
Mogi Guaçu,353070,SP,Sudeste,PFIZER/BIONTECH,1841,1839,2
Mogi Mirim,353080,SP,Sudeste,FIOCRUZ/ASTRAZENECA,23327,21537,1790
Mogi Mirim,353080,SP,Sudeste,BUTANTAN/SINOVAC,21988,11857,10131
Mogi Mirim,353080,SP,Sudeste,PFIZER/BIONTECH,1019,1019,0
Moiporá,521340,GO,Centro-Oeste,FIOCRUZ/ASTRAZENECA,645,594,51
Moiporá,521340,GO,Centro-Oeste,BUTANTAN/SINOVAC,475,242,233
Moita Bonita,280410,SE,Nordeste,BUTANTAN/SINOVAC,3364,1814,1550
Moita Bonita,280410,SE,Nordeste,FIOCRUZ/ASTRAZENECA,2050,2050,0
Moita Bonita,280410,SE,Nordeste,PFIZER/BIONTECH,299,299,0
Moju,150470,PA,Norte,FIOCRUZ/ASTRAZENECA,15271,13433,1838
Moju,150470,PA,Norte,BUTANTAN/SINOVAC,6788,3724,3064
Mojuí Dos Campos,150475,PA,Norte,FIOCRUZ/ASTRAZENECA,5290,3778,1512
Mojuí Dos Campos,150475,PA,Norte,BUTANTAN/SINOVAC,1479,790,689
Mombaça,230850,CE,Nordeste,BUTANTAN/SINOVAC,8571,4519,4052
Mombaça,230850,CE,Nordeste,FIOCRUZ/ASTRAZENECA,4124,3470,654
Mombuca,353090,SP,Sudeste,BUTANTAN/SINOVAC,1463,832,631
Mombuca,353090,SP,Sudeste,FIOCRUZ/ASTRAZENECA,1276,1214,62
Mombuca,353090,SP,Sudeste,PFIZER/BIONTECH,94,94,0
Monção,210690,MA,Nordeste,FIOCRUZ/ASTRAZENECA,6467,5947,520
Monção,210690,MA,Nordeste,BUTANTAN/SINOVAC,4245,2375,1870
Monções,353100,SP,Sudeste,BUTANTAN/SINOVAC,896,513,383
Monções,353100,SP,Sudeste,FIOCRUZ/ASTRAZENECA,618,558,60
Monções,353100,SP,Sudeste,PFIZER/BIONTECH,72,72,0
Mondaí,421100,SC,Sul,FIOCRUZ/ASTRAZENECA,2687,2472,215
Mondaí,421100,SC,Sul,BUTANTAN/SINOVAC,2343,1250,1093
Mondaí,421100,SC,Sul,PFIZER/BIONTECH,147,147,0
Mongaguá,353110,SP,Sudeste,FIOCRUZ/ASTRAZENECA,6915,6682,233
Mongaguá,353110,SP,Sudeste,BUTANTAN/SINOVAC,6271,4210,2061
Mongaguá,353110,SP,Sudeste,PFIZER/BIONTECH,467,467,0
Monjolos,314250,MG,Sudeste,FIOCRUZ/ASTRAZENECA,644,595,49
Monjolos,314250,MG,Sudeste,BUTANTAN/SINOVAC,588,299,289
Monjolos,314250,MG,Sudeste,PFIZER/BIONTECH,78,78,0
Monsenhor Gil,220640,PI,Nordeste,FIOCRUZ/ASTRAZENECA,2174,1988,186
Monsenhor Gil,220640,PI,Nordeste,BUTANTAN/SINOVAC,1907,995,912
Monsenhor Gil,220640,PI,Nordeste,PFIZER/BIONTECH,64,64,0
Monsenhor Hipólito,220650,PI,Nordeste,BUTANTAN/SINOVAC,1906,982,924
Monsenhor Hipólito,220650,PI,Nordeste,FIOCRUZ/ASTRAZENECA,1614,1459,155
Monsenhor Hipólito,220650,PI,Nordeste,PFIZER/BIONTECH,155,155,0
Monsenhor Paulo,314260,MG,Sudeste,FIOCRUZ/ASTRAZENECA,917,882,35
Monsenhor Paulo,314260,MG,Sudeste,BUTANTAN/SINOVAC,715,402,313
Monsenhor Paulo,314260,MG,Sudeste,PFIZER/BIONTECH,130,130,0
Monsenhor Tabosa,230860,CE,Nordeste,BUTANTAN/SINOVAC,7623,4024,3599
Monsenhor Tabosa,230860,CE,Nordeste,FIOCRUZ/ASTRAZENECA,1711,1501,210
Montadas,250950,PB,Nordeste,BUTANTAN/SINOVAC,1318,667,651
Montadas,250950,PB,Nordeste,FIOCRUZ/ASTRAZENECA,927,829,98
Montadas,250950,PB,Nordeste,PFIZER/BIONTECH,66,66,0
Montalvânia,314270,MG,Sudeste,BUTANTAN/SINOVAC,4105,2047,2058
Montalvânia,314270,MG,Sudeste,FIOCRUZ/ASTRAZENECA,2507,2276,231
Montalvânia,314270,MG,Sudeste,PFIZER/BIONTECH,227,227,0
Montanha,320350,ES,Sudeste,BUTANTAN/SINOVAC,5668,3207,2461
Montanha,320350,ES,Sudeste,FIOCRUZ/ASTRAZENECA,3754,3555,199
Montanha,320350,ES,Sudeste,PFIZER/BIONTECH,357,356,1
Montanhas,240770,RN,Nordeste,BUTANTAN/SINOVAC,3211,1659,1552
Montanhas,240770,RN,Nordeste,FIOCRUZ/ASTRAZENECA,2220,2070,150
Montanhas,240770,RN,Nordeste,PFIZER/BIONTECH,219,219,0
Montauri,431235,RS,Sul,BUTANTAN/SINOVAC,543,272,271
Montauri,431235,RS,Sul,FIOCRUZ/ASTRAZENECA,486,435,51
Montauri,431235,RS,Sul,PFIZER/BIONTECH,72,71,1
Monte Alegre,150480,PA,Norte,FIOCRUZ/ASTRAZENECA,13132,9972,3160
Monte Alegre,150480,PA,Norte,BUTANTAN/SINOVAC,2351,1223,1128
Monte Alegre,240780,RN,Nordeste,BUTANTAN/SINOVAC,4288,2153,2135
Monte Alegre,240780,RN,Nordeste,FIOCRUZ/ASTRAZENECA,4242,3889,353
Monte Alegre,240780,RN,Nordeste,PFIZER/BIONTECH,482,481,1
Monte Alegre De Goiás,521350,GO,Centro-Oeste,BUTANTAN/SINOVAC,3856,2124,1732
Monte Alegre De Goiás,521350,GO,Centro-Oeste,FIOCRUZ/ASTRAZENECA,1580,1502,78
Monte Alegre De Minas,314280,MG,Sudeste,BUTANTAN/SINOVAC,4478,2300,2178
Monte Alegre De Minas,314280,MG,Sudeste,FIOCRUZ/ASTRAZENECA,3549,2914,635
Monte Alegre De Minas,314280,MG,Sudeste,PFIZER/BIONTECH,73,73,0
Monte Alegre De Sergipe,280420,SE,Nordeste,BUTANTAN/SINOVAC,2832,1441,1391
Monte Alegre De Sergipe,280420,SE,Nordeste,FIOCRUZ/ASTRAZENECA,1716,1710,6
Monte Alegre De Sergipe,280420,SE,Nordeste,PFIZER/BIONTECH,122,122,0
Monte Alegre Do Piauí,220660,PI,Nordeste,FIOCRUZ/ASTRAZENECA,1942,1826,116
Monte Alegre Do Piauí,220660,PI,Nordeste,BUTANTAN/SINOVAC,1463,753,710
Monte Alegre Do Piauí,220660,PI,Nordeste,PFIZER/BIONTECH,86,86,0
Monte Alegre Do Sul,353120,SP,Sudeste,BUTANTAN/SINOVAC,2361,1330,1031
Monte Alegre Do Sul,353120,SP,Sudeste,FIOCRUZ/ASTRAZENECA,2327,2128,199
Monte Alegre Do Sul,353120,SP,Sudeste,PFIZER/BIONTECH,80,80,0
Monte Alegre Dos Campos,431237,RS,Sul,FIOCRUZ/ASTRAZENECA,1004,878,126
Monte Alegre Dos Campos,431237,RS,Sul,BUTANTAN/SINOVAC,753,387,366
Monte Alegre Dos Campos,431237,RS,Sul,PFIZER/BIONTECH,88,88,0
Monte Alto,353130,SP,Sudeste,FIOCRUZ/ASTRAZENECA,12788,11757,1031
Monte Alto,353130,SP,Sudeste,BUTANTAN/SINOVAC,11962,6704,5258
Monte Alto,353130,SP,Sudeste,PFIZER/BIONTECH,1046,1046,0
Monte Aprazível,353140,SP,Sudeste,BUTANTAN/SINOVAC,6926,3893,3033
Monte Aprazível,353140,SP,Sudeste,FIOCRUZ/ASTRAZENECA,5985,5409,576
Monte Aprazível,353140,SP,Sudeste,PFIZER/BIONTECH,471,470,1
Monte Azul,314290,MG,Sudeste,FIOCRUZ/ASTRAZENECA,5538,5280,258
Monte Azul,314290,MG,Sudeste,BUTANTAN/SINOVAC,4392,2424,1968
Monte Azul,314290,MG,Sudeste,PFIZER/BIONTECH,63,63,0
Monte Azul Paulista,353150,SP,Sudeste,BUTANTAN/SINOVAC,5651,2900,2751
Monte Azul Paulista,353150,SP,Sudeste,FIOCRUZ/ASTRAZENECA,5397,4765,632
Monte Azul Paulista,353150,SP,Sudeste,PFIZER/BIONTECH,411,407,4
Monte Belo,314300,MG,Sudeste,FIOCRUZ/ASTRAZENECA,3745,3484,261
Monte Belo,314300,MG,Sudeste,BUTANTAN/SINOVAC,3004,1511,1493
Monte Belo,314300,MG,Sudeste,PFIZER/BIONTECH,202,202,0
Monte Belo Do Sul,431238,RS,Sul,BUTANTAN/SINOVAC,1019,511,508
Monte Belo Do Sul,431238,RS,Sul,FIOCRUZ/ASTRAZENECA,864,695,169
Monte Belo Do Sul,431238,RS,Sul,PFIZER/BIONTECH,108,108,0
Monte Carlo,421105,SC,Sul,FIOCRUZ/ASTRAZENECA,2034,1854,180
Monte Carlo,421105,SC,Sul,BUTANTAN/SINOVAC,1617,866,751
Monte Carmelo,314310,MG,Sudeste,FIOCRUZ/ASTRAZENECA,10031,8856,1175
Monte Carmelo,314310,MG,Sudeste,BUTANTAN/SINOVAC,8085,4133,3952
Monte Carmelo,314310,MG,Sudeste,PFIZER/BIONTECH,1143,1141,2
Monte Castelo,353160,SP,Sudeste,BUTANTAN/SINOVAC,1238,667,571
Monte Castelo,353160,SP,Sudeste,FIOCRUZ/ASTRAZENECA,1186,1078,108
Monte Castelo,353160,SP,Sudeste,PFIZER/BIONTECH,128,128,0
Monte Castelo,421110,SC,Sul,FIOCRUZ/ASTRAZENECA,2178,1993,185
Monte Castelo,421110,SC,Sul,BUTANTAN/SINOVAC,1511,801,710
Monte Castelo,421110,SC,Sul,PFIZER/BIONTECH,172,172,0
Monte Das Gameleiras,240790,RN,Nordeste,BUTANTAN/SINOVAC,1096,575,521
Monte Das Gameleiras,240790,RN,Nordeste,FIOCRUZ/ASTRAZENECA,792,726,66
Monte Das Gameleiras,240790,RN,Nordeste,PFIZER/BIONTECH,104,104,0
Monte Do Carmo,171360,TO,Norte,BUTANTAN/SINOVAC,1361,766,595
Monte Do Carmo,171360,TO,Norte,FIOCRUZ/ASTRAZENECA,1076,974,102
Monte Formoso,314315,MG,Sudeste,BUTANTAN/SINOVAC,1128,572,556
Monte Formoso,314315,MG,Sudeste,FIOCRUZ/ASTRAZENECA,608,515,93
Monte Formoso,314315,MG,Sudeste,PFIZER/BIONTECH,67,67,0
Monte Horebe,250960,PB,Nordeste,BUTANTAN/SINOVAC,935,491,444
Monte Horebe,250960,PB,Nordeste,FIOCRUZ/ASTRAZENECA,684,601,83
Monte Horebe,250960,PB,Nordeste,PFIZER/BIONTECH,63,63,0
Monte Mor,353180,SP,Sudeste,FIOCRUZ/ASTRAZENECA,11046,10472,574
Monte Mor,353180,SP,Sudeste,BUTANTAN/SINOVAC,9293,5141,4152
Monte Mor,353180,SP,Sudeste,PFIZER/BIONTECH,1407,1407,0
Monte Negro,110140,RO,Norte,FIOCRUZ/ASTRAZENECA,3251,3160,91
Monte Negro,110140,RO,Norte,BUTANTAN/SINOVAC,2773,1531,1242
Monte Negro,110140,RO,Norte,PFIZER/BIONTECH,258,258,0
Monte Santo,292150,BA,Nordeste,FIOCRUZ/ASTRAZENECA,7428,7408,20
Monte Santo,292150,BA,Nordeste,BUTANTAN/SINOVAC,6524,4784,1740
Monte Santo,292150,BA,Nordeste,PFIZER/BIONTECH,745,745,0
Monte Santo De Minas,314320,MG,Sudeste,BUTANTAN/SINOVAC,5928,3151,2777
Monte Santo De Minas,314320,MG,Sudeste,FIOCRUZ/ASTRAZENECA,4788,4346,442
Monte Santo De Minas,314320,MG,Sudeste,PFIZER/BIONTECH,171,170,1
Monte Santo Do Tocantins,171370,TO,Norte,BUTANTAN/SINOVAC,475,237,238
Monte Santo Do Tocantins,171370,TO,Norte,FIOCRUZ/ASTRAZENECA,360,349,11
Monte Sião,314340,MG,Sudeste,FIOCRUZ/ASTRAZENECA,4245,4046,199
Monte Sião,314340,MG,Sudeste,BUTANTAN/SINOVAC,3928,1983,1945
Monte Sião,314340,MG,Sudeste,PFIZER/BIONTECH,86,86,0
Monteiro,250970,PB,Nordeste,BUTANTAN/SINOVAC,8005,4069,3936
Monteiro,250970,PB,Nordeste,FIOCRUZ/ASTRAZENECA,6966,6276,690
Monteiro,250970,PB,Nordeste,PFIZER/BIONTECH,806,805,1
Monteiro Lobato,353170,SP,Sudeste,BUTANTAN/SINOVAC,1223,656,567
Monteiro Lobato,353170,SP,Sudeste,FIOCRUZ/ASTRAZENECA,728,624,104
Monteiro Lobato,353170,SP,Sudeste,PFIZER/BIONTECH,32,32,0
Monteirópolis,270540,AL,Nordeste,FIOCRUZ/ASTRAZENECA,1590,1442,148
Monteirópolis,270540,AL,Nordeste,BUTANTAN/SINOVAC,1146,586,560
Montenegro,431240,RS,Sul,BUTANTAN/SINOVAC,16184,8175,8009
Montenegro,431240,RS,Sul,FIOCRUZ/ASTRAZENECA,14142,12760,1382
Montenegro,431240,RS,Sul,PFIZER/BIONTECH,785,785,0
Montes Altos,210700,MA,Nordeste,BUTANTAN/SINOVAC,3042,1813,1229
Montes Altos,210700,MA,Nordeste,FIOCRUZ/ASTRAZENECA,1532,1413,119
Montes Claros,314330,MG,Sudeste,BUTANTAN/SINOVAC,75401,39617,35784
Montes Claros,314330,MG,Sudeste,FIOCRUZ/ASTRAZENECA,37868,35225,2643
Montes Claros,314330,MG,Sudeste,PFIZER/BIONTECH,135,135,0
Montes Claros De Goiás,521370,GO,Centro-Oeste,FIOCRUZ/ASTRAZENECA,2417,2280,137
Montes Claros De Goiás,521370,GO,Centro-Oeste,BUTANTAN/SINOVAC,1730,941,789
Montezuma,314345,MG,Sudeste,BUTANTAN/SINOVAC,1435,746,689
Montezuma,314345,MG,Sudeste,FIOCRUZ/ASTRAZENECA,960,876,84
Montezuma,314345,MG,Sudeste,PFIZER/BIONTECH,45,45,0
Montividiu,521375,GO,Centro-Oeste,BUTANTAN/SINOVAC,1796,929,867
Montividiu,521375,GO,Centro-Oeste,FIOCRUZ/ASTRAZENECA,1461,1414,47
Montividiu,521375,GO,Centro-Oeste,PFIZER/BIONTECH,29,29,0
Montividiu Do Norte,521377,GO,Centro-Oeste,FIOCRUZ/ASTRAZENECA,963,883,80
Montividiu Do Norte,521377,GO,Centro-Oeste,BUTANTAN/SINOVAC,688,357,331
Morada Nova,230870,CE,Nordeste,BUTANTAN/SINOVAC,11605,6223,5382
Morada Nova,230870,CE,Nordeste,FIOCRUZ/ASTRAZENECA,7201,6233,968
Morada Nova De Minas,314350,MG,Sudeste,FIOCRUZ/ASTRAZENECA,2197,2008,189
Morada Nova De Minas,314350,MG,Sudeste,BUTANTAN/SINOVAC,2044,1025,1019
Morada Nova De Minas,314350,MG,Sudeste,PFIZER/BIONTECH,337,337,0
Moraújo,230880,CE,Nordeste,BUTANTAN/SINOVAC,1675,942,733
Moraújo,230880,CE,Nordeste,FIOCRUZ/ASTRAZENECA,962,876,86
Moreilândia,261430,PE,Nordeste,FIOCRUZ/ASTRAZENECA,2402,2139,263
Moreilândia,261430,PE,Nordeste,BUTANTAN/SINOVAC,2226,1125,1101
Moreilândia,261430,PE,Nordeste,PFIZER/BIONTECH,258,258,0
Moreira Sales,411610,PR,Sul,FIOCRUZ/ASTRAZENECA,3402,3181,221
Moreira Sales,411610,PR,Sul,BUTANTAN/SINOVAC,3198,1612,1586
Moreno,260940,PE,Nordeste,FIOCRUZ/ASTRAZENECA,10313,9688,625
Moreno,260940,PE,Nordeste,BUTANTAN/SINOVAC,8979,4717,4262
Moreno,260940,PE,Nordeste,PFIZER/BIONTECH,322,320,2
Mormaço,431242,RS,Sul,FIOCRUZ/ASTRAZENECA,868,745,123
Mormaço,431242,RS,Sul,BUTANTAN/SINOVAC,811,407,404
Mormaço,431242,RS,Sul,PFIZER/BIONTECH,129,128,1
Morpará,292160,BA,Nordeste,BUTANTAN/SINOVAC,2273,1163,1110
Morpará,292160,BA,Nordeste,FIOCRUZ/ASTRAZENECA,1341,1234,107
Morpará,292160,BA,Nordeste,PFIZER/BIONTECH,11,11,0
Morretes,411620,PR,Sul,FIOCRUZ/ASTRAZENECA,3840,3678,162
Morretes,411620,PR,Sul,BUTANTAN/SINOVAC,3467,1905,1562
Morretes,411620,PR,Sul,PFIZER/BIONTECH,188,188,0
Morrinhos,230890,CE,Nordeste,BUTANTAN/SINOVAC,2071,1524,547
Morrinhos,230890,CE,Nordeste,FIOCRUZ/ASTRAZENECA,1183,1161,22
Morrinhos,230890,CE,Nordeste,PFIZER/BIONTECH,10,10,0
Morrinhos,521380,GO,Centro-Oeste,FIOCRUZ/ASTRAZENECA,11974,11081,893
Morrinhos,521380,GO,Centro-Oeste,BUTANTAN/SINOVAC,9337,4766,4571
Morrinhos,521380,GO,Centro-Oeste,PFIZER/BIONTECH,413,413,0
Morrinhos Do Sul,431244,RS,Sul,BUTANTAN/SINOVAC,1333,777,556
Morrinhos Do Sul,431244,RS,Sul,FIOCRUZ/ASTRAZENECA,1113,1044,69
Morrinhos Do Sul,431244,RS,Sul,PFIZER/BIONTECH,150,146,4
Morro Agudo,353190,SP,Sudeste,FIOCRUZ/ASTRAZENECA,6715,6320,395
Morro Agudo,353190,SP,Sudeste,BUTANTAN/SINOVAC,5500,2962,2538
Morro Agudo,353190,SP,Sudeste,PFIZER/BIONTECH,606,606,0
Morro Agudo De Goiás,521385,GO,Centro-Oeste,FIOCRUZ/ASTRAZENECA,1035,921,114
Morro Agudo De Goiás,521385,GO,Centro-Oeste,BUTANTAN/SINOVAC,546,276,270
Morro Agudo De Goiás,521385,GO,Centro-Oeste,PFIZER/BIONTECH,12,12,0
Morro Cabeça No Tempo,220665,PI,Nordeste,BUTANTAN/SINOVAC,869,495,374
Morro Cabeça No Tempo,220665,PI,Nordeste,FIOCRUZ/ASTRAZENECA,549,440,109
Morro Da Fumaça,421120,SC,Sul,FIOCRUZ/ASTRAZENECA,3857,3667,190
Morro Da Fumaça,421120,SC,Sul,BUTANTAN/SINOVAC,3162,1722,1440
Morro Da Fumaça,421120,SC,Sul,PFIZER/BIONTECH,394,394,0
Morro Da Garça,314360,MG,Sudeste,BUTANTAN/SINOVAC,630,315,315
Morro Da Garça,314360,MG,Sudeste,FIOCRUZ/ASTRAZENECA,562,498,64
Morro Da Garça,314360,MG,Sudeste,PFIZER/BIONTECH,24,24,0
Morro Do Chapéu,292170,BA,Nordeste,FIOCRUZ/ASTRAZENECA,7009,6477,532
Morro Do Chapéu,292170,BA,Nordeste,BUTANTAN/SINOVAC,6136,3132,3004
Morro Do Chapéu,292170,BA,Nordeste,PFIZER/BIONTECH,96,96,0
Morro Do Chapéu Do Piauí,220667,PI,Nordeste,BUTANTAN/SINOVAC,1260,696,564
Morro Do Chapéu Do Piauí,220667,PI,Nordeste,FIOCRUZ/ASTRAZENECA,1212,1090,122
Morro Do Chapéu Do Piauí,220667,PI,Nordeste,PFIZER/BIONTECH,83,83,0
Morro Do Pilar,314370,MG,Sudeste,BUTANTAN/SINOVAC,888,480,408
Morro Do Pilar,314370,MG,Sudeste,FIOCRUZ/ASTRAZENECA,695,648,47
Morro Do Pilar,314370,MG,Sudeste,PFIZER/BIONTECH,52,52,0
Morro Grande,421125,SC,Sul,FIOCRUZ/ASTRAZENECA,809,747,62
Morro Grande,421125,SC,Sul,BUTANTAN/SINOVAC,705,367,338
Morro Grande,421125,SC,Sul,PFIZER/BIONTECH,66,66,0
Morro Redondo,431245,RS,Sul,BUTANTAN/SINOVAC,2302,1207,1095
Morro Redondo,431245,RS,Sul,FIOCRUZ/ASTRAZENECA,1914,1795,119
Morro Redondo,431245,RS,Sul,PFIZER/BIONTECH,267,267,0
Morro Reuter,431247,RS,Sul,BUTANTAN/SINOVAC,1868,946,922
Morro Reuter,431247,RS,Sul,FIOCRUZ/ASTRAZENECA,1608,1470,138
Morro Reuter,431247,RS,Sul,PFIZER/BIONTECH,291,291,0
Morros,210710,MA,Nordeste,FIOCRUZ/ASTRAZENECA,3631,3424,207
Morros,210710,MA,Nordeste,BUTANTAN/SINOVAC,2162,1117,1045
Mortugaba,292180,BA,Nordeste,BUTANTAN/SINOVAC,4985,2765,2220
Mortugaba,292180,BA,Nordeste,FIOCRUZ/ASTRAZENECA,3691,3206,485
Mortugaba,292180,BA,Nordeste,PFIZER/BIONTECH,275,275,0
Morungaba,353200,SP,Sudeste,FIOCRUZ/ASTRAZENECA,2633,2478,155
Morungaba,353200,SP,Sudeste,BUTANTAN/SINOVAC,2519,1483,1036
Morungaba,353200,SP,Sudeste,PFIZER/BIONTECH,248,248,0
Mossâmedes,521390,GO,Centro-Oeste,FIOCRUZ/ASTRAZENECA,1428,1325,103
Mossâmedes,521390,GO,Centro-Oeste,BUTANTAN/SINOVAC,995,528,467
Mossoró,240800,RN,Nordeste,BUTANTAN/SINOVAC,67200,34782,32418
Mossoró,240800,RN,Nordeste,FIOCRUZ/ASTRAZENECA,66141,59550,6591
Mossoró,240800,RN,Nordeste,PFIZER/BIONTECH,10070,10069,1
Mostardas,431250,RS,Sul,FIOCRUZ/ASTRAZENECA,4362,3854,508
Mostardas,431250,RS,Sul,BUTANTAN/SINOVAC,3890,1951,1939
Mostardas,431250,RS,Sul,PFIZER/BIONTECH,416,415,1
Motuca,353205,SP,Sudeste,FIOCRUZ/ASTRAZENECA,1278,1214,64
Motuca,353205,SP,Sudeste,BUTANTAN/SINOVAC,853,445,408
Motuca,353205,SP,Sudeste,PFIZER/BIONTECH,77,77,0
Mozarlândia,521400,GO,Centro-Oeste,FIOCRUZ/ASTRAZENECA,3585,3460,125
Mozarlândia,521400,GO,Centro-Oeste,BUTANTAN/SINOVAC,2201,1273,928
Muaná,150490,PA,Norte,FIOCRUZ/ASTRAZENECA,6958,6793,165
Muaná,150490,PA,Norte,BUTANTAN/SINOVAC,1604,831,773
Mucajaí,140030,RR,Norte,BUTANTAN/SINOVAC,2952,1522,1430
Mucajaí,140030,RR,Norte,FIOCRUZ/ASTRAZENECA,2436,2304,132
Mucajaí,140030,RR,Norte,PFIZER/BIONTECH,56,56,0
Mucambo,230900,CE,Nordeste,FIOCRUZ/ASTRAZENECA,2479,2240,239
Mucambo,230900,CE,Nordeste,BUTANTAN/SINOVAC,2215,1270,945
Mucambo,230900,CE,Nordeste,PFIZER/BIONTECH,44,42,2
Mucugê,292190,BA,Nordeste,FIOCRUZ/ASTRAZENECA,2057,1778,279
Mucugê,292190,BA,Nordeste,BUTANTAN/SINOVAC,1668,875,793
Mucugê,292190,BA,Nordeste,PFIZER/BIONTECH,129,129,0
Muçum,431260,RS,Sul,BUTANTAN/SINOVAC,1964,986,978
Muçum,431260,RS,Sul,FIOCRUZ/ASTRAZENECA,1276,1115,161
Muçum,431260,RS,Sul,PFIZER/BIONTECH,171,171,0
Mucuri,292200,BA,Nordeste,BUTANTAN/SINOVAC,3277,2334,943
Mucuri,292200,BA,Nordeste,FIOCRUZ/ASTRAZENECA,1305,1245,60
Mucurici,320360,ES,Sudeste,BUTANTAN/SINOVAC,1582,894,688
Mucurici,320360,ES,Sudeste,FIOCRUZ/ASTRAZENECA,1062,1006,56
Mucurici,320360,ES,Sudeste,PFIZER/BIONTECH,181,181,0
Muitos Capões,431261,RS,Sul,FIOCRUZ/ASTRAZENECA,910,876,34
Muitos Capões,431261,RS,Sul,BUTANTAN/SINOVAC,598,302,296
Muitos Capões,431261,RS,Sul,PFIZER/BIONTECH,6,6,0
Muliterno,431262,RS,Sul,FIOCRUZ/ASTRAZENECA,514,447,67
Muliterno,431262,RS,Sul,BUTANTAN/SINOVAC,449,232,217
Muliterno,431262,RS,Sul,PFIZER/BIONTECH,102,102,0
Mulungu,230910,CE,Nordeste,BUTANTAN/SINOVAC,1629,911,718
Mulungu,230910,CE,Nordeste,FIOCRUZ/ASTRAZENECA,1116,1002,114
Mulungu,230910,CE,Nordeste,PFIZER/BIONTECH,33,33,0
Mulungu,250980,PB,Nordeste,BUTANTAN/SINOVAC,2631,1405,1226
Mulungu,250980,PB,Nordeste,FIOCRUZ/ASTRAZENECA,995,912,83
Mulungu,250980,PB,Nordeste,PFIZER/BIONTECH,36,36,0
Mulungu Do Morro,292205,BA,Nordeste,FIOCRUZ/ASTRAZENECA,4758,4007,751
Mulungu Do Morro,292205,BA,Nordeste,BUTANTAN/SINOVAC,1907,1004,903
Mulungu Do Morro,292205,BA,Nordeste,PFIZER/BIONTECH,207,207,0
Mundo Novo,292210,BA,Nordeste,FIOCRUZ/ASTRAZENECA,4521,4054,467
Mundo Novo,292210,BA,Nordeste,BUTANTAN/SINOVAC,4334,2203,2131
Mundo Novo,292210,BA,Nordeste,PFIZER/BIONTECH,343,340,3
Mundo Novo,500568,MS,Centro-Oeste,BUTANTAN/SINOVAC,4698,2497,2201
Mundo Novo,500568,MS,Centro-Oeste,FIOCRUZ/ASTRAZENECA,4526,4111,415
Mundo Novo,500568,MS,Centro-Oeste,PFIZER/BIONTECH,518,517,1
Mundo Novo,521405,GO,Centro-Oeste,FIOCRUZ/ASTRAZENECA,1818,1722,96
Mundo Novo,521405,GO,Centro-Oeste,BUTANTAN/SINOVAC,909,501,408
Munhoz,314380,MG,Sudeste,BUTANTAN/SINOVAC,1161,590,571
Munhoz,314380,MG,Sudeste,FIOCRUZ/ASTRAZENECA,1158,1097,61
Munhoz,314380,MG,Sudeste,PFIZER/BIONTECH,42,42,0
Munhoz De Melo,411630,PR,Sul,FIOCRUZ/ASTRAZENECA,1236,1176,60
Munhoz De Melo,411630,PR,Sul,BUTANTAN/SINOVAC,1144,593,551
Munhoz De Melo,411630,PR,Sul,PFIZER/BIONTECH,16,16,0
Muniz Ferreira,292220,BA,Nordeste,FIOCRUZ/ASTRAZENECA,2127,1945,182
Muniz Ferreira,292220,BA,Nordeste,BUTANTAN/SINOVAC,1570,818,752
Muniz Ferreira,292220,BA,Nordeste,PFIZER/BIONTECH,228,228,0
Muniz Freire,320370,ES,Sudeste,BUTANTAN/SINOVAC,4643,2339,2304
Muniz Freire,320370,ES,Sudeste,FIOCRUZ/ASTRAZENECA,4608,4228,380
Muniz Freire,320370,ES,Sudeste,PFIZER/BIONTECH,774,773,1
Muquém Do São Francisco,292225,BA,Nordeste,FIOCRUZ/ASTRAZENECA,3310,2797,513
Muquém Do São Francisco,292225,BA,Nordeste,BUTANTAN/SINOVAC,1965,1023,942
Muquém Do São Francisco,292225,BA,Nordeste,PFIZER/BIONTECH,115,115,0
Muqui,320380,ES,Sudeste,BUTANTAN/SINOVAC,4143,2353,1790
Muqui,320380,ES,Sudeste,FIOCRUZ/ASTRAZENECA,2844,2762,82
Muqui,320380,ES,Sudeste,PFIZER/BIONTECH,593,593,0
Muriaé,314390,MG,Sudeste,BUTANTAN/SINOVAC,28748,15485,13263
Muriaé,314390,MG,Sudeste,FIOCRUZ/ASTRAZENECA,17058,15663,1395
Muriaé,314390,MG,Sudeste,PFIZER/BIONTECH,1051,1051,0
Muribeca,280430,SE,Nordeste,BUTANTAN/SINOVAC,1881,1036,845
Muribeca,280430,SE,Nordeste,FIOCRUZ/ASTRAZENECA,1384,1306,78
Muribeca,280430,SE,Nordeste,PFIZER/BIONTECH,174,174,0
Murici,270550,AL,Nordeste,FIOCRUZ/ASTRAZENECA,4882,4565,317
Murici,270550,AL,Nordeste,BUTANTAN/SINOVAC,4241,2194,2047
Murici,270550,AL,Nordeste,PFIZER/BIONTECH,59,59,0
Murici Dos Portelas,220669,PI,Nordeste,BUTANTAN/SINOVAC,1119,569,550
Murici Dos Portelas,220669,PI,Nordeste,FIOCRUZ/ASTRAZENECA,979,886,93
Murici Dos Portelas,220669,PI,Nordeste,PFIZER/BIONTECH,161,161,0
Muricilândia,171395,TO,Norte,FIOCRUZ/ASTRAZENECA,1569,1172,397
Muricilândia,171395,TO,Norte,BUTANTAN/SINOVAC,742,416,326
Muritiba,292230,BA,Nordeste,FIOCRUZ/ASTRAZENECA,5926,5456,470
Muritiba,292230,BA,Nordeste,BUTANTAN/SINOVAC,5142,2667,2475
Muritiba,292230,BA,Nordeste,PFIZER/BIONTECH,649,648,1
Murutinga Do Sul,353210,SP,Sudeste,BUTANTAN/SINOVAC,2068,1200,868
Murutinga Do Sul,353210,SP,Sudeste,FIOCRUZ/ASTRAZENECA,1426,1262,164
Murutinga Do Sul,353210,SP,Sudeste,PFIZER/BIONTECH,129,128,1
Mutuípe,292240,BA,Nordeste,BUTANTAN/SINOVAC,3596,1838,1758
Mutuípe,292240,BA,Nordeste,FIOCRUZ/ASTRAZENECA,2293,2170,123
Mutuípe,292240,BA,Nordeste,PFIZER/BIONTECH,95,95,0
Mutum,314400,MG,Sudeste,BUTANTAN/SINOVAC,6366,3434,2932
Mutum,314400,MG,Sudeste,FIOCRUZ/ASTRAZENECA,5532,5155,377
Mutum,314400,MG,Sudeste,PFIZER/BIONTECH,114,114,0
Mutunópolis,521410,GO,Centro-Oeste,FIOCRUZ/ASTRAZENECA,1355,1278,77
Mutunópolis,521410,GO,Centro-Oeste,BUTANTAN/SINOVAC,1031,623,408
Mutunópolis,521410,GO,Centro-Oeste,PFIZER/BIONTECH,2,1,1
Muzambinho,314410,MG,Sudeste,FIOCRUZ/ASTRAZENECA,5474,5015,459
Muzambinho,314410,MG,Sudeste,BUTANTAN/SINOVAC,4975,2548,2427
Muzambinho,314410,MG,Sudeste,PFIZER/BIONTECH,374,374,0
Nacip Raydan,314420,MG,Sudeste,BUTANTAN/SINOVAC,825,415,410
Nacip Raydan,314420,MG,Sudeste,FIOCRUZ/ASTRAZENECA,470,438,32
Nantes,353215,SP,Sudeste,FIOCRUZ/ASTRAZENECA,989,948,41
Nantes,353215,SP,Sudeste,BUTANTAN/SINOVAC,807,467,340
Nantes,353215,SP,Sudeste,PFIZER/BIONTECH,126,126,0
Nanuque,314430,MG,Sudeste,BUTANTAN/SINOVAC,7743,4168,3575
Nanuque,314430,MG,Sudeste,FIOCRUZ/ASTRAZENECA,6969,6667,302
Nanuque,314430,MG,Sudeste,PFIZER/BIONTECH,676,674,2
Não-Me-Toque,431265,RS,Sul,FIOCRUZ/ASTRAZENECA,5104,4450,654
Não-Me-Toque,431265,RS,Sul,BUTANTAN/SINOVAC,4745,2434,2311
Não-Me-Toque,431265,RS,Sul,PFIZER/BIONTECH,583,583,0
Naque,314435,MG,Sudeste,FIOCRUZ/ASTRAZENECA,1364,1070,294
Naque,314435,MG,Sudeste,BUTANTAN/SINOVAC,1084,561,523
Naque,314435,MG,Sudeste,PFIZER/BIONTECH,111,111,0
Narandiba,353220,SP,Sudeste,FIOCRUZ/ASTRAZENECA,2185,2022,163
Narandiba,353220,SP,Sudeste,BUTANTAN/SINOVAC,1653,851,802
Narandiba,353220,SP,Sudeste,PFIZER/BIONTECH,135,135,0
Natal,240810,RN,Nordeste,BUTANTAN/SINOVAC,210005,110425,99580
Natal,240810,RN,Nordeste,FIOCRUZ/ASTRAZENECA,162420,141429,20991
Natal,240810,RN,Nordeste,PFIZER/BIONTECH,32359,32320,39
Natalândia,314437,MG,Sudeste,FIOCRUZ/ASTRAZENECA,898,766,132
Natalândia,314437,MG,Sudeste,BUTANTAN/SINOVAC,665,343,322
Natalândia,314437,MG,Sudeste,PFIZER/BIONTECH,139,138,1
Natércia,314440,MG,Sudeste,BUTANTAN/SINOVAC,1935,997,938
Natércia,314440,MG,Sudeste,FIOCRUZ/ASTRAZENECA,927,784,143
Natividade,171420,TO,Norte,FIOCRUZ/ASTRAZENECA,1902,1830,72
Natividade,171420,TO,Norte,BUTANTAN/SINOVAC,1786,915,871
Natividade,330310,RJ,Sudeste,BUTANTAN/SINOVAC,2177,1282,895
Natividade,330310,RJ,Sudeste,FIOCRUZ/ASTRAZENECA,810,744,66
Natividade Da Serra,353230,SP,Sudeste,BUTANTAN/SINOVAC,1482,866,616
Natividade Da Serra,353230,SP,Sudeste,FIOCRUZ/ASTRAZENECA,1157,1126,31
Natividade Da Serra,353230,SP,Sudeste,PFIZER/BIONTECH,81,81,0
Natuba,250990,PB,Nordeste,BUTANTAN/SINOVAC,2299,1121,1178
Natuba,250990,PB,Nordeste,FIOCRUZ/ASTRAZENECA,1450,1272,178
Natuba,250990,PB,Nordeste,PFIZER/BIONTECH,123,123,0
Navegantes,421130,SC,Sul,FIOCRUZ/ASTRAZENECA,15571,14483,1088
Navegantes,421130,SC,Sul,BUTANTAN/SINOVAC,6953,4129,2824
Navegantes,421130,SC,Sul,PFIZER/BIONTECH,525,524,1
Naviraí,500570,MS,Centro-Oeste,FIOCRUZ/ASTRAZENECA,10048,8792,1256
Naviraí,500570,MS,Centro-Oeste,BUTANTAN/SINOVAC,9919,5068,4851
Naviraí,500570,MS,Centro-Oeste,PFIZER/BIONTECH,785,784,1
Nazaré,171430,TO,Norte,FIOCRUZ/ASTRAZENECA,1245,1200,45
Nazaré,171430,TO,Norte,BUTANTAN/SINOVAC,971,498,473
Nazaré,292250,BA,Nordeste,FIOCRUZ/ASTRAZENECA,4395,3968,427
Nazaré,292250,BA,Nordeste,BUTANTAN/SINOVAC,4231,2253,1978
Nazaré,292250,BA,Nordeste,PFIZER/BIONTECH,324,323,1
Nazaré Da Mata,260950,PE,Nordeste,FIOCRUZ/ASTRAZENECA,7181,6820,361
Nazaré Da Mata,260950,PE,Nordeste,BUTANTAN/SINOVAC,6516,3454,3062
Nazaré Da Mata,260950,PE,Nordeste,PFIZER/BIONTECH,164,164,0
Nazaré Do Piauí,220670,PI,Nordeste,BUTANTAN/SINOVAC,2410,1434,976
Nazaré Do Piauí,220670,PI,Nordeste,FIOCRUZ/ASTRAZENECA,1084,950,134
Nazaré Do Piauí,220670,PI,Nordeste,PFIZER/BIONTECH,62,62,0
Nazaré Paulista,353240,SP,Sudeste,BUTANTAN/SINOVAC,4335,2576,1759
Nazaré Paulista,353240,SP,Sudeste,FIOCRUZ/ASTRAZENECA,3667,3398,269
Nazaré Paulista,353240,SP,Sudeste,PFIZER/BIONTECH,529,529,0
Nazareno,314450,MG,Sudeste,FIOCRUZ/ASTRAZENECA,2264,2099,165
Nazareno,314450,MG,Sudeste,BUTANTAN/SINOVAC,1768,892,876
Nazareno,314450,MG,Sudeste,PFIZER/BIONTECH,36,36,0
Nazarezinho,251000,PB,Nordeste,BUTANTAN/SINOVAC,1926,970,956
Nazarezinho,251000,PB,Nordeste,FIOCRUZ/ASTRAZENECA,1462,1334,128
Nazarezinho,251000,PB,Nordeste,PFIZER/BIONTECH,130,130,0
Nazária,220672,PI,Nordeste,BUTANTAN/SINOVAC,1048,678,370
Nazária,220672,PI,Nordeste,FIOCRUZ/ASTRAZENECA,1006,951,55
Nazário,521440,GO,Centro-Oeste,FIOCRUZ/ASTRAZENECA,2676,2548,128
Nazário,521440,GO,Centro-Oeste,BUTANTAN/SINOVAC,1818,941,877
Nazário,521440,GO,Centro-Oeste,PFIZER/BIONTECH,126,126,0
Neópolis,280440,SE,Nordeste,BUTANTAN/SINOVAC,3682,1922,1760
Neópolis,280440,SE,Nordeste,FIOCRUZ/ASTRAZENECA,2294,2121,173
Neópolis,280440,SE,Nordeste,PFIZER/BIONTECH,79,79,0
Nepomuceno,314460,MG,Sudeste,BUTANTAN/SINOVAC,5395,2718,2677
Nepomuceno,314460,MG,Sudeste,FIOCRUZ/ASTRAZENECA,4883,4506,377
Nepomuceno,314460,MG,Sudeste,PFIZER/BIONTECH,298,298,0
Nerópolis,521450,GO,Centro-Oeste,FIOCRUZ/ASTRAZENECA,5516,5072,444
Nerópolis,521450,GO,Centro-Oeste,BUTANTAN/SINOVAC,4303,2218,2085
Neves Paulista,353250,SP,Sudeste,FIOCRUZ/ASTRAZENECA,2797,2526,271
Neves Paulista,353250,SP,Sudeste,BUTANTAN/SINOVAC,2547,1505,1042
Neves Paulista,353250,SP,Sudeste,PFIZER/BIONTECH,219,219,0
Nhamundá,130300,AM,Norte,FIOCRUZ/ASTRAZENECA,7095,6475,620
Nhamundá,130300,AM,Norte,BUTANTAN/SINOVAC,3183,1835,1348
Nhandeara,353260,SP,Sudeste,BUTANTAN/SINOVAC,3592,1900,1692
Nhandeara,353260,SP,Sudeste,FIOCRUZ/ASTRAZENECA,2923,2643,280
Nhandeara,353260,SP,Sudeste,PFIZER/BIONTECH,216,216,0
Nicolau Vergueiro,431267,RS,Sul,BUTANTAN/SINOVAC,627,396,231
Nicolau Vergueiro,431267,RS,Sul,FIOCRUZ/ASTRAZENECA,551,512,39
Nicolau Vergueiro,431267,RS,Sul,PFIZER/BIONTECH,82,82,0
Nilo Peçanha,292260,BA,Nordeste,BUTANTAN/SINOVAC,1371,748,623
Nilo Peçanha,292260,BA,Nordeste,FIOCRUZ/ASTRAZENECA,787,735,52
Nilo Peçanha,292260,BA,Nordeste,PFIZER/BIONTECH,6,6,0
Nilópolis,330320,RJ,Sudeste,BUTANTAN/SINOVAC,45572,24377,21195
Nilópolis,330320,RJ,Sudeste,FIOCRUZ/ASTRAZENECA,24489,20856,3633
Nilópolis,330320,RJ,Sudeste,PFIZER/BIONTECH,4803,4793,10
Nina Rodrigues,210720,MA,Nordeste,FIOCRUZ/ASTRAZENECA,2120,2028,92
Nina Rodrigues,210720,MA,Nordeste,BUTANTAN/SINOVAC,1215,623,592
Ninheira,314465,MG,Sudeste,BUTANTAN/SINOVAC,2039,1031,1008
Ninheira,314465,MG,Sudeste,FIOCRUZ/ASTRAZENECA,1566,1422,144
Ninheira,314465,MG,Sudeste,PFIZER/BIONTECH,130,130,0
Nioaque,500580,MS,Centro-Oeste,FIOCRUZ/ASTRAZENECA,4435,3820,615
Nioaque,500580,MS,Centro-Oeste,BUTANTAN/SINOVAC,4322,2243,2079
Nioaque,500580,MS,Centro-Oeste,PFIZER/BIONTECH,500,499,1
Nipoã,353270,SP,Sudeste,BUTANTAN/SINOVAC,1098,605,493
Nipoã,353270,SP,Sudeste,FIOCRUZ/ASTRAZENECA,766,700,66
Niquelândia,521460,GO,Centro-Oeste,FIOCRUZ/ASTRAZENECA,10140,9495,645
Niquelândia,521460,GO,Centro-Oeste,BUTANTAN/SINOVAC,9869,6191,3678
Nísia Floresta,240820,RN,Nordeste,FIOCRUZ/ASTRAZENECA,4455,4280,175
Nísia Floresta,240820,RN,Nordeste,BUTANTAN/SINOVAC,4007,2093,1914
Nísia Floresta,240820,RN,Nordeste,PFIZER/BIONTECH,827,827,0
Niterói,330330,RJ,Sudeste,BUTANTAN/SINOVAC,138561,76403,62158
Niterói,330330,RJ,Sudeste,FIOCRUZ/ASTRAZENECA,120767,109988,10779
Niterói,330330,RJ,Sudeste,PFIZER/BIONTECH,7756,7750,6
Nobres,510590,MT,Centro-Oeste,BUTANTAN/SINOVAC,3081,1609,1472
Nobres,510590,MT,Centro-Oeste,FIOCRUZ/ASTRAZENECA,2725,2611,114
Nobres,510590,MT,Centro-Oeste,PFIZER/BIONTECH,289,288,1
Nonoai,431270,RS,Sul,BUTANTAN/SINOVAC,4668,2496,2172
Nonoai,431270,RS,Sul,FIOCRUZ/ASTRAZENECA,3365,3092,273
Nonoai,431270,RS,Sul,PFIZER/BIONTECH,397,396,1
Nordestina,292265,BA,Nordeste,FIOCRUZ/ASTRAZENECA,4373,3565,808
Nordestina,292265,BA,Nordeste,BUTANTAN/SINOVAC,2734,1454,1280
Nordestina,292265,BA,Nordeste,PFIZER/BIONTECH,395,395,0
Normandia,140040,RR,Norte,BUTANTAN/SINOVAC,5369,3202,2167
Normandia,140040,RR,Norte,FIOCRUZ/ASTRAZENECA,659,659,0
Nortelândia,510600,MT,Centro-Oeste,BUTANTAN/SINOVAC,1412,700,712
Nortelândia,510600,MT,Centro-Oeste,FIOCRUZ/ASTRAZENECA,1114,994,120
Nortelândia,510600,MT,Centro-Oeste,PFIZER/BIONTECH,25,25,0
Nossa Senhora Aparecida,280445,SE,Nordeste,BUTANTAN/SINOVAC,2319,1290,1029
Nossa Senhora Aparecida,280445,SE,Nordeste,FIOCRUZ/ASTRAZENECA,1120,1118,2
Nossa Senhora Aparecida,280445,SE,Nordeste,PFIZER/BIONTECH,42,42,0
Nossa Senhora Da Glória,280450,SE,Nordeste,FIOCRUZ/ASTRAZENECA,5758,5501,257
Nossa Senhora Da Glória,280450,SE,Nordeste,BUTANTAN/SINOVAC,4303,2353,1950
Nossa Senhora Da Glória,280450,SE,Nordeste,PFIZER/BIONTECH,310,310,0
Nossa Senhora Das Dores,280460,SE,Nordeste,BUTANTAN/SINOVAC,7131,4026,3105
Nossa Senhora Das Dores,280460,SE,Nordeste,FIOCRUZ/ASTRAZENECA,4413,4406,7
Nossa Senhora Das Dores,280460,SE,Nordeste,PFIZER/BIONTECH,581,581,0
Nossa Senhora Das Graças,411640,PR,Sul,FIOCRUZ/ASTRAZENECA,1010,988,22
Nossa Senhora Das Graças,411640,PR,Sul,BUTANTAN/SINOVAC,985,521,464
Nossa Senhora De Lourdes,280470,SE,Nordeste,BUTANTAN/SINOVAC,1452,743,709
Nossa Senhora De Lourdes,280470,SE,Nordeste,FIOCRUZ/ASTRAZENECA,1224,1168,56
Nossa Senhora De Lourdes,280470,SE,Nordeste,PFIZER/BIONTECH,155,154,1
Nossa Senhora De Nazaré,220675,PI,Nordeste,FIOCRUZ/ASTRAZENECA,1332,1206,126
Nossa Senhora De Nazaré,220675,PI,Nordeste,BUTANTAN/SINOVAC,1064,545,519
Nossa Senhora De Nazaré,220675,PI,Nordeste,PFIZER/BIONTECH,111,111,0
Nossa Senhora Do Livramento,510610,MT,Centro-Oeste,FIOCRUZ/ASTRAZENECA,6767,3826,2941
Nossa Senhora Do Livramento,510610,MT,Centro-Oeste,BUTANTAN/SINOVAC,2800,1450,1350
Nossa Senhora Do Socorro,280480,SE,Nordeste,BUTANTAN/SINOVAC,24423,12713,11710
Nossa Senhora Do Socorro,280480,SE,Nordeste,FIOCRUZ/ASTRAZENECA,9304,8883,421
Nossa Senhora Dos Remédios,220680,PI,Nordeste,FIOCRUZ/ASTRAZENECA,1688,1594,94
Nossa Senhora Dos Remédios,220680,PI,Nordeste,BUTANTAN/SINOVAC,1169,595,574
Nossa Senhora Dos Remédios,220680,PI,Nordeste,PFIZER/BIONTECH,130,130,0
Nova Aliança,353280,SP,Sudeste,BUTANTAN/SINOVAC,1797,1002,795
Nova Aliança,353280,SP,Sudeste,FIOCRUZ/ASTRAZENECA,1726,1567,159
Nova Aliança,353280,SP,Sudeste,PFIZER/BIONTECH,206,206,0
Nova Aliança Do Ivaí,411650,PR,Sul,FIOCRUZ/ASTRAZENECA,543,509,34
Nova Aliança Do Ivaí,411650,PR,Sul,BUTANTAN/SINOVAC,415,249,166
Nova Aliança Do Ivaí,411650,PR,Sul,PFIZER/BIONTECH,12,12,0
Nova Alvorada,431275,RS,Sul,FIOCRUZ/ASTRAZENECA,1002,847,155
Nova Alvorada,431275,RS,Sul,BUTANTAN/SINOVAC,953,484,469
Nova Alvorada,431275,RS,Sul,PFIZER/BIONTECH,137,137,0
Nova Alvorada Do Sul,500600,MS,Centro-Oeste,FIOCRUZ/ASTRAZENECA,4083,3429,654
Nova Alvorada Do Sul,500600,MS,Centro-Oeste,BUTANTAN/SINOVAC,2020,1138,882
Nova Alvorada Do Sul,500600,MS,Centro-Oeste,PFIZER/BIONTECH,333,332,1
Nova América,521470,GO,Centro-Oeste,FIOCRUZ/ASTRAZENECA,969,877,92
Nova América,521470,GO,Centro-Oeste,BUTANTAN/SINOVAC,848,440,408
Nova América,521470,GO,Centro-Oeste,PFIZER/BIONTECH,6,6,0
Nova América Da Colina,411660,PR,Sul,FIOCRUZ/ASTRAZENECA,989,925,64
Nova América Da Colina,411660,PR,Sul,BUTANTAN/SINOVAC,742,398,344
Nova América Da Colina,411660,PR,Sul,PFIZER/BIONTECH,17,17,0
Nova Andradina,500620,MS,Centro-Oeste,FIOCRUZ/ASTRAZENECA,13955,11632,2323
Nova Andradina,500620,MS,Centro-Oeste,BUTANTAN/SINOVAC,11069,5853,5216
Nova Andradina,500620,MS,Centro-Oeste,PFIZER/BIONTECH,1957,1956,1
Nova Araçá,431280,RS,Sul,FIOCRUZ/ASTRAZENECA,1287,1090,197
Nova Araçá,431280,RS,Sul,BUTANTAN/SINOVAC,1020,521,499
Nova Araçá,431280,RS,Sul,PFIZER/BIONTECH,150,150,0
Nova Aurora,411670,PR,Sul,FIOCRUZ/ASTRAZENECA,3249,3048,201
Nova Aurora,411670,PR,Sul,BUTANTAN/SINOVAC,2848,1453,1395
Nova Aurora,411670,PR,Sul,PFIZER/BIONTECH,153,153,0
Nova Aurora,521480,GO,Centro-Oeste,FIOCRUZ/ASTRAZENECA,821,693,128
Nova Aurora,521480,GO,Centro-Oeste,BUTANTAN/SINOVAC,483,243,240
Nova Aurora,521480,GO,Centro-Oeste,PFIZER/BIONTECH,6,6,0
Nova Bandeirantes,510615,MT,Centro-Oeste,BUTANTAN/SINOVAC,1783,1023,760
Nova Bandeirantes,510615,MT,Centro-Oeste,FIOCRUZ/ASTRAZENECA,1383,1320,63
Nova Bandeirantes,510615,MT,Centro-Oeste,PFIZER/BIONTECH,72,72,0
Nova Bassano,431290,RS,Sul,BUTANTAN/SINOVAC,2816,1424,1392
Nova Bassano,431290,RS,Sul,FIOCRUZ/ASTRAZENECA,2796,2380,416
Nova Bassano,431290,RS,Sul,PFIZER/BIONTECH,271,271,0
Nova Belém,314467,MG,Sudeste,BUTANTAN/SINOVAC,808,417,391
Nova Belém,314467,MG,Sudeste,FIOCRUZ/ASTRAZENECA,727,648,79
Nova Belém,314467,MG,Sudeste,PFIZER/BIONTECH,112,112,0
Nova Boa Vista,431295,RS,Sul,BUTANTAN/SINOVAC,869,438,431
Nova Boa Vista,431295,RS,Sul,FIOCRUZ/ASTRAZENECA,545,476,69
Nova Boa Vista,431295,RS,Sul,PFIZER/BIONTECH,81,81,0
Nova Brasilândia,510620,MT,Centro-Oeste,BUTANTAN/SINOVAC,858,490,368
Nova Brasilândia,510620,MT,Centro-Oeste,FIOCRUZ/ASTRAZENECA,846,790,56
Nova Brasilândia,510620,MT,Centro-Oeste,PFIZER/BIONTECH,41,41,0
Nova Brasilândia D'Oeste,110014,RO,Norte,BUTANTAN/SINOVAC,3218,1668,1550
Nova Brasilândia D'Oeste,110014,RO,Norte,FIOCRUZ/ASTRAZENECA,2464,2367,97
Nova Brasilândia D'Oeste,110014,RO,Norte,PFIZER/BIONTECH,137,137,0
Nova Bréscia,431300,RS,Sul,BUTANTAN/SINOVAC,1351,680,671
Nova Bréscia,431300,RS,Sul,FIOCRUZ/ASTRAZENECA,1011,860,151
Nova Bréscia,431300,RS,Sul,PFIZER/BIONTECH,125,125,0
Nova Campina,353282,SP,Sudeste,FIOCRUZ/ASTRAZENECA,1750,1669,81
Nova Campina,353282,SP,Sudeste,BUTANTAN/SINOVAC,1363,696,667
Nova Campina,353282,SP,Sudeste,PFIZER/BIONTECH,167,166,1
Nova Canaã,292270,BA,Nordeste,BUTANTAN/SINOVAC,4138,2450,1688
Nova Canaã,292270,BA,Nordeste,FIOCRUZ/ASTRAZENECA,1925,1760,165
Nova Canaã,292270,BA,Nordeste,PFIZER/BIONTECH,6,6,0
Nova Canaã Do Norte,510621,MT,Centro-Oeste,FIOCRUZ/ASTRAZENECA,2312,2228,84
Nova Canaã Do Norte,510621,MT,Centro-Oeste,BUTANTAN/SINOVAC,2129,1087,1042
Nova Canaã Do Norte,510621,MT,Centro-Oeste,PFIZER/BIONTECH,212,212,0
Nova Canaã Paulista,353284,SP,Sudeste,BUTANTAN/SINOVAC,1334,679,655
Nova Canaã Paulista,353284,SP,Sudeste,FIOCRUZ/ASTRAZENECA,988,897,91
Nova Canaã Paulista,353284,SP,Sudeste,PFIZER/BIONTECH,137,137,0
Nova Candelária,431301,RS,Sul,BUTANTAN/SINOVAC,880,445,435
Nova Candelária,431301,RS,Sul,FIOCRUZ/ASTRAZENECA,833,794,39
Nova Candelária,431301,RS,Sul,PFIZER/BIONTECH,110,110,0
Nova Cantu,411680,PR,Sul,FIOCRUZ/ASTRAZENECA,1866,1756,110
Nova Cantu,411680,PR,Sul,BUTANTAN/SINOVAC,1245,652,593
Nova Cantu,411680,PR,Sul,PFIZER/BIONTECH,20,20,0
Nova Castilho,353286,SP,Sudeste,BUTANTAN/SINOVAC,679,354,325
Nova Castilho,353286,SP,Sudeste,FIOCRUZ/ASTRAZENECA,398,371,27
Nova Castilho,353286,SP,Sudeste,PFIZER/BIONTECH,81,81,0
Nova Colinas,210725,MA,Nordeste,FIOCRUZ/ASTRAZENECA,1032,956,76
Nova Colinas,210725,MA,Nordeste,BUTANTAN/SINOVAC,963,494,469
Nova Crixás,521483,GO,Centro-Oeste,FIOCRUZ/ASTRAZENECA,2813,2748,65
Nova Crixás,521483,GO,Centro-Oeste,BUTANTAN/SINOVAC,2095,1087,1008
Nova Cruz,240830,RN,Nordeste,FIOCRUZ/ASTRAZENECA,7737,7130,607
Nova Cruz,240830,RN,Nordeste,BUTANTAN/SINOVAC,6895,3681,3214
Nova Cruz,240830,RN,Nordeste,PFIZER/BIONTECH,638,637,1
Nova Era,314470,MG,Sudeste,FIOCRUZ/ASTRAZENECA,4090,3755,335
Nova Era,314470,MG,Sudeste,BUTANTAN/SINOVAC,3819,1961,1858
Nova Era,314470,MG,Sudeste,PFIZER/BIONTECH,412,412,0
Nova Erechim,421140,SC,Sul,FIOCRUZ/ASTRAZENECA,1239,1140,99
Nova Erechim,421140,SC,Sul,BUTANTAN/SINOVAC,1005,516,489
Nova Erechim,421140,SC,Sul,PFIZER/BIONTECH,59,59,0
Nova Esperança,411690,PR,Sul,BUTANTAN/SINOVAC,9527,5551,3976
Nova Esperança,411690,PR,Sul,FIOCRUZ/ASTRAZENECA,7921,7401,520
Nova Esperança,411690,PR,Sul,PFIZER/BIONTECH,307,307,0
Nova Esperança Do Piriá,150495,PA,Norte,FIOCRUZ/ASTRAZENECA,2988,2752,236
Nova Esperança Do Piriá,150495,PA,Norte,BUTANTAN/SINOVAC,1487,766,721
Nova Esperança Do Sudoeste,411695,PR,Sul,FIOCRUZ/ASTRAZENECA,1794,1698,96
Nova Esperança Do Sudoeste,411695,PR,Sul,BUTANTAN/SINOVAC,1141,594,547
Nova Esperança Do Sudoeste,411695,PR,Sul,PFIZER/BIONTECH,30,30,0
Nova Esperança Do Sul,431303,RS,Sul,FIOCRUZ/ASTRAZENECA,1484,1357,127
Nova Esperança Do Sul,431303,RS,Sul,BUTANTAN/SINOVAC,1282,642,640
Nova Esperança Do Sul,431303,RS,Sul,PFIZER/BIONTECH,213,213,0
Nova Europa,353290,SP,Sudeste,FIOCRUZ/ASTRAZENECA,2098,1954,144
Nova Europa,353290,SP,Sudeste,BUTANTAN/SINOVAC,2042,1233,809
Nova Europa,353290,SP,Sudeste,PFIZER/BIONTECH,210,210,0
Nova Fátima,292273,BA,Nordeste,BUTANTAN/SINOVAC,1906,986,920
Nova Fátima,292273,BA,Nordeste,FIOCRUZ/ASTRAZENECA,1731,1504,227
Nova Fátima,292273,BA,Nordeste,PFIZER/BIONTECH,186,186,0
Nova Fátima,411700,PR,Sul,FIOCRUZ/ASTRAZENECA,2094,2000,94
Nova Fátima,411700,PR,Sul,BUTANTAN/SINOVAC,1842,955,887
Nova Fátima,411700,PR,Sul,PFIZER/BIONTECH,109,109,0
Nova Floresta,251010,PB,Nordeste,BUTANTAN/SINOVAC,2548,1287,1261
Nova Floresta,251010,PB,Nordeste,FIOCRUZ/ASTRAZENECA,1980,1795,185
Nova Floresta,251010,PB,Nordeste,PFIZER/BIONTECH,234,234,0
Nova Friburgo,330340,RJ,Sudeste,BUTANTAN/SINOVAC,23716,14083,9633
Nova Friburgo,330340,RJ,Sudeste,FIOCRUZ/ASTRAZENECA,17017,16508,509
Nova Friburgo,330340,RJ,Sudeste,PFIZER/BIONTECH,5,5,0
Nova Glória,521486,GO,Centro-Oeste,FIOCRUZ/ASTRAZENECA,2952,2780,172
Nova Glória,521486,GO,Centro-Oeste,BUTANTAN/SINOVAC,1528,781,747
Nova Granada,353300,SP,Sudeste,BUTANTAN/SINOVAC,5093,2888,2205
Nova Granada,353300,SP,Sudeste,FIOCRUZ/ASTRAZENECA,4575,4168,407
Nova Granada,353300,SP,Sudeste,PFIZER/BIONTECH,496,496,0
Nova Guarita,510880,MT,Centro-Oeste,BUTANTAN/SINOVAC,1302,735,567
Nova Guarita,510880,MT,Centro-Oeste,FIOCRUZ/ASTRAZENECA,1252,1185,67
Nova Guarita,510880,MT,Centro-Oeste,PFIZER/BIONTECH,64,64,0
Nova Guataporanga,353310,SP,Sudeste,FIOCRUZ/ASTRAZENECA,1006,926,80
Nova Guataporanga,353310,SP,Sudeste,BUTANTAN/SINOVAC,734,394,340
Nova Guataporanga,353310,SP,Sudeste,PFIZER/BIONTECH,74,74,0
Nova Hartz,431306,RS,Sul,FIOCRUZ/ASTRAZENECA,4473,4262,211
Nova Hartz,431306,RS,Sul,BUTANTAN/SINOVAC,3345,1682,1663
Nova Hartz,431306,RS,Sul,PFIZER/BIONTECH,696,696,0
Nova Ibiá,292275,BA,Nordeste,FIOCRUZ/ASTRAZENECA,1283,1176,107
Nova Ibiá,292275,BA,Nordeste,BUTANTAN/SINOVAC,1101,640,461
Nova Iguaçu,330350,RJ,Sudeste,BUTANTAN/SINOVAC,148658,82323,66335
Nova Iguaçu,330350,RJ,Sudeste,FIOCRUZ/ASTRAZENECA,79945,70604,9341
Nova Iguaçu,330350,RJ,Sudeste,PFIZER/BIONTECH,6047,6006,41
Nova Iguaçu De Goiás,521487,GO,Centro-Oeste,FIOCRUZ/ASTRAZENECA,1033,933,100
Nova Iguaçu De Goiás,521487,GO,Centro-Oeste,BUTANTAN/SINOVAC,438,232,206
Nova Independência,353320,SP,Sudeste,BUTANTAN/SINOVAC,1338,844,494
Nova Independência,353320,SP,Sudeste,FIOCRUZ/ASTRAZENECA,844,768,76
Nova Independência,353320,SP,Sudeste,PFIZER/BIONTECH,135,135,0
Nova Iorque,210730,MA,Nordeste,BUTANTAN/SINOVAC,1210,656,554
Nova Iorque,210730,MA,Nordeste,FIOCRUZ/ASTRAZENECA,968,894,74
Nova Ipixuna,150497,PA,Norte,FIOCRUZ/ASTRAZENECA,2355,2021,334
Nova Ipixuna,150497,PA,Norte,BUTANTAN/SINOVAC,984,552,432
Nova Itaberaba,421145,SC,Sul,BUTANTAN/SINOVAC,1112,645,467
Nova Itaberaba,421145,SC,Sul,FIOCRUZ/ASTRAZENECA,801,749,52
Nova Itarana,292280,BA,Nordeste,FIOCRUZ/ASTRAZENECA,1884,1724,160
Nova Itarana,292280,BA,Nordeste,BUTANTAN/SINOVAC,1441,762,679
Nova Lacerda,510618,MT,Centro-Oeste,BUTANTAN/SINOVAC,838,417,421
Nova Lacerda,510618,MT,Centro-Oeste,FIOCRUZ/ASTRAZENECA,824,775,49
Nova Lacerda,510618,MT,Centro-Oeste,PFIZER/BIONTECH,12,12,0
Nova Laranjeiras,411705,PR,Sul,BUTANTAN/SINOVAC,4956,2562,2394
Nova Laranjeiras,411705,PR,Sul,FIOCRUZ/ASTRAZENECA,2352,2228,124
Nova Laranjeiras,411705,PR,Sul,PFIZER/BIONTECH,1,1,0
Nova Lima,314480,MG,Sudeste,BUTANTAN/SINOVAC,23890,12491,11399
Nova Lima,314480,MG,Sudeste,FIOCRUZ/ASTRAZENECA,21439,19345,2094
Nova Lima,314480,MG,Sudeste,PFIZER/BIONTECH,2565,2562,3
Nova Londrina,411710,PR,Sul,FIOCRUZ/ASTRAZENECA,3968,3708,260
Nova Londrina,411710,PR,Sul,BUTANTAN/SINOVAC,3107,1608,1499
Nova Londrina,411710,PR,Sul,PFIZER/BIONTECH,174,174,0
Nova Luzitânia,353330,SP,Sudeste,BUTANTAN/SINOVAC,1047,582,465
Nova Luzitânia,353330,SP,Sudeste,FIOCRUZ/ASTRAZENECA,664,593,71
Nova Luzitânia,353330,SP,Sudeste,PFIZER/BIONTECH,125,125,0
Nova Mamoré,110033,RO,Norte,BUTANTAN/SINOVAC,3844,1993,1851
Nova Mamoré,110033,RO,Norte,FIOCRUZ/ASTRAZENECA,3564,3365,199
Nova Mamoré,110033,RO,Norte,PFIZER/BIONTECH,183,183,0
Nova Marilândia,510885,MT,Centro-Oeste,BUTANTAN/SINOVAC,637,324,313
Nova Marilândia,510885,MT,Centro-Oeste,FIOCRUZ/ASTRAZENECA,448,412,36
Nova Marilândia,510885,MT,Centro-Oeste,PFIZER/BIONTECH,30,30,0
Nova Maringá,510890,MT,Centro-Oeste,BUTANTAN/SINOVAC,896,448,448
Nova Maringá,510890,MT,Centro-Oeste,FIOCRUZ/ASTRAZENECA,536,477,59
Nova Maringá,510890,MT,Centro-Oeste,PFIZER/BIONTECH,22,22,0
Nova Módica,314490,MG,Sudeste,BUTANTAN/SINOVAC,912,463,449
Nova Módica,314490,MG,Sudeste,FIOCRUZ/ASTRAZENECA,837,791,46
Nova Módica,314490,MG,Sudeste,PFIZER/BIONTECH,69,69,0
Nova Monte Verde,510895,MT,Centro-Oeste,BUTANTAN/SINOVAC,1894,1041,853
Nova Monte Verde,510895,MT,Centro-Oeste,FIOCRUZ/ASTRAZENECA,1206,1151,55
Nova Monte Verde,510895,MT,Centro-Oeste,PFIZER/BIONTECH,7,7,0
Nova Mutum,510622,MT,Centro-Oeste,FIOCRUZ/ASTRAZENECA,4735,4346,389
Nova Mutum,510622,MT,Centro-Oeste,BUTANTAN/SINOVAC,3454,1773,1681
Nova Mutum,510622,MT,Centro-Oeste,PFIZER/BIONTECH,554,554,0
Nova Nazaré,510617,MT,Centro-Oeste,BUTANTAN/SINOVAC,668,338,330
Nova Nazaré,510617,MT,Centro-Oeste,FIOCRUZ/ASTRAZENECA,488,438,50
Nova Nazaré,510617,MT,Centro-Oeste,PFIZER/BIONTECH,94,94,0
Nova Odessa,353340,SP,Sudeste,FIOCRUZ/ASTRAZENECA,14221,13564,657
Nova Odessa,353340,SP,Sudeste,BUTANTAN/SINOVAC,11669,6538,5131
Nova Odessa,353340,SP,Sudeste,PFIZER/BIONTECH,968,968,0
Nova Olímpia,411720,PR,Sul,FIOCRUZ/ASTRAZENECA,1686,1562,124
Nova Olímpia,411720,PR,Sul,BUTANTAN/SINOVAC,1564,827,737
Nova Olímpia,411720,PR,Sul,PFIZER/BIONTECH,24,24,0
Nova Olímpia,510623,MT,Centro-Oeste,BUTANTAN/SINOVAC,2548,1376,1172
Nova Olímpia,510623,MT,Centro-Oeste,FIOCRUZ/ASTRAZENECA,2283,2204,79
Nova Olímpia,510623,MT,Centro-Oeste,PFIZER/BIONTECH,50,50,0
Nova Olinda,171488,TO,Norte,BUTANTAN/SINOVAC,1873,983,890
Nova Olinda,171488,TO,Norte,FIOCRUZ/ASTRAZENECA,1449,1372,77
Nova Olinda,230920,CE,Nordeste,BUTANTAN/SINOVAC,933,729,204
Nova Olinda,230920,CE,Nordeste,FIOCRUZ/ASTRAZENECA,225,223,2
Nova Olinda,251020,PB,Nordeste,BUTANTAN/SINOVAC,1443,724,719
Nova Olinda,251020,PB,Nordeste,FIOCRUZ/ASTRAZENECA,1103,1011,92
Nova Olinda,251020,PB,Nordeste,PFIZER/BIONTECH,91,91,0
Nova Olinda Do Maranhão,210735,MA,Nordeste,FIOCRUZ/ASTRAZENECA,5926,5013,913
Nova Olinda Do Maranhão,210735,MA,Nordeste,BUTANTAN/SINOVAC,3426,1889,1537
Nova Olinda Do Norte,130310,AM,Norte,FIOCRUZ/ASTRAZENECA,1436,1436,0
Nova Olinda Do Norte,130310,AM,Norte,BUTANTAN/SINOVAC,1419,1000,419
Nova Pádua,431308,RS,Sul,BUTANTAN/SINOVAC,955,479,476
Nova Pádua,431308,RS,Sul,FIOCRUZ/ASTRAZENECA,820,661,159
Nova Pádua,431308,RS,Sul,PFIZER/BIONTECH,107,107,0
Nova Palma,431310,RS,Sul,BUTANTAN/SINOVAC,1887,958,929
Nova Palma,431310,RS,Sul,FIOCRUZ/ASTRAZENECA,1839,1655,184
Nova Palma,431310,RS,Sul,PFIZER/BIONTECH,233,233,0
Nova Palmeira,251030,PB,Nordeste,BUTANTAN/SINOVAC,1284,647,637
Nova Palmeira,251030,PB,Nordeste,FIOCRUZ/ASTRAZENECA,984,888,96
Nova Palmeira,251030,PB,Nordeste,PFIZER/BIONTECH,101,101,0
Nova Petrópolis,431320,RS,Sul,BUTANTAN/SINOVAC,6572,3287,3285
Nova Petrópolis,431320,RS,Sul,FIOCRUZ/ASTRAZENECA,5870,4992,878
Nova Petrópolis,431320,RS,Sul,PFIZER/BIONTECH,689,689,0
Nova Ponte,314500,MG,Sudeste,FIOCRUZ/ASTRAZENECA,2441,2291,150
Nova Ponte,314500,MG,Sudeste,BUTANTAN/SINOVAC,2162,1121,1041
Nova Ponte,314500,MG,Sudeste,PFIZER/BIONTECH,261,261,0
Nova Porteirinha,314505,MG,Sudeste,FIOCRUZ/ASTRAZENECA,1541,1429,112
Nova Porteirinha,314505,MG,Sudeste,BUTANTAN/SINOVAC,1237,626,611
Nova Porteirinha,314505,MG,Sudeste,PFIZER/BIONTECH,90,90,0
Nova Prata,431330,RS,Sul,FIOCRUZ/ASTRAZENECA,6346,5658,688
Nova Prata,431330,RS,Sul,BUTANTAN/SINOVAC,5864,2967,2897
Nova Prata,431330,RS,Sul,PFIZER/BIONTECH,719,718,1
Nova Prata Do Iguaçu,411725,PR,Sul,FIOCRUZ/ASTRAZENECA,2405,2249,156
Nova Prata Do Iguaçu,411725,PR,Sul,BUTANTAN/SINOVAC,2390,1227,1163
Nova Prata Do Iguaçu,411725,PR,Sul,PFIZER/BIONTECH,138,138,0
Nova Ramada,431333,RS,Sul,FIOCRUZ/ASTRAZENECA,682,593,89
Nova Ramada,431333,RS,Sul,BUTANTAN/SINOVAC,674,340,334
Nova Ramada,431333,RS,Sul,PFIZER/BIONTECH,96,96,0
Nova Redenção,292285,BA,Nordeste,BUTANTAN/SINOVAC,1293,766,527
Nova Redenção,292285,BA,Nordeste,FIOCRUZ/ASTRAZENECA,553,552,1
Nova Resende,314510,MG,Sudeste,BUTANTAN/SINOVAC,3099,1560,1539
Nova Resende,314510,MG,Sudeste,FIOCRUZ/ASTRAZENECA,3018,2772,246
Nova Resende,314510,MG,Sudeste,PFIZER/BIONTECH,135,135,0
Nova Roma,521490,GO,Centro-Oeste,FIOCRUZ/ASTRAZENECA,1114,926,188
Nova Roma,521490,GO,Centro-Oeste,BUTANTAN/SINOVAC,277,154,123
Nova Roma Do Sul,431335,RS,Sul,BUTANTAN/SINOVAC,1087,551,536
Nova Roma Do Sul,431335,RS,Sul,FIOCRUZ/ASTRAZENECA,1021,846,175
Nova Roma Do Sul,431335,RS,Sul,PFIZER/BIONTECH,140,140,0
Nova Rosalândia,171500,TO,Norte,BUTANTAN/SINOVAC,950,497,453
Nova Rosalândia,171500,TO,Norte,FIOCRUZ/ASTRAZENECA,919,889,30
Nova Russas,230930,CE,Nordeste,BUTANTAN/SINOVAC,6500,3369,3131
Nova Russas,230930,CE,Nordeste,FIOCRUZ/ASTRAZENECA,2916,2338,578
Nova Santa Bárbara,411721,PR,Sul,FIOCRUZ/ASTRAZENECA,1576,1500,76
Nova Santa Bárbara,411721,PR,Sul,BUTANTAN/SINOVAC,1424,762,662
Nova Santa Helena,510619,MT,Centro-Oeste,BUTANTAN/SINOVAC,660,338,322
Nova Santa Helena,510619,MT,Centro-Oeste,FIOCRUZ/ASTRAZENECA,429,417,12
Nova Santa Helena,510619,MT,Centro-Oeste,PFIZER/BIONTECH,24,24,0
Nova Santa Rita,220795,PI,Nordeste,FIOCRUZ/ASTRAZENECA,803,695,108
Nova Santa Rita,220795,PI,Nordeste,BUTANTAN/SINOVAC,696,346,350
Nova Santa Rita,220795,PI,Nordeste,PFIZER/BIONTECH,36,36,0
Nova Santa Rita,431337,RS,Sul,FIOCRUZ/ASTRAZENECA,6677,6339,338
Nova Santa Rita,431337,RS,Sul,BUTANTAN/SINOVAC,5192,2610,2582
Nova Santa Rita,431337,RS,Sul,PFIZER/BIONTECH,956,955,1
Nova Santa Rosa,411722,PR,Sul,BUTANTAN/SINOVAC,2558,1328,1230
Nova Santa Rosa,411722,PR,Sul,FIOCRUZ/ASTRAZENECA,1783,1659,124
Nova Serrana,314520,MG,Sudeste,FIOCRUZ/ASTRAZENECA,9201,8640,561
Nova Serrana,314520,MG,Sudeste,BUTANTAN/SINOVAC,7761,3931,3830
Nova Serrana,314520,MG,Sudeste,PFIZER/BIONTECH,2092,2090,2
Nova Soure,292290,BA,Nordeste,BUTANTAN/SINOVAC,5115,2653,2462
Nova Soure,292290,BA,Nordeste,FIOCRUZ/ASTRAZENECA,4723,3982,741
Nova Soure,292290,BA,Nordeste,PFIZER/BIONTECH,348,348,0
Nova Tebas,411727,PR,Sul,FIOCRUZ/ASTRAZENECA,1719,1599,120
Nova Tebas,411727,PR,Sul,BUTANTAN/SINOVAC,1597,831,766
Nova Tebas,411727,PR,Sul,PFIZER/BIONTECH,22,22,0
Nova Timboteua,150500,PA,Norte,FIOCRUZ/ASTRAZENECA,3740,2906,834
Nova Timboteua,150500,PA,Norte,BUTANTAN/SINOVAC,2782,1448,1334
Nova Timboteua,150500,PA,Norte,PFIZER/BIONTECH,1,1,0
Nova Trento,421150,SC,Sul,BUTANTAN/SINOVAC,4820,2371,2449
Nova Trento,421150,SC,Sul,FIOCRUZ/ASTRAZENECA,3993,3771,222
Nova Trento,421150,SC,Sul,PFIZER/BIONTECH,2,2,0
Nova Ubiratã,510624,MT,Centro-Oeste,FIOCRUZ/ASTRAZENECA,1248,1109,139
Nova Ubiratã,510624,MT,Centro-Oeste,BUTANTAN/SINOVAC,1230,619,611
Nova Ubiratã,510624,MT,Centro-Oeste,PFIZER/BIONTECH,72,71,1
Nova União,110143,RO,Norte,FIOCRUZ/ASTRAZENECA,1745,1697,48
Nova União,110143,RO,Norte,BUTANTAN/SINOVAC,1409,844,565
Nova União,110143,RO,Norte,PFIZER/BIONTECH,108,108,0
Nova União,313660,MG,Sudeste,FIOCRUZ/ASTRAZENECA,1450,1306,144
Nova União,313660,MG,Sudeste,BUTANTAN/SINOVAC,1387,697,690
Nova União,313660,MG,Sudeste,PFIZER/BIONTECH,48,48,0
Nova Venécia,320390,ES,Sudeste,BUTANTAN/SINOVAC,11812,6057,5755
Nova Venécia,320390,ES,Sudeste,FIOCRUZ/ASTRAZENECA,10744,10282,462
Nova Venécia,320390,ES,Sudeste,PFIZER/BIONTECH,2167,2167,0
Nova Veneza,421160,SC,Sul,BUTANTAN/SINOVAC,3358,1726,1632
Nova Veneza,421160,SC,Sul,FIOCRUZ/ASTRAZENECA,3236,3028,208
Nova Veneza,421160,SC,Sul,PFIZER/BIONTECH,348,348,0
Nova Veneza,521500,GO,Centro-Oeste,FIOCRUZ/ASTRAZENECA,2117,1958,159
Nova Veneza,521500,GO,Centro-Oeste,BUTANTAN/SINOVAC,1628,841,787
Nova Veneza,521500,GO,Centro-Oeste,PFIZER/BIONTECH,94,94,0
Nova Viçosa,292300,BA,Nordeste,FIOCRUZ/ASTRAZENECA,2572,2497,75
Nova Viçosa,292300,BA,Nordeste,BUTANTAN/SINOVAC,1816,888,928
Nova Viçosa,292300,BA,Nordeste,PFIZER/BIONTECH,42,34,8
Nova Xavantina,510625,MT,Centro-Oeste,FIOCRUZ/ASTRAZENECA,4565,4409,156
Nova Xavantina,510625,MT,Centro-Oeste,BUTANTAN/SINOVAC,4021,2047,1974
Nova Xavantina,510625,MT,Centro-Oeste,PFIZER/BIONTECH,325,325,0
Novais,353325,SP,Sudeste,FIOCRUZ/ASTRAZENECA,1102,999,103
Novais,353325,SP,Sudeste,BUTANTAN/SINOVAC,1092,582,510
Novais,353325,SP,Sudeste,PFIZER/BIONTECH,39,39,0
Novo Acordo,171510,TO,Norte,BUTANTAN/SINOVAC,947,496,451
Novo Acordo,171510,TO,Norte,FIOCRUZ/ASTRAZENECA,598,558,40
Novo Airão,130320,AM,Norte,FIOCRUZ/ASTRAZENECA,3575,3007,568
Novo Airão,130320,AM,Norte,BUTANTAN/SINOVAC,1864,1063,801
Novo Alegre,171515,TO,Norte,FIOCRUZ/ASTRAZENECA,532,497,35
Novo Alegre,171515,TO,Norte,BUTANTAN/SINOVAC,490,245,245
Novo Aripuanã,130330,AM,Norte,FIOCRUZ/ASTRAZENECA,3893,3077,816
Novo Aripuanã,130330,AM,Norte,BUTANTAN/SINOVAC,2232,1222,1010
Novo Barreiro,431349,RS,Sul,FIOCRUZ/ASTRAZENECA,1333,1229,104
Novo Barreiro,431349,RS,Sul,BUTANTAN/SINOVAC,1249,654,595
Novo Barreiro,431349,RS,Sul,PFIZER/BIONTECH,155,155,0
Novo Brasil,521520,GO,Centro-Oeste,FIOCRUZ/ASTRAZENECA,1056,976,80
Novo Brasil,521520,GO,Centro-Oeste,BUTANTAN/SINOVAC,841,432,409
Novo Brasil,521520,GO,Centro-Oeste,PFIZER/BIONTECH,18,18,0
Novo Cabrais,431339,RS,Sul,FIOCRUZ/ASTRAZENECA,1211,1060,151
Novo Cabrais,431339,RS,Sul,BUTANTAN/SINOVAC,1183,595,588
Novo Cabrais,431339,RS,Sul,PFIZER/BIONTECH,167,166,1
Novo Cruzeiro,314530,MG,Sudeste,BUTANTAN/SINOVAC,4898,2588,2310
Novo Cruzeiro,314530,MG,Sudeste,FIOCRUZ/ASTRAZENECA,3208,2944,264
Novo Cruzeiro,314530,MG,Sudeste,PFIZER/BIONTECH,667,667,0
Novo Gama,521523,GO,Centro-Oeste,FIOCRUZ/ASTRAZENECA,12982,12333,649
Novo Gama,521523,GO,Centro-Oeste,BUTANTAN/SINOVAC,9172,4727,4445
Novo Hamburgo,431340,RS,Sul,BUTANTAN/SINOVAC,69233,35321,33912
Novo Hamburgo,431340,RS,Sul,FIOCRUZ/ASTRAZENECA,59162,54433,4729
Novo Hamburgo,431340,RS,Sul,PFIZER/BIONTECH,2927,2927,0
Novo Horizonte,292303,BA,Nordeste,BUTANTAN/SINOVAC,2054,1161,893
Novo Horizonte,292303,BA,Nordeste,FIOCRUZ/ASTRAZENECA,1394,1304,90
Novo Horizonte,353350,SP,Sudeste,BUTANTAN/SINOVAC,10314,5634,4680
Novo Horizonte,353350,SP,Sudeste,FIOCRUZ/ASTRAZENECA,9625,8830,795
Novo Horizonte,353350,SP,Sudeste,PFIZER/BIONTECH,838,838,0
Novo Horizonte,421165,SC,Sul,FIOCRUZ/ASTRAZENECA,733,679,54
Novo Horizonte,421165,SC,Sul,BUTANTAN/SINOVAC,638,344,294
Novo Horizonte Do Norte,510627,MT,Centro-Oeste,BUTANTAN/SINOVAC,876,446,430
Novo Horizonte Do Norte,510627,MT,Centro-Oeste,FIOCRUZ/ASTRAZENECA,741,688,53
Novo Horizonte Do Norte,510627,MT,Centro-Oeste,PFIZER/BIONTECH,58,58,0
Novo Horizonte Do Oeste,110050,RO,Norte,BUTANTAN/SINOVAC,1687,876,811
Novo Horizonte Do Oeste,110050,RO,Norte,FIOCRUZ/ASTRAZENECA,961,940,21
Novo Horizonte Do Sul,500625,MS,Centro-Oeste,FIOCRUZ/ASTRAZENECA,1170,931,239
Novo Horizonte Do Sul,500625,MS,Centro-Oeste,BUTANTAN/SINOVAC,1034,535,499
Novo Horizonte Do Sul,500625,MS,Centro-Oeste,PFIZER/BIONTECH,119,119,0
Novo Itacolomi,411729,PR,Sul,FIOCRUZ/ASTRAZENECA,1037,971,66
Novo Itacolomi,411729,PR,Sul,BUTANTAN/SINOVAC,785,401,384
Novo Itacolomi,411729,PR,Sul,PFIZER/BIONTECH,6,6,0
Novo Jardim,171525,TO,Norte,FIOCRUZ/ASTRAZENECA,496,468,28
Novo Jardim,171525,TO,Norte,BUTANTAN/SINOVAC,398,200,198
Novo Lino,270560,AL,Nordeste,BUTANTAN/SINOVAC,1460,726,734
Novo Lino,270560,AL,Nordeste,FIOCRUZ/ASTRAZENECA,1432,1302,130
Novo Machado,431342,RS,Sul,BUTANTAN/SINOVAC,1121,574,547
Novo Machado,431342,RS,Sul,FIOCRUZ/ASTRAZENECA,1023,944,79
Novo Machado,431342,RS,Sul,PFIZER/BIONTECH,125,124,1
Novo Mundo,510626,MT,Centro-Oeste,BUTANTAN/SINOVAC,2189,1271,918
Novo Mundo,510626,MT,Centro-Oeste,FIOCRUZ/ASTRAZENECA,1385,1075,310
Novo Mundo,510626,MT,Centro-Oeste,PFIZER/BIONTECH,52,52,0
Novo Oriente,230940,CE,Nordeste,BUTANTAN/SINOVAC,4860,2801,2059
Novo Oriente,230940,CE,Nordeste,FIOCRUZ/ASTRAZENECA,2686,2471,215
Novo Oriente De Minas,314535,MG,Sudeste,BUTANTAN/SINOVAC,2406,1281,1125
Novo Oriente De Minas,314535,MG,Sudeste,FIOCRUZ/ASTRAZENECA,849,777,72
Novo Oriente De Minas,314535,MG,Sudeste,PFIZER/BIONTECH,233,233,0
Novo Oriente Do Piauí,220690,PI,Nordeste,BUTANTAN/SINOVAC,1340,678,662
Novo Oriente Do Piauí,220690,PI,Nordeste,FIOCRUZ/ASTRAZENECA,1163,1056,107
Novo Planalto,521525,GO,Centro-Oeste,FIOCRUZ/ASTRAZENECA,1178,1114,64
Novo Planalto,521525,GO,Centro-Oeste,BUTANTAN/SINOVAC,730,394,336
Novo Progresso,150503,PA,Norte,FIOCRUZ/ASTRAZENECA,3041,2601,440
Novo Progresso,150503,PA,Norte,BUTANTAN/SINOVAC,2373,1268,1105
Novo Repartimento,150506,PA,Norte,FIOCRUZ/ASTRAZENECA,5811,5386,425
Novo Repartimento,150506,PA,Norte,BUTANTAN/SINOVAC,1992,1098,894
Novo Santo Antônio,220695,PI,Nordeste,FIOCRUZ/ASTRAZENECA,745,696,49
Novo Santo Antônio,220695,PI,Nordeste,BUTANTAN/SINOVAC,687,361,326
Novo Santo Antônio,220695,PI,Nordeste,PFIZER/BIONTECH,77,77,0
Novo Santo Antônio,510631,MT,Centro-Oeste,FIOCRUZ/ASTRAZENECA,608,553,55
Novo Santo Antônio,510631,MT,Centro-Oeste,BUTANTAN/SINOVAC,401,201,200
Novo Santo Antônio,510631,MT,Centro-Oeste,PFIZER/BIONTECH,24,24,0
Novo São Joaquim,510628,MT,Centro-Oeste,BUTANTAN/SINOVAC,934,473,461
Novo São Joaquim,510628,MT,Centro-Oeste,FIOCRUZ/ASTRAZENECA,893,857,36
Novo São Joaquim,510628,MT,Centro-Oeste,PFIZER/BIONTECH,6,6,0
Novo Tiradentes,431344,RS,Sul,BUTANTAN/SINOVAC,816,409,407
Novo Tiradentes,431344,RS,Sul,FIOCRUZ/ASTRAZENECA,529,500,29
Novo Tiradentes,431344,RS,Sul,PFIZER/BIONTECH,102,102,0
Novo Triunfo,292305,BA,Nordeste,FIOCRUZ/ASTRAZENECA,2548,2314,234
Novo Triunfo,292305,BA,Nordeste,BUTANTAN/SINOVAC,2170,1167,1003
Novo Triunfo,292305,BA,Nordeste,PFIZER/BIONTECH,218,218,0
Novo Xingu,431346,RS,Sul,FIOCRUZ/ASTRAZENECA,660,585,75
Novo Xingu,431346,RS,Sul,BUTANTAN/SINOVAC,545,273,272
Novo Xingu,431346,RS,Sul,PFIZER/BIONTECH,71,70,1
Novorizonte,314537,MG,Sudeste,BUTANTAN/SINOVAC,1533,1055,478
Novorizonte,314537,MG,Sudeste,FIOCRUZ/ASTRAZENECA,354,353,1
Novorizonte,314537,MG,Sudeste,PFIZER/BIONTECH,56,56,0
Nuporanga,353360,SP,Sudeste,BUTANTAN/SINOVAC,2027,1061,966
Nuporanga,353360,SP,Sudeste,FIOCRUZ/ASTRAZENECA,1974,1839,135
Nuporanga,353360,SP,Sudeste,PFIZER/BIONTECH,162,162,0
Óbidos,150510,PA,Norte,FIOCRUZ/ASTRAZENECA,19342,14440,4902
Óbidos,150510,PA,Norte,BUTANTAN/SINOVAC,3073,1735,1338
Ocara,230945,CE,Nordeste,BUTANTAN/SINOVAC,4034,2090,1944
Ocara,230945,CE,Nordeste,FIOCRUZ/ASTRAZENECA,2056,1828,228
Ocara,230945,CE,Nordeste,PFIZER/BIONTECH,2,1,1
Ocauçu,353370,SP,Sudeste,FIOCRUZ/ASTRAZENECA,1190,1094,96
Ocauçu,353370,SP,Sudeste,BUTANTAN/SINOVAC,1086,574,512
Ocauçu,353370,SP,Sudeste,PFIZER/BIONTECH,125,125,0
Oeiras,220700,PI,Nordeste,FIOCRUZ/ASTRAZENECA,8765,7564,1201
Oeiras,220700,PI,Nordeste,BUTANTAN/SINOVAC,6300,3178,3122
Oeiras,220700,PI,Nordeste,PFIZER/BIONTECH,280,280,0
Oeiras Do Pará,150520,PA,Norte,FIOCRUZ/ASTRAZENECA,4587,4130,457
Oeiras Do Pará,150520,PA,Norte,BUTANTAN/SINOVAC,2622,1409,1213
Oiapoque,160050,AP,Norte,BUTANTAN/SINOVAC,7814,4311,3503
Oiapoque,160050,AP,Norte,FIOCRUZ/ASTRAZENECA,770,682,88
Olaria,314540,MG,Sudeste,FIOCRUZ/ASTRAZENECA,722,669,53
Olaria,314540,MG,Sudeste,BUTANTAN/SINOVAC,620,315,305
Olaria,314540,MG,Sudeste,PFIZER/BIONTECH,46,46,0
Óleo,353380,SP,Sudeste,BUTANTAN/SINOVAC,946,491,455
Óleo,353380,SP,Sudeste,FIOCRUZ/ASTRAZENECA,712,657,55
Óleo,353380,SP,Sudeste,PFIZER/BIONTECH,57,57,0
Olho D'Água,251040,PB,Nordeste,BUTANTAN/SINOVAC,1534,768,766
Olho D'Água,251040,PB,Nordeste,FIOCRUZ/ASTRAZENECA,943,879,64
Olho D'Água,251040,PB,Nordeste,PFIZER/BIONTECH,77,77,0
Olho D'Água Das Cunhãs,210740,MA,Nordeste,FIOCRUZ/ASTRAZENECA,4728,4463,265
Olho D'Água Das Cunhãs,210740,MA,Nordeste,BUTANTAN/SINOVAC,3374,1831,1543
Olho D'Água Das Flores,270570,AL,Nordeste,FIOCRUZ/ASTRAZENECA,5101,4803,298
Olho D'Água Das Flores,270570,AL,Nordeste,BUTANTAN/SINOVAC,3465,1805,1660
Olho D'Água Do Casado,270580,AL,Nordeste,FIOCRUZ/ASTRAZENECA,1927,1795,132
Olho D'Água Do Casado,270580,AL,Nordeste,BUTANTAN/SINOVAC,1244,665,579
Olho D'Água Do Piauí,220710,PI,Nordeste,BUTANTAN/SINOVAC,687,353,334
Olho D'Água Do Piauí,220710,PI,Nordeste,FIOCRUZ/ASTRAZENECA,515,472,43
Olho D'Água Do Piauí,220710,PI,Nordeste,PFIZER/BIONTECH,62,62,0
Olho D'Água Grande,270590,AL,Nordeste,BUTANTAN/SINOVAC,881,454,427
Olho D'Água Grande,270590,AL,Nordeste,FIOCRUZ/ASTRAZENECA,759,716,43
Olho-D'Água Do Borges,240840,RN,Nordeste,BUTANTAN/SINOVAC,1780,907,873
Olho-D'Água Do Borges,240840,RN,Nordeste,FIOCRUZ/ASTRAZENECA,1516,1417,99
Olho-D'Água Do Borges,240840,RN,Nordeste,PFIZER/BIONTECH,95,95,0
Olhos-D'Água,314545,MG,Sudeste,FIOCRUZ/ASTRAZENECA,1401,1312,89
Olhos-D'Água,314545,MG,Sudeste,BUTANTAN/SINOVAC,751,389,362
Olhos-D'Água,314545,MG,Sudeste,PFIZER/BIONTECH,74,74,0
Olímpia,353390,SP,Sudeste,BUTANTAN/SINOVAC,14343,7963,6380
Olímpia,353390,SP,Sudeste,FIOCRUZ/ASTRAZENECA,12376,11333,1043
Olímpia,353390,SP,Sudeste,PFIZER/BIONTECH,1198,1192,6
Olímpio Noronha,314550,MG,Sudeste,FIOCRUZ/ASTRAZENECA,924,867,57
Olímpio Noronha,314550,MG,Sudeste,BUTANTAN/SINOVAC,641,325,316
Olímpio Noronha,314550,MG,Sudeste,PFIZER/BIONTECH,18,18,0
Olinda,260960,PE,Nordeste,BUTANTAN/SINOVAC,68652,35314,33338
Olinda,260960,PE,Nordeste,FIOCRUZ/ASTRAZENECA,34563,29254,5309
Olinda,260960,PE,Nordeste,PFIZER/BIONTECH,4547,4532,15
Olinda Nova Do Maranhão,210745,MA,Nordeste,FIOCRUZ/ASTRAZENECA,3356,3087,269
Olinda Nova Do Maranhão,210745,MA,Nordeste,BUTANTAN/SINOVAC,1818,935,883
Olindina,292310,BA,Nordeste,FIOCRUZ/ASTRAZENECA,4869,4448,421
Olindina,292310,BA,Nordeste,BUTANTAN/SINOVAC,4472,2265,2207
Olindina,292310,BA,Nordeste,PFIZER/BIONTECH,229,227,2
Olivedos,251050,PB,Nordeste,BUTANTAN/SINOVAC,911,463,448
Olivedos,251050,PB,Nordeste,FIOCRUZ/ASTRAZENECA,630,546,84
Olivedos,251050,PB,Nordeste,PFIZER/BIONTECH,47,47,0
Oliveira,314560,MG,Sudeste,BUTANTAN/SINOVAC,9458,4960,4498
Oliveira,314560,MG,Sudeste,FIOCRUZ/ASTRAZENECA,8498,7688,810
Oliveira,314560,MG,Sudeste,PFIZER/BIONTECH,1215,1215,0
Oliveira De Fátima,171550,TO,Norte,BUTANTAN/SINOVAC,269,135,134
Oliveira De Fátima,171550,TO,Norte,FIOCRUZ/ASTRAZENECA,249,230,19
Oliveira Dos Brejinhos,292320,BA,Nordeste,BUTANTAN/SINOVAC,4784,2521,2263
Oliveira Dos Brejinhos,292320,BA,Nordeste,FIOCRUZ/ASTRAZENECA,4465,4344,121
Oliveira Fortes,314570,MG,Sudeste,FIOCRUZ/ASTRAZENECA,585,550,35
Oliveira Fortes,314570,MG,Sudeste,BUTANTAN/SINOVAC,462,257,205
Oliveira Fortes,314570,MG,Sudeste,PFIZER/BIONTECH,106,106,0
Olivença,270600,AL,Nordeste,FIOCRUZ/ASTRAZENECA,2018,1788,230
Olivença,270600,AL,Nordeste,BUTANTAN/SINOVAC,1875,955,920
Onça De Pitangui,314580,MG,Sudeste,FIOCRUZ/ASTRAZENECA,593,565,28
Onça De Pitangui,314580,MG,Sudeste,BUTANTAN/SINOVAC,541,339,202
Onça De Pitangui,314580,MG,Sudeste,PFIZER/BIONTECH,40,40,0
Onda Verde,353400,SP,Sudeste,BUTANTAN/SINOVAC,1224,706,518
Onda Verde,353400,SP,Sudeste,FIOCRUZ/ASTRAZENECA,1175,1090,85
Onda Verde,353400,SP,Sudeste,PFIZER/BIONTECH,53,53,0
Oratórios,314585,MG,Sudeste,FIOCRUZ/ASTRAZENECA,1359,1280,79
Oratórios,314585,MG,Sudeste,BUTANTAN/SINOVAC,1334,682,652
Oratórios,314585,MG,Sudeste,PFIZER/BIONTECH,64,64,0
Oriente,353410,SP,Sudeste,BUTANTAN/SINOVAC,1986,1154,832
Oriente,353410,SP,Sudeste,FIOCRUZ/ASTRAZENECA,1556,1383,173
Oriente,353410,SP,Sudeste,PFIZER/BIONTECH,201,201,0
Orindiúva,353420,SP,Sudeste,FIOCRUZ/ASTRAZENECA,1535,1432,103
Orindiúva,353420,SP,Sudeste,BUTANTAN/SINOVAC,1095,628,467
Orindiúva,353420,SP,Sudeste,PFIZER/BIONTECH,238,238,0
Oriximiná,150530,PA,Norte,FIOCRUZ/ASTRAZENECA,18193,15677,2516
Oriximiná,150530,PA,Norte,BUTANTAN/SINOVAC,5855,3346,2509
Orizânia,314587,MG,Sudeste,FIOCRUZ/ASTRAZENECA,1387,1298,89
Orizânia,314587,MG,Sudeste,BUTANTAN/SINOVAC,1266,661,605
Orizânia,314587,MG,Sudeste,PFIZER/BIONTECH,39,39,0
Orizona,521530,GO,Centro-Oeste,FIOCRUZ/ASTRAZENECA,4962,4610,352
Orizona,521530,GO,Centro-Oeste,BUTANTAN/SINOVAC,3653,2031,1622
Orlândia,353430,SP,Sudeste,BUTANTAN/SINOVAC,9402,5305,4097
Orlândia,353430,SP,Sudeste,FIOCRUZ/ASTRAZENECA,7721,7070,651
Orlândia,353430,SP,Sudeste,PFIZER/BIONTECH,612,611,1
Orleans,421170,SC,Sul,FIOCRUZ/ASTRAZENECA,6505,5974,531
Orleans,421170,SC,Sul,BUTANTAN/SINOVAC,4914,2706,2208
Orleans,421170,SC,Sul,PFIZER/BIONTECH,612,612,0
Orobó,260970,PE,Nordeste,FIOCRUZ/ASTRAZENECA,5660,5106,554
Orobó,260970,PE,Nordeste,BUTANTAN/SINOVAC,4221,2168,2053
Orobó,260970,PE,Nordeste,PFIZER/BIONTECH,176,176,0
Orocó,260980,PE,Nordeste,FIOCRUZ/ASTRAZENECA,4854,4494,360
Orocó,260980,PE,Nordeste,BUTANTAN/SINOVAC,2217,1127,1090
Orocó,260980,PE,Nordeste,PFIZER/BIONTECH,132,132,0
Orós,230950,CE,Nordeste,BUTANTAN/SINOVAC,4257,2483,1774
Orós,230950,CE,Nordeste,FIOCRUZ/ASTRAZENECA,2509,2251,258
Orós,230950,CE,Nordeste,PFIZER/BIONTECH,33,33,0
Ortigueira,411730,PR,Sul,FIOCRUZ/ASTRAZENECA,5760,5528,232
Ortigueira,411730,PR,Sul,BUTANTAN/SINOVAC,4946,2717,2229
Osasco,353440,SP,Sudeste,FIOCRUZ/ASTRAZENECA,145443,134742,10701
Osasco,353440,SP,Sudeste,BUTANTAN/SINOVAC,132774,78531,54243
Osasco,353440,SP,Sudeste,PFIZER/BIONTECH,12478,12449,29
Oscar Bressane,353450,SP,Sudeste,BUTANTAN/SINOVAC,984,546,438
Oscar Bressane,353450,SP,Sudeste,FIOCRUZ/ASTRAZENECA,683,602,81
Oscar Bressane,353450,SP,Sudeste,PFIZER/BIONTECH,60,60,0
Osório,431350,RS,Sul,FIOCRUZ/ASTRAZENECA,14133,12838,1295
Osório,431350,RS,Sul,BUTANTAN/SINOVAC,13652,6942,6710
Osório,431350,RS,Sul,PFIZER/BIONTECH,1339,1339,0
Osvaldo Cruz,353460,SP,Sudeste,BUTANTAN/SINOVAC,9293,5087,4206
Osvaldo Cruz,353460,SP,Sudeste,FIOCRUZ/ASTRAZENECA,7501,6799,702
Osvaldo Cruz,353460,SP,Sudeste,PFIZER/BIONTECH,360,360,0
Otacílio Costa,421175,SC,Sul,FIOCRUZ/ASTRAZENECA,5029,4662,367
Otacílio Costa,421175,SC,Sul,BUTANTAN/SINOVAC,3272,1859,1413
Otacílio Costa,421175,SC,Sul,PFIZER/BIONTECH,206,205,1
Ourém,150540,PA,Norte,FIOCRUZ/ASTRAZENECA,3157,2270,887
Ourém,150540,PA,Norte,BUTANTAN/SINOVAC,2096,1076,1020
Ouriçangas,292330,BA,Nordeste,FIOCRUZ/ASTRAZENECA,1949,1862,87
Ouriçangas,292330,BA,Nordeste,BUTANTAN/SINOVAC,1892,1095,797
Ouriçangas,292330,BA,Nordeste,PFIZER/BIONTECH,186,185,1
Ouricuri,260990,PE,Nordeste,BUTANTAN/SINOVAC,12331,6537,5794
Ouricuri,260990,PE,Nordeste,FIOCRUZ/ASTRAZENECA,11079,10198,881
Ouricuri,260990,PE,Nordeste,PFIZER/BIONTECH,1462,1385,77
Ourilândia Do Norte,150543,PA,Norte,BUTANTAN/SINOVAC,3270,1814,1456
Ourilândia Do Norte,150543,PA,Norte,FIOCRUZ/ASTRAZENECA,2485,2224,261
Ourinhos,353470,SP,Sudeste,FIOCRUZ/ASTRAZENECA,29490,27550,1940
Ourinhos,353470,SP,Sudeste,BUTANTAN/SINOVAC,29166,16384,12782
Ourinhos,353470,SP,Sudeste,PFIZER/BIONTECH,3534,3534,0
Ourizona,411740,PR,Sul,FIOCRUZ/ASTRAZENECA,1472,1400,72
Ourizona,411740,PR,Sul,BUTANTAN/SINOVAC,926,483,443
Ourizona,411740,PR,Sul,PFIZER/BIONTECH,17,16,1
Ouro,421180,SC,Sul,FIOCRUZ/ASTRAZENECA,1999,1902,97
Ouro,421180,SC,Sul,BUTANTAN/SINOVAC,1841,951,890
Ouro,421180,SC,Sul,PFIZER/BIONTECH,179,178,1
Ouro Branco,240850,RN,Nordeste,BUTANTAN/SINOVAC,1234,615,619
Ouro Branco,240850,RN,Nordeste,FIOCRUZ/ASTRAZENECA,1174,1074,100
Ouro Branco,240850,RN,Nordeste,PFIZER/BIONTECH,149,149,0
Ouro Branco,270610,AL,Nordeste,BUTANTAN/SINOVAC,2113,1150,963
Ouro Branco,270610,AL,Nordeste,FIOCRUZ/ASTRAZENECA,2039,1804,235
Ouro Branco,314590,MG,Sudeste,BUTANTAN/SINOVAC,3606,2251,1355
Ouro Branco,314590,MG,Sudeste,FIOCRUZ/ASTRAZENECA,1304,1006,298
Ouro Fino,314600,MG,Sudeste,BUTANTAN/SINOVAC,6565,3875,2690
Ouro Fino,314600,MG,Sudeste,FIOCRUZ/ASTRAZENECA,6123,5826,297
Ouro Fino,314600,MG,Sudeste,PFIZER/BIONTECH,251,251,0
Ouro Preto,314610,MG,Sudeste,FIOCRUZ/ASTRAZENECA,15811,14829,982
Ouro Preto,314610,MG,Sudeste,BUTANTAN/SINOVAC,15544,7834,7710
Ouro Preto,314610,MG,Sudeste,PFIZER/BIONTECH,2680,2674,6
Ouro Preto Do Oeste,110015,RO,Norte,BUTANTAN/SINOVAC,6373,3816,2557
Ouro Preto Do Oeste,110015,RO,Norte,FIOCRUZ/ASTRAZENECA,5996,5739,257
Ouro Preto Do Oeste,110015,RO,Norte,PFIZER/BIONTECH,711,710,1
Ouro Velho,251060,PB,Nordeste,BUTANTAN/SINOVAC,822,427,395
Ouro Velho,251060,PB,Nordeste,FIOCRUZ/ASTRAZENECA,666,616,50
Ouro Velho,251060,PB,Nordeste,PFIZER/BIONTECH,72,72,0
Ouro Verde,353480,SP,Sudeste,BUTANTAN/SINOVAC,2481,1344,1137
Ouro Verde,353480,SP,Sudeste,FIOCRUZ/ASTRAZENECA,2268,1975,293
Ouro Verde,353480,SP,Sudeste,PFIZER/BIONTECH,54,53,1
Ouro Verde,421185,SC,Sul,BUTANTAN/SINOVAC,569,309,260
Ouro Verde,421185,SC,Sul,FIOCRUZ/ASTRAZENECA,535,473,62
Ouro Verde,421185,SC,Sul,PFIZER/BIONTECH,7,7,0
Ouro Verde De Goiás,521540,GO,Centro-Oeste,FIOCRUZ/ASTRAZENECA,1242,1168,74
Ouro Verde De Goiás,521540,GO,Centro-Oeste,BUTANTAN/SINOVAC,815,465,350
Ouro Verde De Minas,314620,MG,Sudeste,BUTANTAN/SINOVAC,1460,847,613
Ouro Verde De Minas,314620,MG,Sudeste,FIOCRUZ/ASTRAZENECA,1125,1110,15
Ouro Verde Do Oeste,411745,PR,Sul,FIOCRUZ/ASTRAZENECA,1475,1394,81
Ouro Verde Do Oeste,411745,PR,Sul,BUTANTAN/SINOVAC,1198,620,578
Ouro Verde Do Oeste,411745,PR,Sul,PFIZER/BIONTECH,11,11,0
Ouroeste,353475,SP,Sudeste,BUTANTAN/SINOVAC,2711,1485,1226
Ouroeste,353475,SP,Sudeste,FIOCRUZ/ASTRAZENECA,2607,2393,214
Ouroeste,353475,SP,Sudeste,PFIZER/BIONTECH,238,238,0
Ourolândia,292335,BA,Nordeste,FIOCRUZ/ASTRAZENECA,2957,2537,420
Ourolândia,292335,BA,Nordeste,BUTANTAN/SINOVAC,2501,1346,1155
Ourolândia,292335,BA,Nordeste,PFIZER/BIONTECH,33,33,0
Ouvidor,521550,GO,Centro-Oeste,FIOCRUZ/ASTRAZENECA,2188,1883,305
Ouvidor,521550,GO,Centro-Oeste,BUTANTAN/SINOVAC,1240,624,616
Ouvidor,521550,GO,Centro-Oeste,PFIZER/BIONTECH,91,91,0
Pacaembu,353490,SP,Sudeste,BUTANTAN/SINOVAC,4303,2563,1740
Pacaembu,353490,SP,Sudeste,FIOCRUZ/ASTRAZENECA,2573,2237,336
Pacaembu,353490,SP,Sudeste,PFIZER/BIONTECH,112,112,0
Pacajá,150548,PA,Norte,FIOCRUZ/ASTRAZENECA,4599,3543,1056
Pacajá,150548,PA,Norte,BUTANTAN/SINOVAC,3694,1992,1702
Pacajus,230960,CE,Nordeste,BUTANTAN/SINOVAC,9718,5049,4669
Pacajus,230960,CE,Nordeste,FIOCRUZ/ASTRAZENECA,5226,4667,559
Pacaraima,140045,RR,Norte,BUTANTAN/SINOVAC,6285,3520,2765
Pacaraima,140045,RR,Norte,FIOCRUZ/ASTRAZENECA,872,870,2
Pacatuba,230970,CE,Nordeste,BUTANTAN/SINOVAC,9544,4817,4727
Pacatuba,230970,CE,Nordeste,FIOCRUZ/ASTRAZENECA,6253,5560,693
Pacatuba,280490,SE,Nordeste,FIOCRUZ/ASTRAZENECA,2441,2297,144
Pacatuba,280490,SE,Nordeste,BUTANTAN/SINOVAC,2217,1136,1081
Pacatuba,280490,SE,Nordeste,PFIZER/BIONTECH,261,261,0
Paço Do Lumiar,210750,MA,Nordeste,FIOCRUZ/ASTRAZENECA,46403,45215,1188
Paço Do Lumiar,210750,MA,Nordeste,BUTANTAN/SINOVAC,12341,6417,5924
Paço Do Lumiar,210750,MA,Nordeste,PFIZER/BIONTECH,534,533,1
Pacoti,230980,CE,Nordeste,BUTANTAN/SINOVAC,1515,817,698
Pacoti,230980,CE,Nordeste,FIOCRUZ/ASTRAZENECA,820,751,69
Pacoti,230980,CE,Nordeste,PFIZER/BIONTECH,1,1,0
Pacujá,230990,CE,Nordeste,BUTANTAN/SINOVAC,1296,683,613
Pacujá,230990,CE,Nordeste,FIOCRUZ/ASTRAZENECA,850,788,62
Padre Bernardo,521560,GO,Centro-Oeste,FIOCRUZ/ASTRAZENECA,7669,6528,1141
Padre Bernardo,521560,GO,Centro-Oeste,BUTANTAN/SINOVAC,3559,1863,1696
Padre Carvalho,314625,MG,Sudeste,FIOCRUZ/ASTRAZENECA,986,930,56
Padre Carvalho,314625,MG,Sudeste,BUTANTAN/SINOVAC,805,423,382
Padre Carvalho,314625,MG,Sudeste,PFIZER/BIONTECH,47,47,0
Padre Marcos,220720,PI,Nordeste,BUTANTAN/SINOVAC,1286,653,633
Padre Marcos,220720,PI,Nordeste,FIOCRUZ/ASTRAZENECA,637,540,97
Padre Paraíso,314630,MG,Sudeste,BUTANTAN/SINOVAC,4175,2162,2013
Padre Paraíso,314630,MG,Sudeste,FIOCRUZ/ASTRAZENECA,2403,2188,215
Paes Landim,220730,PI,Nordeste,BUTANTAN/SINOVAC,1080,596,484
Paes Landim,220730,PI,Nordeste,FIOCRUZ/ASTRAZENECA,738,684,54
Pai Pedro,314655,MG,Sudeste,FIOCRUZ/ASTRAZENECA,1568,1507,61
Pai Pedro,314655,MG,Sudeste,BUTANTAN/SINOVAC,1065,544,521
Pai Pedro,314655,MG,Sudeste,PFIZER/BIONTECH,25,25,0
Paial,421187,SC,Sul,BUTANTAN/SINOVAC,618,321,297
Paial,421187,SC,Sul,FIOCRUZ/ASTRAZENECA,486,430,56
Paiçandu,411750,PR,Sul,FIOCRUZ/ASTRAZENECA,9052,8573,479
Paiçandu,411750,PR,Sul,BUTANTAN/SINOVAC,7722,3998,3724
Paiçandu,411750,PR,Sul,PFIZER/BIONTECH,465,465,0
Paim Filho,431360,RS,Sul,BUTANTAN/SINOVAC,1362,687,675
Paim Filho,431360,RS,Sul,FIOCRUZ/ASTRAZENECA,1265,1050,215
Paim Filho,431360,RS,Sul,PFIZER/BIONTECH,158,158,0
Paineiras,314640,MG,Sudeste,BUTANTAN/SINOVAC,1362,695,667
Paineiras,314640,MG,Sudeste,FIOCRUZ/ASTRAZENECA,1185,1083,102
Paineiras,314640,MG,Sudeste,PFIZER/BIONTECH,90,90,0
Painel,421189,SC,Sul,FIOCRUZ/ASTRAZENECA,889,816,73
Painel,421189,SC,Sul,BUTANTAN/SINOVAC,632,359,273
Pains,314650,MG,Sudeste,BUTANTAN/SINOVAC,2915,1614,1301
Pains,314650,MG,Sudeste,FIOCRUZ/ASTRAZENECA,2134,1935,199
Pains,314650,MG,Sudeste,PFIZER/BIONTECH,299,299,0
Paiva,314660,MG,Sudeste,FIOCRUZ/ASTRAZENECA,698,540,158
Paiva,314660,MG,Sudeste,BUTANTAN/SINOVAC,504,272,232
Paiva,314660,MG,Sudeste,PFIZER/BIONTECH,30,30,0
Pajeú Do Piauí,220735,PI,Nordeste,BUTANTAN/SINOVAC,926,477,449
Pajeú Do Piauí,220735,PI,Nordeste,FIOCRUZ/ASTRAZENECA,505,450,55
Palestina,270620,AL,Nordeste,FIOCRUZ/ASTRAZENECA,1459,1360,99
Palestina,270620,AL,Nordeste,BUTANTAN/SINOVAC,913,475,438
Palestina,353500,SP,Sudeste,BUTANTAN/SINOVAC,3419,1797,1622
Palestina,353500,SP,Sudeste,FIOCRUZ/ASTRAZENECA,2413,2158,255
Palestina De Goiás,521565,GO,Centro-Oeste,BUTANTAN/SINOVAC,747,416,331
Palestina De Goiás,521565,GO,Centro-Oeste,FIOCRUZ/ASTRAZENECA,725,680,45
Palestina Do Pará,150549,PA,Norte,FIOCRUZ/ASTRAZENECA,992,907,85
Palestina Do Pará,150549,PA,Norte,BUTANTAN/SINOVAC,427,229,198
Palhano,231000,CE,Nordeste,BUTANTAN/SINOVAC,1970,1021,949
Palhano,231000,CE,Nordeste,FIOCRUZ/ASTRAZENECA,1772,1594,178
Palhano,231000,CE,Nordeste,PFIZER/BIONTECH,143,143,0
Palhoça,421190,SC,Sul,FIOCRUZ/ASTRAZENECA,33432,29662,3770
Palhoça,421190,SC,Sul,BUTANTAN/SINOVAC,29564,16209,13355
Palhoça,421190,SC,Sul,PFIZER/BIONTECH,13355,13355,0
Palma,314670,MG,Sudeste,BUTANTAN/SINOVAC,1511,935,576
Palma,314670,MG,Sudeste,FIOCRUZ/ASTRAZENECA,895,853,42
Palma Sola,421200,SC,Sul,FIOCRUZ/ASTRAZENECA,1843,1696,147
Palma Sola,421200,SC,Sul,BUTANTAN/SINOVAC,1580,849,731
Palma Sola,421200,SC,Sul,PFIZER/BIONTECH,180,180,0
Palmácia,231010,CE,Nordeste,BUTANTAN/SINOVAC,2552,1316,1236
Palmácia,231010,CE,Nordeste,FIOCRUZ/ASTRAZENECA,1839,1627,212
Palmácia,231010,CE,Nordeste,PFIZER/BIONTECH,35,35,0
Palmares,261000,PE,Nordeste,BUTANTAN/SINOVAC,11367,5850,5517
Palmares,261000,PE,Nordeste,FIOCRUZ/ASTRAZENECA,9375,8723,652
Palmares,261000,PE,Nordeste,PFIZER/BIONTECH,545,542,3
Palmares Do Sul,431365,RS,Sul,BUTANTAN/SINOVAC,4670,2415,2255
Palmares Do Sul,431365,RS,Sul,FIOCRUZ/ASTRAZENECA,3374,3138,236
Palmares Do Sul,431365,RS,Sul,PFIZER/BIONTECH,345,345,0
Palmares Paulista,353510,SP,Sudeste,FIOCRUZ/ASTRAZENECA,1841,1731,110
Palmares Paulista,353510,SP,Sudeste,BUTANTAN/SINOVAC,1514,785,729
Palmares Paulista,353510,SP,Sudeste,PFIZER/BIONTECH,93,93,0
Palmas,172100,TO,Norte,BUTANTAN/SINOVAC,38855,20535,18320
Palmas,172100,TO,Norte,FIOCRUZ/ASTRAZENECA,35219,33936,1283
Palmas,172100,TO,Norte,PFIZER/BIONTECH,22043,22019,24
Palmas,411760,PR,Sul,FIOCRUZ/ASTRAZENECA,10268,9238,1030
Palmas,411760,PR,Sul,BUTANTAN/SINOVAC,7000,3781,3219
Palmas,411760,PR,Sul,PFIZER/BIONTECH,1091,1089,2
Palmas De Monte Alto,292340,BA,Nordeste,FIOCRUZ/ASTRAZENECA,6322,5984,338
Palmas De Monte Alto,292340,BA,Nordeste,BUTANTAN/SINOVAC,4007,2093,1914
Palmas De Monte Alto,292340,BA,Nordeste,PFIZER/BIONTECH,67,67,0
Palmeira,411770,PR,Sul,BUTANTAN/SINOVAC,6165,3163,3002
Palmeira,411770,PR,Sul,FIOCRUZ/ASTRAZENECA,5288,4982,306
Palmeira,421205,SC,Sul,FIOCRUZ/ASTRAZENECA,756,644,112
Palmeira,421205,SC,Sul,BUTANTAN/SINOVAC,702,370,332
Palmeira,421205,SC,Sul,PFIZER/BIONTECH,6,6,0
Palmeira D'Oeste,353520,SP,Sudeste,BUTANTAN/SINOVAC,3243,1820,1423
Palmeira D'Oeste,353520,SP,Sudeste,FIOCRUZ/ASTRAZENECA,2961,2691,270
Palmeira D'Oeste,353520,SP,Sudeste,PFIZER/BIONTECH,197,197,0
Palmeira Das Missões,431370,RS,Sul,FIOCRUZ/ASTRAZENECA,9282,8408,874
Palmeira Das Missões,431370,RS,Sul,BUTANTAN/SINOVAC,8592,4312,4280
Palmeira Das Missões,431370,RS,Sul,PFIZER/BIONTECH,1368,1368,0
Palmeira Do Piauí,220740,PI,Nordeste,FIOCRUZ/ASTRAZENECA,962,881,81
Palmeira Do Piauí,220740,PI,Nordeste,BUTANTAN/SINOVAC,910,469,441
Palmeira Dos Índios,270630,AL,Nordeste,FIOCRUZ/ASTRAZENECA,17953,15487,2466
Palmeira Dos Índios,270630,AL,Nordeste,BUTANTAN/SINOVAC,16129,8332,7797
Palmeira Dos Índios,270630,AL,Nordeste,PFIZER/BIONTECH,1238,1223,15
Palmeirais,220750,PI,Nordeste,BUTANTAN/SINOVAC,2302,1472,830
Palmeirais,220750,PI,Nordeste,FIOCRUZ/ASTRAZENECA,1780,1764,16
Palmeirândia,210760,MA,Nordeste,FIOCRUZ/ASTRAZENECA,4823,4513,310
Palmeirândia,210760,MA,Nordeste,BUTANTAN/SINOVAC,3328,1808,1520
Palmeirante,171570,TO,Norte,BUTANTAN/SINOVAC,929,474,455
Palmeirante,171570,TO,Norte,FIOCRUZ/ASTRAZENECA,701,684,17
Palmeiras,292350,BA,Nordeste,BUTANTAN/SINOVAC,3119,1729,1390
Palmeiras,292350,BA,Nordeste,FIOCRUZ/ASTRAZENECA,2954,2646,308
Palmeiras,292350,BA,Nordeste,PFIZER/BIONTECH,83,83,0
Palmeiras De Goiás,521570,GO,Centro-Oeste,FIOCRUZ/ASTRAZENECA,7310,6781,529
Palmeiras De Goiás,521570,GO,Centro-Oeste,BUTANTAN/SINOVAC,5575,2867,2708
Palmeiras De Goiás,521570,GO,Centro-Oeste,PFIZER/BIONTECH,435,435,0
Palmeiras Do Tocantins,171380,TO,Norte,BUTANTAN/SINOVAC,993,514,479
Palmeiras Do Tocantins,171380,TO,Norte,FIOCRUZ/ASTRAZENECA,681,642,39
Palmeirina,261010,PE,Nordeste,BUTANTAN/SINOVAC,1304,665,639
Palmeirina,261010,PE,Nordeste,FIOCRUZ/ASTRAZENECA,1067,1005,62
Palmeirina,261010,PE,Nordeste,PFIZER/BIONTECH,126,125,1
Palmeirópolis,171575,TO,Norte,FIOCRUZ/ASTRAZENECA,1585,1539,46
Palmeirópolis,171575,TO,Norte,BUTANTAN/SINOVAC,1501,756,745
Palmelo,521580,GO,Centro-Oeste,FIOCRUZ/ASTRAZENECA,958,798,160
Palmelo,521580,GO,Centro-Oeste,BUTANTAN/SINOVAC,613,314,299
Palmelo,521580,GO,Centro-Oeste,PFIZER/BIONTECH,18,18,0
Palminópolis,521590,GO,Centro-Oeste,FIOCRUZ/ASTRAZENECA,1078,990,88
Palminópolis,521590,GO,Centro-Oeste,BUTANTAN/SINOVAC,917,460,457
Palminópolis,521590,GO,Centro-Oeste,PFIZER/BIONTECH,48,48,0
Palmital,353530,SP,Sudeste,BUTANTAN/SINOVAC,6510,3617,2893
Palmital,353530,SP,Sudeste,FIOCRUZ/ASTRAZENECA,5369,4883,486
Palmital,353530,SP,Sudeste,PFIZER/BIONTECH,813,813,0
Palmital,411780,PR,Sul,FIOCRUZ/ASTRAZENECA,3518,3390,128
Palmital,411780,PR,Sul,BUTANTAN/SINOVAC,2792,1455,1337
Palmital,411780,PR,Sul,PFIZER/BIONTECH,119,119,0
Palmitinho,431380,RS,Sul,BUTANTAN/SINOVAC,2310,1180,1130
Palmitinho,431380,RS,Sul,FIOCRUZ/ASTRAZENECA,2025,1835,190
Palmitinho,431380,RS,Sul,PFIZER/BIONTECH,285,285,0
Palmitos,421210,SC,Sul,FIOCRUZ/ASTRAZENECA,4409,4049,360
Palmitos,421210,SC,Sul,BUTANTAN/SINOVAC,4383,2313,2070
Palmitos,421210,SC,Sul,PFIZER/BIONTECH,430,430,0
Palmópolis,314675,MG,Sudeste,BUTANTAN/SINOVAC,1556,829,727
Palmópolis,314675,MG,Sudeste,FIOCRUZ/ASTRAZENECA,1135,1044,91
Palmópolis,314675,MG,Sudeste,PFIZER/BIONTECH,212,212,0
Palotina,411790,PR,Sul,BUTANTAN/SINOVAC,6648,3379,3269
Palotina,411790,PR,Sul,FIOCRUZ/ASTRAZENECA,6105,5691,414
Palotina,411790,PR,Sul,PFIZER/BIONTECH,195,195,0
Panamá,521600,GO,Centro-Oeste,FIOCRUZ/ASTRAZENECA,784,750,34
Panamá,521600,GO,Centro-Oeste,BUTANTAN/SINOVAC,634,333,301
Panambi,431390,RS,Sul,BUTANTAN/SINOVAC,9298,4695,4603
Panambi,431390,RS,Sul,FIOCRUZ/ASTRAZENECA,6997,6415,582
Panambi,431390,RS,Sul,PFIZER/BIONTECH,503,503,0
Pancas,320400,ES,Sudeste,BUTANTAN/SINOVAC,5941,3139,2802
Pancas,320400,ES,Sudeste,FIOCRUZ/ASTRAZENECA,4528,4332,196
Pancas,320400,ES,Sudeste,PFIZER/BIONTECH,823,822,1
Panelas,261020,PE,Nordeste,BUTANTAN/SINOVAC,5022,2806,2216
Panelas,261020,PE,Nordeste,FIOCRUZ/ASTRAZENECA,4136,3811,325
Panelas,261020,PE,Nordeste,PFIZER/BIONTECH,186,186,0
Panorama,353540,SP,Sudeste,BUTANTAN/SINOVAC,3690,2005,1685
Panorama,353540,SP,Sudeste,FIOCRUZ/ASTRAZENECA,3683,3460,223
Panorama,353540,SP,Sudeste,PFIZER/BIONTECH,377,377,0
Pantano Grande,431395,RS,Sul,BUTANTAN/SINOVAC,3263,1957,1306
Pantano Grande,431395,RS,Sul,FIOCRUZ/ASTRAZENECA,2700,2492,208
Pantano Grande,431395,RS,Sul,PFIZER/BIONTECH,347,347,0
Pão De Açúcar,270640,AL,Nordeste,FIOCRUZ/ASTRAZENECA,4765,4424,341
Pão De Açúcar,270640,AL,Nordeste,BUTANTAN/SINOVAC,3637,1875,1762
Papagaios,314690,MG,Sudeste,BUTANTAN/SINOVAC,2214,1124,1090
Papagaios,314690,MG,Sudeste,FIOCRUZ/ASTRAZENECA,2119,1906,213
Papagaios,314690,MG,Sudeste,PFIZER/BIONTECH,12,12,0
Papanduva,421220,SC,Sul,FIOCRUZ/ASTRAZENECA,4227,3985,242
Papanduva,421220,SC,Sul,BUTANTAN/SINOVAC,3153,1720,1433
Papanduva,421220,SC,Sul,PFIZER/BIONTECH,423,423,0
Paquetá,220755,PI,Nordeste,FIOCRUZ/ASTRAZENECA,1240,912,328
Paquetá,220755,PI,Nordeste,BUTANTAN/SINOVAC,937,480,457
Pará De Minas,314710,MG,Sudeste,FIOCRUZ/ASTRAZENECA,17778,16588,1190
Pará De Minas,314710,MG,Sudeste,BUTANTAN/SINOVAC,17169,8877,8292
Pará De Minas,314710,MG,Sudeste,PFIZER/BIONTECH,1826,1824,2
Paracambi,330360,RJ,Sudeste,BUTANTAN/SINOVAC,8967,4522,4445
Paracambi,330360,RJ,Sudeste,FIOCRUZ/ASTRAZENECA,7851,7414,437
Paracatu,314700,MG,Sudeste,FIOCRUZ/ASTRAZENECA,17551,16284,1267
Paracatu,314700,MG,Sudeste,BUTANTAN/SINOVAC,14791,7845,6946
Paracatu,314700,MG,Sudeste,PFIZER/BIONTECH,1482,1482,0
Paracuru,231020,CE,Nordeste,BUTANTAN/SINOVAC,5754,2962,2792
Paracuru,231020,CE,Nordeste,FIOCRUZ/ASTRAZENECA,2860,2657,203
Paragominas,150550,PA,Norte,FIOCRUZ/ASTRAZENECA,21821,20772,1049
Paragominas,150550,PA,Norte,BUTANTAN/SINOVAC,13139,7766,5373
Paraguaçu,314720,MG,Sudeste,BUTANTAN/SINOVAC,4905,2481,2424
Paraguaçu,314720,MG,Sudeste,FIOCRUZ/ASTRAZENECA,3935,3377,558
Paraguaçu Paulista,353550,SP,Sudeste,FIOCRUZ/ASTRAZENECA,11577,10876,701
Paraguaçu Paulista,353550,SP,Sudeste,BUTANTAN/SINOVAC,10204,5786,4418
Paraguaçu Paulista,353550,SP,Sudeste,PFIZER/BIONTECH,1423,1421,2
Paraí,431400,RS,Sul,FIOCRUZ/ASTRAZENECA,2140,1833,307
Paraí,431400,RS,Sul,BUTANTAN/SINOVAC,1877,937,940
Paraí,431400,RS,Sul,PFIZER/BIONTECH,98,98,0
Paraíba Do Sul,330370,RJ,Sudeste,BUTANTAN/SINOVAC,11016,5682,5334
Paraíba Do Sul,330370,RJ,Sudeste,FIOCRUZ/ASTRAZENECA,9622,8971,651
Paraibano,210770,MA,Nordeste,FIOCRUZ/ASTRAZENECA,3980,3774,206
Paraibano,210770,MA,Nordeste,BUTANTAN/SINOVAC,3469,1884,1585
Paraibuna,353560,SP,Sudeste,BUTANTAN/SINOVAC,5371,3236,2135
Paraibuna,353560,SP,Sudeste,FIOCRUZ/ASTRAZENECA,4043,3742,301
Paraibuna,353560,SP,Sudeste,PFIZER/BIONTECH,387,386,1
Paraipaba,231025,CE,Nordeste,BUTANTAN/SINOVAC,4228,2044,2184
Paraipaba,231025,CE,Nordeste,FIOCRUZ/ASTRAZENECA,1686,1287,399
Paraíso,353570,SP,Sudeste,BUTANTAN/SINOVAC,1570,855,715
Paraíso,353570,SP,Sudeste,FIOCRUZ/ASTRAZENECA,1518,1391,127
Paraíso,353570,SP,Sudeste,PFIZER/BIONTECH,100,100,0
Paraíso,421223,SC,Sul,FIOCRUZ/ASTRAZENECA,1344,1249,95
Paraíso,421223,SC,Sul,BUTANTAN/SINOVAC,1055,574,481
Paraíso,421223,SC,Sul,PFIZER/BIONTECH,50,50,0
Paraíso Das Águas,500627,MS,Centro-Oeste,FIOCRUZ/ASTRAZENECA,1173,1092,81
Paraíso Das Águas,500627,MS,Centro-Oeste,BUTANTAN/SINOVAC,1172,596,576
Paraíso Das Águas,500627,MS,Centro-Oeste,PFIZER/BIONTECH,129,129,0
Paraíso Do Norte,411800,PR,Sul,FIOCRUZ/ASTRAZENECA,2964,2769,195
Paraíso Do Norte,411800,PR,Sul,BUTANTAN/SINOVAC,2665,1447,1218
Paraíso Do Norte,411800,PR,Sul,PFIZER/BIONTECH,470,470,0
Paraíso Do Sul,431402,RS,Sul,FIOCRUZ/ASTRAZENECA,2230,1938,292
Paraíso Do Sul,431402,RS,Sul,BUTANTAN/SINOVAC,2174,1101,1073
Paraíso Do Sul,431402,RS,Sul,PFIZER/BIONTECH,223,223,0
Paraíso Do Tocantins,171610,TO,Norte,BUTANTAN/SINOVAC,8186,4175,4011
Paraíso Do Tocantins,171610,TO,Norte,FIOCRUZ/ASTRAZENECA,7241,6708,533
Paraíso Do Tocantins,171610,TO,Norte,PFIZER/BIONTECH,2539,2539,0
Paraisópolis,314730,MG,Sudeste,BUTANTAN/SINOVAC,2345,1330,1015
Paraisópolis,314730,MG,Sudeste,FIOCRUZ/ASTRAZENECA,2116,2110,6
Paraisópolis,314730,MG,Sudeste,PFIZER/BIONTECH,66,66,0
Parambu,231030,CE,Nordeste,BUTANTAN/SINOVAC,7729,4426,3303
Parambu,231030,CE,Nordeste,FIOCRUZ/ASTRAZENECA,4560,3539,1021
Paramirim,292360,BA,Nordeste,FIOCRUZ/ASTRAZENECA,6361,5437,924
Paramirim,292360,BA,Nordeste,BUTANTAN/SINOVAC,5231,2703,2528
Paramirim,292360,BA,Nordeste,PFIZER/BIONTECH,435,435,0
Paramoti,231040,CE,Nordeste,BUTANTAN/SINOVAC,1822,912,910
Paramoti,231040,CE,Nordeste,FIOCRUZ/ASTRAZENECA,1074,872,202
Paraná,240860,RN,Nordeste,BUTANTAN/SINOVAC,1243,631,612
Paraná,240860,RN,Nordeste,FIOCRUZ/ASTRAZENECA,1004,944,60
Paraná,240860,RN,Nordeste,PFIZER/BIONTECH,78,78,0
Paranã,171620,TO,Norte,FIOCRUZ/ASTRAZENECA,2085,1828,257
Paranã,171620,TO,Norte,BUTANTAN/SINOVAC,2024,1044,980
Paranacity,411810,PR,Sul,FIOCRUZ/ASTRAZENECA,2322,2197,125
Paranacity,411810,PR,Sul,BUTANTAN/SINOVAC,2016,1045,971
Paranacity,411810,PR,Sul,PFIZER/BIONTECH,113,113,0
Paranaguá,411820,PR,Sul,FIOCRUZ/ASTRAZENECA,51626,50037,1589
Paranaguá,411820,PR,Sul,BUTANTAN/SINOVAC,19531,12285,7246
Paranaguá,411820,PR,Sul,PFIZER/BIONTECH,7324,7324,0
Paranaíba,500630,MS,Centro-Oeste,FIOCRUZ/ASTRAZENECA,11922,10587,1335
Paranaíba,500630,MS,Centro-Oeste,BUTANTAN/SINOVAC,11089,5959,5130
Paranaíba,500630,MS,Centro-Oeste,PFIZER/BIONTECH,1465,1465,0
Paranaiguara,521630,GO,Centro-Oeste,FIOCRUZ/ASTRAZENECA,2716,2555,161
Paranaiguara,521630,GO,Centro-Oeste,BUTANTAN/SINOVAC,2264,1149,1115
Paranaiguara,521630,GO,Centro-Oeste,PFIZER/BIONTECH,143,143,0
Paranaíta,510629,MT,Centro-Oeste,FIOCRUZ/ASTRAZENECA,2468,2355,113
Paranaíta,510629,MT,Centro-Oeste,BUTANTAN/SINOVAC,1729,896,833
Paranaíta,510629,MT,Centro-Oeste,PFIZER/BIONTECH,267,267,0
Paranapanema,353580,SP,Sudeste,FIOCRUZ/ASTRAZENECA,4828,4577,251
Paranapanema,353580,SP,Sudeste,BUTANTAN/SINOVAC,4359,2482,1877
Paranapanema,353580,SP,Sudeste,PFIZER/BIONTECH,495,494,1
Paranapoema,411830,PR,Sul,FIOCRUZ/ASTRAZENECA,752,717,35
Paranapoema,411830,PR,Sul,BUTANTAN/SINOVAC,531,269,262
Paranapuã,353590,SP,Sudeste,BUTANTAN/SINOVAC,1141,670,471
Paranapuã,353590,SP,Sudeste,FIOCRUZ/ASTRAZENECA,1044,954,90
Paranapuã,353590,SP,Sudeste,PFIZER/BIONTECH,116,116,0
Paranatama,261030,PE,Nordeste,FIOCRUZ/ASTRAZENECA,2686,2496,190
Paranatama,261030,PE,Nordeste,BUTANTAN/SINOVAC,2330,1224,1106
Paranatama,261030,PE,Nordeste,PFIZER/BIONTECH,385,385,0
Paranatinga,510630,MT,Centro-Oeste,BUTANTAN/SINOVAC,4615,2363,2252
Paranatinga,510630,MT,Centro-Oeste,FIOCRUZ/ASTRAZENECA,3687,3433,254
Paranatinga,510630,MT,Centro-Oeste,PFIZER/BIONTECH,126,126,0
Paranavaí,411840,PR,Sul,FIOCRUZ/ASTRAZENECA,22850,20451,2399
Paranavaí,411840,PR,Sul,BUTANTAN/SINOVAC,20475,10804,9671
Paranavaí,411840,PR,Sul,PFIZER/BIONTECH,4897,4891,6
Paranhos,500635,MS,Centro-Oeste,BUTANTAN/SINOVAC,7300,3838,3462
Paranhos,500635,MS,Centro-Oeste,FIOCRUZ/ASTRAZENECA,2265,2150,115
Paranhos,500635,MS,Centro-Oeste,PFIZER/BIONTECH,355,355,0
Paraopeba,314740,MG,Sudeste,FIOCRUZ/ASTRAZENECA,5790,5462,328
Paraopeba,314740,MG,Sudeste,BUTANTAN/SINOVAC,4001,2066,1935
Paraopeba,314740,MG,Sudeste,PFIZER/BIONTECH,561,561,0
Parapuã,353600,SP,Sudeste,BUTANTAN/SINOVAC,5160,2763,2397
Parapuã,353600,SP,Sudeste,FIOCRUZ/ASTRAZENECA,4479,4152,327
Parapuã,353600,SP,Sudeste,PFIZER/BIONTECH,250,250,0
Parari,251065,PB,Nordeste,BUTANTAN/SINOVAC,551,281,270
Parari,251065,PB,Nordeste,FIOCRUZ/ASTRAZENECA,468,428,40
Parari,251065,PB,Nordeste,PFIZER/BIONTECH,47,47,0
Paratinga,292370,BA,Nordeste,FIOCRUZ/ASTRAZENECA,8274,7938,336
Paratinga,292370,BA,Nordeste,BUTANTAN/SINOVAC,6977,3561,3416
Paratinga,292370,BA,Nordeste,PFIZER/BIONTECH,80,80,0
Paraty,330380,RJ,Sudeste,BUTANTAN/SINOVAC,5183,3551,1632
Paraty,330380,RJ,Sudeste,FIOCRUZ/ASTRAZENECA,4933,4646,287
Paraú,240870,RN,Nordeste,BUTANTAN/SINOVAC,988,511,477
Paraú,240870,RN,Nordeste,FIOCRUZ/ASTRAZENECA,786,741,45
Paraú,240870,RN,Nordeste,PFIZER/BIONTECH,36,36,0
Parauapebas,150553,PA,Norte,FIOCRUZ/ASTRAZENECA,26269,24565,1704
Parauapebas,150553,PA,Norte,BUTANTAN/SINOVAC,10243,7089,3154
Paraúna,521640,GO,Centro-Oeste,FIOCRUZ/ASTRAZENECA,3192,2980,212
Paraúna,521640,GO,Centro-Oeste,BUTANTAN/SINOVAC,1825,1065,760
Paraúna,521640,GO,Centro-Oeste,PFIZER/BIONTECH,92,92,0
Parazinho,240880,RN,Nordeste,BUTANTAN/SINOVAC,1134,586,548
Parazinho,240880,RN,Nordeste,FIOCRUZ/ASTRAZENECA,946,887,59
Parazinho,240880,RN,Nordeste,PFIZER/BIONTECH,187,187,0
Pardinho,353610,SP,Sudeste,BUTANTAN/SINOVAC,1521,893,628
Pardinho,353610,SP,Sudeste,FIOCRUZ/ASTRAZENECA,1456,1318,138
Pardinho,353610,SP,Sudeste,PFIZER/BIONTECH,48,48,0
Pareci Novo,431403,RS,Sul,BUTANTAN/SINOVAC,1102,554,548
Pareci Novo,431403,RS,Sul,FIOCRUZ/ASTRAZENECA,867,808,59
Pareci Novo,431403,RS,Sul,PFIZER/BIONTECH,150,150,0
Parecis,110145,RO,Norte,BUTANTAN/SINOVAC,990,508,482
Parecis,110145,RO,Norte,FIOCRUZ/ASTRAZENECA,944,905,39
Parecis,110145,RO,Norte,PFIZER/BIONTECH,97,97,0
Parelhas,240890,RN,Nordeste,FIOCRUZ/ASTRAZENECA,4491,4002,489
Parelhas,240890,RN,Nordeste,BUTANTAN/SINOVAC,4263,2229,2034
Parelhas,240890,RN,Nordeste,PFIZER/BIONTECH,475,472,3
Pariconha,270642,AL,Nordeste,BUTANTAN/SINOVAC,5904,3079,2825
Pariconha,270642,AL,Nordeste,FIOCRUZ/ASTRAZENECA,1614,1397,217
Parintins,130340,AM,Norte,FIOCRUZ/ASTRAZENECA,18627,15591,3036
Parintins,130340,AM,Norte,BUTANTAN/SINOVAC,11103,6670,4433
Parintins,130340,AM,Norte,PFIZER/BIONTECH,13,10,3
Paripiranga,292380,BA,Nordeste,FIOCRUZ/ASTRAZENECA,6432,6413,19
Paripiranga,292380,BA,Nordeste,BUTANTAN/SINOVAC,4268,2668,1600
Paripiranga,292380,BA,Nordeste,PFIZER/BIONTECH,33,32,1
Paripueira,270644,AL,Nordeste,BUTANTAN/SINOVAC,2230,1303,927
Paripueira,270644,AL,Nordeste,FIOCRUZ/ASTRAZENECA,1884,1656,228
Pariquera-Açu,353620,SP,Sudeste,BUTANTAN/SINOVAC,6478,3574,2904
Pariquera-Açu,353620,SP,Sudeste,FIOCRUZ/ASTRAZENECA,5500,5100,400
Pariquera-Açu,353620,SP,Sudeste,PFIZER/BIONTECH,540,539,1
Parisi,353625,SP,Sudeste,BUTANTAN/SINOVAC,902,509,393
Parisi,353625,SP,Sudeste,FIOCRUZ/ASTRAZENECA,615,546,69
Parisi,353625,SP,Sudeste,PFIZER/BIONTECH,84,84,0
Parnaguá,220760,PI,Nordeste,FIOCRUZ/ASTRAZENECA,1899,1777,122
Parnaguá,220760,PI,Nordeste,BUTANTAN/SINOVAC,1395,731,664
Parnaíba,220770,PI,Nordeste,BUTANTAN/SINOVAC,24266,12539,11727
Parnaíba,220770,PI,Nordeste,FIOCRUZ/ASTRAZENECA,23788,21805,1983
Parnaíba,220770,PI,Nordeste,PFIZER/BIONTECH,4313,4311,2
Parnamirim,240325,RN,Nordeste,BUTANTAN/SINOVAC,48345,25449,22896
Parnamirim,240325,RN,Nordeste,FIOCRUZ/ASTRAZENECA,48318,44149,4169
Parnamirim,240325,RN,Nordeste,PFIZER/BIONTECH,9868,9860,8
Parnamirim,261040,PE,Nordeste,FIOCRUZ/ASTRAZENECA,4355,3584,771
Parnamirim,261040,PE,Nordeste,BUTANTAN/SINOVAC,4080,2113,1967
Parnamirim,261040,PE,Nordeste,PFIZER/BIONTECH,123,123,0
Parnarama,210780,MA,Nordeste,FIOCRUZ/ASTRAZENECA,7138,6397,741
Parnarama,210780,MA,Nordeste,BUTANTAN/SINOVAC,5056,2655,2401
Parobé,431405,RS,Sul,FIOCRUZ/ASTRAZENECA,13855,13170,685
Parobé,431405,RS,Sul,BUTANTAN/SINOVAC,10226,5237,4989
Parobé,431405,RS,Sul,PFIZER/BIONTECH,1466,1466,0
Passa E Fica,240910,RN,Nordeste,BUTANTAN/SINOVAC,2681,1397,1284
Passa E Fica,240910,RN,Nordeste,FIOCRUZ/ASTRAZENECA,2293,2067,226
Passa E Fica,240910,RN,Nordeste,PFIZER/BIONTECH,347,347,0
Passa Quatro,314760,MG,Sudeste,BUTANTAN/SINOVAC,2903,1513,1390
Passa Quatro,314760,MG,Sudeste,FIOCRUZ/ASTRAZENECA,2689,2592,97
Passa Quatro,314760,MG,Sudeste,PFIZER/BIONTECH,14,14,0
Passa Sete,431406,RS,Sul,BUTANTAN/SINOVAC,1274,636,638
Passa Sete,431406,RS,Sul,FIOCRUZ/ASTRAZENECA,1200,1074,126
Passa Sete,431406,RS,Sul,PFIZER/BIONTECH,213,213,0
Passa Tempo,314770,MG,Sudeste,BUTANTAN/SINOVAC,2140,1160,980
Passa Tempo,314770,MG,Sudeste,FIOCRUZ/ASTRAZENECA,1625,1499,126
Passa Tempo,314770,MG,Sudeste,PFIZER/BIONTECH,25,25,0
Passa-Vinte,314780,MG,Sudeste,FIOCRUZ/ASTRAZENECA,814,741,73
Passa-Vinte,314780,MG,Sudeste,BUTANTAN/SINOVAC,649,335,314
Passa-Vinte,314780,MG,Sudeste,PFIZER/BIONTECH,27,27,0
Passabém,314750,MG,Sudeste,BUTANTAN/SINOVAC,654,333,321
Passabém,314750,MG,Sudeste,FIOCRUZ/ASTRAZENECA,629,509,120
Passabém,314750,MG,Sudeste,PFIZER/BIONTECH,46,46,0
Passagem,240920,RN,Nordeste,BUTANTAN/SINOVAC,827,422,405
Passagem,240920,RN,Nordeste,FIOCRUZ/ASTRAZENECA,488,459,29
Passagem,240920,RN,Nordeste,PFIZER/BIONTECH,67,67,0
Passagem,251070,PB,Nordeste,BUTANTAN/SINOVAC,624,327,297
Passagem,251070,PB,Nordeste,FIOCRUZ/ASTRAZENECA,396,345,51
Passagem,251070,PB,Nordeste,PFIZER/BIONTECH,12,12,0
Passagem Franca,210790,MA,Nordeste,FIOCRUZ/ASTRAZENECA,4985,4711,274
Passagem Franca,210790,MA,Nordeste,BUTANTAN/SINOVAC,2965,1543,1422
Passagem Franca Do Piauí,220775,PI,Nordeste,BUTANTAN/SINOVAC,969,519,450
Passagem Franca Do Piauí,220775,PI,Nordeste,FIOCRUZ/ASTRAZENECA,460,410,50
Passagem Franca Do Piauí,220775,PI,Nordeste,PFIZER/BIONTECH,94,94,0
Passira,261050,PE,Nordeste,FIOCRUZ/ASTRAZENECA,7776,7258,518
Passira,261050,PE,Nordeste,BUTANTAN/SINOVAC,5524,2816,2708
Passira,261050,PE,Nordeste,PFIZER/BIONTECH,196,195,1
Passo De Camaragibe,270650,AL,Nordeste,FIOCRUZ/ASTRAZENECA,2660,2496,164
Passo De Camaragibe,270650,AL,Nordeste,BUTANTAN/SINOVAC,1922,1047,875
Passo De Torres,421225,SC,Sul,FIOCRUZ/ASTRAZENECA,1938,1832,106
Passo De Torres,421225,SC,Sul,BUTANTAN/SINOVAC,1739,921,818
Passo De Torres,421225,SC,Sul,PFIZER/BIONTECH,250,250,0
Passo Do Sobrado,431407,RS,Sul,BUTANTAN/SINOVAC,1713,870,843
Passo Do Sobrado,431407,RS,Sul,FIOCRUZ/ASTRAZENECA,1596,1454,142
Passo Do Sobrado,431407,RS,Sul,PFIZER/BIONTECH,136,136,0
Passo Fundo,431410,RS,Sul,FIOCRUZ/ASTRAZENECA,62039,53931,8108
Passo Fundo,431410,RS,Sul,BUTANTAN/SINOVAC,51198,25900,25298
Passo Fundo,431410,RS,Sul,PFIZER/BIONTECH,6900,6888,12
Passos,314790,MG,Sudeste,BUTANTAN/SINOVAC,24159,12853,11306
Passos,314790,MG,Sudeste,FIOCRUZ/ASTRAZENECA,19147,18162,985
Passos,314790,MG,Sudeste,PFIZER/BIONTECH,1342,1338,4
Passos Maia,421227,SC,Sul,FIOCRUZ/ASTRAZENECA,1229,1149,80
Passos Maia,421227,SC,Sul,BUTANTAN/SINOVAC,813,463,350
Passos Maia,421227,SC,Sul,PFIZER/BIONTECH,63,58,5
Pastos Bons,210800,MA,Nordeste,FIOCRUZ/ASTRAZENECA,3643,3428,215
Pastos Bons,210800,MA,Nordeste,BUTANTAN/SINOVAC,2929,1561,1368
Patis,314795,MG,Sudeste,BUTANTAN/SINOVAC,949,502,447
Patis,314795,MG,Sudeste,FIOCRUZ/ASTRAZENECA,282,239,43
Pato Bragado,411845,PR,Sul,FIOCRUZ/ASTRAZENECA,1231,1133,98
Pato Bragado,411845,PR,Sul,BUTANTAN/SINOVAC,1132,587,545
Pato Bragado,411845,PR,Sul,PFIZER/BIONTECH,28,28,0
Pato Branco,411850,PR,Sul,BUTANTAN/SINOVAC,18594,9680,8914
Pato Branco,411850,PR,Sul,FIOCRUZ/ASTRAZENECA,17997,16581,1416
Pato Branco,411850,PR,Sul,PFIZER/BIONTECH,4576,4572,4
Patos,251080,PB,Nordeste,BUTANTAN/SINOVAC,27332,14081,13251
Patos,251080,PB,Nordeste,FIOCRUZ/ASTRAZENECA,15615,14022,1593
Patos,251080,PB,Nordeste,PFIZER/BIONTECH,1646,1645,1
Patos De Minas,314800,MG,Sudeste,BUTANTAN/SINOVAC,36259,19241,17018
Patos De Minas,314800,MG,Sudeste,FIOCRUZ/ASTRAZENECA,35900,32235,3665
Patos De Minas,314800,MG,Sudeste,PFIZER/BIONTECH,4289,4279,10
Patos Do Piauí,220777,PI,Nordeste,FIOCRUZ/ASTRAZENECA,1399,1297,102
Patos Do Piauí,220777,PI,Nordeste,BUTANTAN/SINOVAC,1222,620,602
Patos Do Piauí,220777,PI,Nordeste,PFIZER/BIONTECH,162,162,0
Patrocínio,314810,MG,Sudeste,FIOCRUZ/ASTRAZENECA,17869,16494,1375
Patrocínio,314810,MG,Sudeste,BUTANTAN/SINOVAC,17012,8673,8339
Patrocínio,314810,MG,Sudeste,PFIZER/BIONTECH,1175,1170,5
Patrocínio Do Muriaé,314820,MG,Sudeste,BUTANTAN/SINOVAC,1559,835,724
Patrocínio Do Muriaé,314820,MG,Sudeste,FIOCRUZ/ASTRAZENECA,1348,1275,73
Patrocínio Do Muriaé,314820,MG,Sudeste,PFIZER/BIONTECH,86,86,0
Patrocínio Paulista,353630,SP,Sudeste,BUTANTAN/SINOVAC,3356,1955,1401
Patrocínio Paulista,353630,SP,Sudeste,FIOCRUZ/ASTRAZENECA,3271,2985,286
Patrocínio Paulista,353630,SP,Sudeste,PFIZER/BIONTECH,331,331,0
Patu,240930,RN,Nordeste,BUTANTAN/SINOVAC,2422,1294,1128
Patu,240930,RN,Nordeste,FIOCRUZ/ASTRAZENECA,2377,2157,220
Patu,240930,RN,Nordeste,PFIZER/BIONTECH,366,365,1
Paty Do Alferes,330385,RJ,Sudeste,FIOCRUZ/ASTRAZENECA,5314,4960,354
Paty Do Alferes,330385,RJ,Sudeste,BUTANTAN/SINOVAC,5238,2926,2312
Paty Do Alferes,330385,RJ,Sudeste,PFIZER/BIONTECH,319,319,0
Pau Brasil,292390,BA,Nordeste,BUTANTAN/SINOVAC,3256,2005,1251
Pau Brasil,292390,BA,Nordeste,FIOCRUZ/ASTRAZENECA,1700,1538,162
Pau Brasil,292390,BA,Nordeste,PFIZER/BIONTECH,21,21,0
Pau D'Arco,150555,PA,Norte,FIOCRUZ/ASTRAZENECA,1139,1010,129
Pau D'Arco,150555,PA,Norte,BUTANTAN/SINOVAC,909,488,421
Pau D'Arco,171630,TO,Norte,BUTANTAN/SINOVAC,943,490,453
Pau D'Arco,171630,TO,Norte,FIOCRUZ/ASTRAZENECA,668,638,30
Pau D'Arco Do Piauí,220779,PI,Nordeste,BUTANTAN/SINOVAC,731,374,357
Pau D'Arco Do Piauí,220779,PI,Nordeste,FIOCRUZ/ASTRAZENECA,606,560,46
Pau Dos Ferros,240940,RN,Nordeste,BUTANTAN/SINOVAC,5422,2739,2683
Pau Dos Ferros,240940,RN,Nordeste,FIOCRUZ/ASTRAZENECA,5320,4620,700
Pau Dos Ferros,240940,RN,Nordeste,PFIZER/BIONTECH,826,826,0
Paudalho,261060,PE,Nordeste,FIOCRUZ/ASTRAZENECA,11187,10558,629
Paudalho,261060,PE,Nordeste,BUTANTAN/SINOVAC,8421,4374,4047
Paudalho,261060,PE,Nordeste,PFIZER/BIONTECH,831,831,0
Pauini,130350,AM,Norte,BUTANTAN/SINOVAC,2761,1638,1123
Pauini,130350,AM,Norte,FIOCRUZ/ASTRAZENECA,938,737,201
Paula Cândido,314830,MG,Sudeste,FIOCRUZ/ASTRAZENECA,2387,2194,193
Paula Cândido,314830,MG,Sudeste,BUTANTAN/SINOVAC,2131,1100,1031
Paula Cândido,314830,MG,Sudeste,PFIZER/BIONTECH,107,107,0
Paula Freitas,411860,PR,Sul,FIOCRUZ/ASTRAZENECA,1583,1487,96
Paula Freitas,411860,PR,Sul,BUTANTAN/SINOVAC,1149,597,552
Paula Freitas,411860,PR,Sul,PFIZER/BIONTECH,29,29,0
Paulicéia,353640,SP,Sudeste,FIOCRUZ/ASTRAZENECA,1695,1584,111
Paulicéia,353640,SP,Sudeste,BUTANTAN/SINOVAC,1453,793,660
Paulicéia,353640,SP,Sudeste,PFIZER/BIONTECH,161,161,0
Paulínia,353650,SP,Sudeste,FIOCRUZ/ASTRAZENECA,21321,20277,1044
Paulínia,353650,SP,Sudeste,BUTANTAN/SINOVAC,19957,11494,8463
Paulínia,353650,SP,Sudeste,PFIZER/BIONTECH,2077,2076,1
Paulino Neves,210805,MA,Nordeste,FIOCRUZ/ASTRAZENECA,3022,2848,174
Paulino Neves,210805,MA,Nordeste,BUTANTAN/SINOVAC,2205,1184,1021
Paulista,251090,PB,Nordeste,BUTANTAN/SINOVAC,2741,1381,1360
Paulista,251090,PB,Nordeste,FIOCRUZ/ASTRAZENECA,2386,2181,205
Paulista,251090,PB,Nordeste,PFIZER/BIONTECH,41,41,0
Paulista,261070,PE,Nordeste,BUTANTAN/SINOVAC,52568,28089,24479
Paulista,261070,PE,Nordeste,FIOCRUZ/ASTRAZENECA,29420,25235,4185
Paulista,261070,PE,Nordeste,PFIZER/BIONTECH,451,446,5
Paulistana,220780,PI,Nordeste,FIOCRUZ/ASTRAZENECA,4804,3516,1288
Paulistana,220780,PI,Nordeste,BUTANTAN/SINOVAC,2961,1498,1463
Paulistana,220780,PI,Nordeste,PFIZER/BIONTECH,184,184,0
Paulistânia,353657,SP,Sudeste,BUTANTAN/SINOVAC,575,324,251
Paulistânia,353657,SP,Sudeste,FIOCRUZ/ASTRAZENECA,441,405,36
Paulistânia,353657,SP,Sudeste,PFIZER/BIONTECH,54,54,0
Paulistas,314840,MG,Sudeste,BUTANTAN/SINOVAC,1241,649,592
Paulistas,314840,MG,Sudeste,FIOCRUZ/ASTRAZENECA,1226,1108,118
Paulistas,314840,MG,Sudeste,PFIZER/BIONTECH,39,39,0
Paulo Afonso,292400,BA,Nordeste,FIOCRUZ/ASTRAZENECA,26334,23030,3304
Paulo Afonso,292400,BA,Nordeste,BUTANTAN/SINOVAC,18748,9768,8980
Paulo Afonso,292400,BA,Nordeste,PFIZER/BIONTECH,1473,1473,0
Paulo Bento,431413,RS,Sul,BUTANTAN/SINOVAC,806,403,403
Paulo Bento,431413,RS,Sul,FIOCRUZ/ASTRAZENECA,729,638,91
Paulo Bento,431413,RS,Sul,PFIZER/BIONTECH,42,42,0
Paulo De Faria,353660,SP,Sudeste,BUTANTAN/SINOVAC,2969,1739,1230
Paulo De Faria,353660,SP,Sudeste,FIOCRUZ/ASTRAZENECA,2046,1862,184
Paulo De Faria,353660,SP,Sudeste,PFIZER/BIONTECH,70,70,0
Paulo Frontin,411870,PR,Sul,FIOCRUZ/ASTRAZENECA,1807,1691,116
Paulo Frontin,411870,PR,Sul,BUTANTAN/SINOVAC,1468,749,719
Paulo Frontin,411870,PR,Sul,PFIZER/BIONTECH,42,42,0
Paulo Jacinto,270660,AL,Nordeste,FIOCRUZ/ASTRAZENECA,1564,1336,228
Paulo Jacinto,270660,AL,Nordeste,BUTANTAN/SINOVAC,1530,768,762
Paulo Lopes,421230,SC,Sul,FIOCRUZ/ASTRAZENECA,1793,1674,119
Paulo Lopes,421230,SC,Sul,BUTANTAN/SINOVAC,1500,852,648
Paulo Lopes,421230,SC,Sul,PFIZER/BIONTECH,116,116,0
Paulo Ramos,210810,MA,Nordeste,FIOCRUZ/ASTRAZENECA,4194,3964,230
Paulo Ramos,210810,MA,Nordeste,BUTANTAN/SINOVAC,2838,1637,1201
Pavão,314850,MG,Sudeste,BUTANTAN/SINOVAC,1270,906,364
Pavão,314850,MG,Sudeste,FIOCRUZ/ASTRAZENECA,429,387,42
Paverama,431415,RS,Sul,BUTANTAN/SINOVAC,2500,1254,1246
Paverama,431415,RS,Sul,FIOCRUZ/ASTRAZENECA,1953,1730,223
Paverama,431415,RS,Sul,PFIZER/BIONTECH,270,270,0
Pavussu,220785,PI,Nordeste,BUTANTAN/SINOVAC,847,432,415
Pavussu,220785,PI,Nordeste,FIOCRUZ/ASTRAZENECA,617,555,62
Pavussu,220785,PI,Nordeste,PFIZER/BIONTECH,78,78,0
Pé De Serra,292405,BA,Nordeste,BUTANTAN/SINOVAC,2940,1552,1388
Pé De Serra,292405,BA,Nordeste,FIOCRUZ/ASTRAZENECA,2332,2058,274
Pé De Serra,292405,BA,Nordeste,PFIZER/BIONTECH,42,42,0
Peabiru,411880,PR,Sul,FIOCRUZ/ASTRAZENECA,3834,3686,148
Peabiru,411880,PR,Sul,BUTANTAN/SINOVAC,2679,1362,1317
Peçanha,314860,MG,Sudeste,FIOCRUZ/ASTRAZENECA,3461,3063,398
Peçanha,314860,MG,Sudeste,BUTANTAN/SINOVAC,3239,1643,1596
Peçanha,314860,MG,Sudeste,PFIZER/BIONTECH,309,309,0
Pederneiras,353670,SP,Sudeste,FIOCRUZ/ASTRAZENECA,9332,8600,732
Pederneiras,353670,SP,Sudeste,BUTANTAN/SINOVAC,8166,4201,3965
Pederneiras,353670,SP,Sudeste,PFIZER/BIONTECH,873,871,2
Pedra,261080,PE,Nordeste,FIOCRUZ/ASTRAZENECA,3330,3045,285
Pedra,261080,PE,Nordeste,BUTANTAN/SINOVAC,3156,1706,1450
Pedra,261080,PE,Nordeste,PFIZER/BIONTECH,218,218,0
Pedra Azul,314870,MG,Sudeste,BUTANTAN/SINOVAC,5239,2659,2580
Pedra Azul,314870,MG,Sudeste,FIOCRUZ/ASTRAZENECA,4357,3943,414
Pedra Azul,314870,MG,Sudeste,PFIZER/BIONTECH,118,117,1
Pedra Bela,353680,SP,Sudeste,BUTANTAN/SINOVAC,1574,844,730
Pedra Bela,353680,SP,Sudeste,FIOCRUZ/ASTRAZENECA,1507,1388,119
Pedra Bela,353680,SP,Sudeste,PFIZER/BIONTECH,158,158,0
Pedra Bonita,314875,MG,Sudeste,FIOCRUZ/ASTRAZENECA,1310,1214,96
Pedra Bonita,314875,MG,Sudeste,BUTANTAN/SINOVAC,1016,507,509
Pedra Bonita,314875,MG,Sudeste,PFIZER/BIONTECH,182,182,0
Pedra Branca,231050,CE,Nordeste,BUTANTAN/SINOVAC,7134,3926,3208
Pedra Branca,231050,CE,Nordeste,FIOCRUZ/ASTRAZENECA,4059,3620,439
Pedra Branca,231050,CE,Nordeste,PFIZER/BIONTECH,82,82,0
Pedra Branca,251100,PB,Nordeste,BUTANTAN/SINOVAC,931,506,425
Pedra Branca,251100,PB,Nordeste,FIOCRUZ/ASTRAZENECA,710,649,61
Pedra Branca,251100,PB,Nordeste,PFIZER/BIONTECH,61,61,0
Pedra Branca Do Amapari,160015,AP,Norte,BUTANTAN/SINOVAC,2574,1387,1187
Pedra Branca Do Amapari,160015,AP,Norte,FIOCRUZ/ASTRAZENECA,1675,1507,168
Pedra Branca Do Amapari,160015,AP,Norte,PFIZER/BIONTECH,338,325,13
Pedra Do Anta,314880,MG,Sudeste,BUTANTAN/SINOVAC,1119,585,534
Pedra Do Anta,314880,MG,Sudeste,FIOCRUZ/ASTRAZENECA,957,853,104
Pedra Do Anta,314880,MG,Sudeste,PFIZER/BIONTECH,41,41,0
Pedra Do Indaiá,314890,MG,Sudeste,BUTANTAN/SINOVAC,1007,552,455
Pedra Do Indaiá,314890,MG,Sudeste,FIOCRUZ/ASTRAZENECA,512,474,38
Pedra Do Indaiá,314890,MG,Sudeste,PFIZER/BIONTECH,17,17,0
Pedra Dourada,314900,MG,Sudeste,FIOCRUZ/ASTRAZENECA,547,490,57
Pedra Dourada,314900,MG,Sudeste,BUTANTAN/SINOVAC,467,239,228
Pedra Dourada,314900,MG,Sudeste,PFIZER/BIONTECH,17,17,0
Pedra Grande,240950,RN,Nordeste,BUTANTAN/SINOVAC,925,411,514
Pedra Grande,240950,RN,Nordeste,FIOCRUZ/ASTRAZENECA,699,683,16
Pedra Grande,240950,RN,Nordeste,PFIZER/BIONTECH,95,95,0
Pedra Lavrada,251110,PB,Nordeste,BUTANTAN/SINOVAC,1960,997,963
Pedra Lavrada,251110,PB,Nordeste,FIOCRUZ/ASTRAZENECA,1457,1316,141
Pedra Lavrada,251110,PB,Nordeste,PFIZER/BIONTECH,75,75,0
Pedra Mole,280500,SE,Nordeste,BUTANTAN/SINOVAC,745,390,355
Pedra Mole,280500,SE,Nordeste,FIOCRUZ/ASTRAZENECA,506,505,1
Pedra Mole,280500,SE,Nordeste,PFIZER/BIONTECH,82,82,0
Pedra Preta,240960,RN,Nordeste,BUTANTAN/SINOVAC,663,349,314
Pedra Preta,240960,RN,Nordeste,FIOCRUZ/ASTRAZENECA,654,626,28
Pedra Preta,240960,RN,Nordeste,PFIZER/BIONTECH,149,149,0
Pedra Preta,510637,MT,Centro-Oeste,BUTANTAN/SINOVAC,2602,1579,1023
Pedra Preta,510637,MT,Centro-Oeste,FIOCRUZ/ASTRAZENECA,1960,1898,62
Pedralva,314910,MG,Sudeste,BUTANTAN/SINOVAC,2643,1395,1248
Pedralva,314910,MG,Sudeste,FIOCRUZ/ASTRAZENECA,1991,1832,159
Pedralva,314910,MG,Sudeste,PFIZER/BIONTECH,5,5,0
Pedranópolis,353690,SP,Sudeste,FIOCRUZ/ASTRAZENECA,862,764,98
Pedranópolis,353690,SP,Sudeste,BUTANTAN/SINOVAC,823,437,386
Pedranópolis,353690,SP,Sudeste,PFIZER/BIONTECH,61,61,0
Pedrão,292410,BA,Nordeste,FIOCRUZ/ASTRAZENECA,1516,1475,41
Pedrão,292410,BA,Nordeste,BUTANTAN/SINOVAC,1294,799,495
Pedrão,292410,BA,Nordeste,PFIZER/BIONTECH,78,78,0
Pedras Altas,431417,RS,Sul,FIOCRUZ/ASTRAZENECA,951,932,19
Pedras Altas,431417,RS,Sul,BUTANTAN/SINOVAC,417,213,204
Pedras Altas,431417,RS,Sul,PFIZER/BIONTECH,67,67,0
Pedras De Fogo,251120,PB,Nordeste,BUTANTAN/SINOVAC,4926,2598,2328
Pedras De Fogo,251120,PB,Nordeste,FIOCRUZ/ASTRAZENECA,4433,4086,347
Pedras De Fogo,251120,PB,Nordeste,PFIZER/BIONTECH,211,211,0
Pedras De Maria Da Cruz,314915,MG,Sudeste,BUTANTAN/SINOVAC,1698,855,843
Pedras De Maria Da Cruz,314915,MG,Sudeste,FIOCRUZ/ASTRAZENECA,1600,1478,122
Pedras De Maria Da Cruz,314915,MG,Sudeste,PFIZER/BIONTECH,1,1,0
Pedras Grandes,421240,SC,Sul,FIOCRUZ/ASTRAZENECA,1380,1288,92
Pedras Grandes,421240,SC,Sul,BUTANTAN/SINOVAC,1140,587,553
Pedras Grandes,421240,SC,Sul,PFIZER/BIONTECH,141,141,0
Pedregulho,353700,SP,Sudeste,BUTANTAN/SINOVAC,3971,2132,1839
Pedregulho,353700,SP,Sudeste,FIOCRUZ/ASTRAZENECA,3704,3412,292
Pedregulho,353700,SP,Sudeste,PFIZER/BIONTECH,481,481,0
Pedreira,353710,SP,Sudeste,BUTANTAN/SINOVAC,11251,6217,5034
Pedreira,353710,SP,Sudeste,FIOCRUZ/ASTRAZENECA,8375,7593,782
Pedreira,353710,SP,Sudeste,PFIZER/BIONTECH,806,804,2
Pedreiras,210820,MA,Nordeste,FIOCRUZ/ASTRAZENECA,9759,8846,913
Pedreiras,210820,MA,Nordeste,BUTANTAN/SINOVAC,6360,3405,2955
Pedreiras,210820,MA,Nordeste,PFIZER/BIONTECH,894,894,0
Pedrinhas,280510,SE,Nordeste,BUTANTAN/SINOVAC,1518,808,710
Pedrinhas,280510,SE,Nordeste,FIOCRUZ/ASTRAZENECA,1502,1413,89
Pedrinhas,280510,SE,Nordeste,PFIZER/BIONTECH,94,94,0
Pedrinhas Paulista,353715,SP,Sudeste,FIOCRUZ/ASTRAZENECA,856,778,78
Pedrinhas Paulista,353715,SP,Sudeste,BUTANTAN/SINOVAC,843,448,395
Pedrinhas Paulista,353715,SP,Sudeste,PFIZER/BIONTECH,137,137,0
Pedrinópolis,314920,MG,Sudeste,BUTANTAN/SINOVAC,1018,524,494
Pedrinópolis,314920,MG,Sudeste,FIOCRUZ/ASTRAZENECA,1001,906,95
Pedrinópolis,314920,MG,Sudeste,PFIZER/BIONTECH,23,23,0
Pedro Afonso,171650,TO,Norte,FIOCRUZ/ASTRAZENECA,2433,2306,127
Pedro Afonso,171650,TO,Norte,BUTANTAN/SINOVAC,1936,1003,933
Pedro Alexandre,292420,BA,Nordeste,BUTANTAN/SINOVAC,1983,1055,928
Pedro Alexandre,292420,BA,Nordeste,FIOCRUZ/ASTRAZENECA,1588,1482,106
Pedro Alexandre,292420,BA,Nordeste,PFIZER/BIONTECH,23,23,0
Pedro Avelino,240970,RN,Nordeste,FIOCRUZ/ASTRAZENECA,8385,7761,624
Pedro Avelino,240970,RN,Nordeste,BUTANTAN/SINOVAC,7201,3651,3550
Pedro Avelino,240970,RN,Nordeste,PFIZER/BIONTECH,884,883,1
Pedro Canário,320405,ES,Sudeste,BUTANTAN/SINOVAC,5038,2784,2254
Pedro Canário,320405,ES,Sudeste,FIOCRUZ/ASTRAZENECA,4091,3935,156
Pedro Canário,320405,ES,Sudeste,PFIZER/BIONTECH,727,724,3
Pedro De Toledo,353720,SP,Sudeste,BUTANTAN/SINOVAC,4198,2268,1930
Pedro De Toledo,353720,SP,Sudeste,FIOCRUZ/ASTRAZENECA,3495,3292,203
Pedro De Toledo,353720,SP,Sudeste,PFIZER/BIONTECH,290,290,0
Pedro Do Rosário,210825,MA,Nordeste,FIOCRUZ/ASTRAZENECA,7042,6033,1009
Pedro Do Rosário,210825,MA,Nordeste,BUTANTAN/SINOVAC,2496,1287,1209
Pedro Gomes,500640,MS,Centro-Oeste,FIOCRUZ/ASTRAZENECA,2648,2297,351
Pedro Gomes,500640,MS,Centro-Oeste,BUTANTAN/SINOVAC,2148,1083,1065
Pedro Gomes,500640,MS,Centro-Oeste,PFIZER/BIONTECH,225,225,0
Pedro Ii,220790,PI,Nordeste,BUTANTAN/SINOVAC,7247,4449,2798
Pedro Ii,220790,PI,Nordeste,FIOCRUZ/ASTRAZENECA,5985,5560,425
Pedro Ii,220790,PI,Nordeste,PFIZER/BIONTECH,239,239,0
Pedro Laurentino,220793,PI,Nordeste,FIOCRUZ/ASTRAZENECA,693,654,39
Pedro Laurentino,220793,PI,Nordeste,BUTANTAN/SINOVAC,519,283,236
Pedro Leopoldo,314930,MG,Sudeste,FIOCRUZ/ASTRAZENECA,10561,9770,791
Pedro Leopoldo,314930,MG,Sudeste,BUTANTAN/SINOVAC,10478,5799,4679
Pedro Leopoldo,314930,MG,Sudeste,PFIZER/BIONTECH,1072,1072,0
Pedro Osório,431420,RS,Sul,BUTANTAN/SINOVAC,2596,1303,1293
Pedro Osório,431420,RS,Sul,FIOCRUZ/ASTRAZENECA,1958,1791,167
Pedro Osório,431420,RS,Sul,PFIZER/BIONTECH,118,118,0
Pedro Régis,251272,PB,Nordeste,BUTANTAN/SINOVAC,1423,728,695
Pedro Régis,251272,PB,Nordeste,FIOCRUZ/ASTRAZENECA,1023,936,87
Pedro Régis,251272,PB,Nordeste,PFIZER/BIONTECH,93,93,0
Pedro Teixeira,314940,MG,Sudeste,FIOCRUZ/ASTRAZENECA,544,478,66
Pedro Teixeira,314940,MG,Sudeste,BUTANTAN/SINOVAC,469,244,225
Pedro Teixeira,314940,MG,Sudeste,PFIZER/BIONTECH,36,36,0
Pedro Velho,240980,RN,Nordeste,BUTANTAN/SINOVAC,2910,1517,1393
Pedro Velho,240980,RN,Nordeste,FIOCRUZ/ASTRAZENECA,2669,2435,234
Pedro Velho,240980,RN,Nordeste,PFIZER/BIONTECH,227,227,0
Peixe,171660,TO,Norte,BUTANTAN/SINOVAC,2472,1367,1105
Peixe,171660,TO,Norte,FIOCRUZ/ASTRAZENECA,1683,1624,59
Peixe-Boi,150560,PA,Norte,BUTANTAN/SINOVAC,1188,670,518
Peixe-Boi,150560,PA,Norte,FIOCRUZ/ASTRAZENECA,1165,923,242
Peixoto De Azevedo,510642,MT,Centro-Oeste,FIOCRUZ/ASTRAZENECA,5628,5130,498
Peixoto De Azevedo,510642,MT,Centro-Oeste,BUTANTAN/SINOVAC,5155,2718,2437
Peixoto De Azevedo,510642,MT,Centro-Oeste,PFIZER/BIONTECH,445,445,0
Pejuçara,431430,RS,Sul,BUTANTAN/SINOVAC,1201,618,583
Pejuçara,431430,RS,Sul,FIOCRUZ/ASTRAZENECA,1025,916,109
Pejuçara,431430,RS,Sul,PFIZER/BIONTECH,158,158,0
Pelotas,431440,RS,Sul,BUTANTAN/SINOVAC,113971,60397,53574
Pelotas,431440,RS,Sul,FIOCRUZ/ASTRAZENECA,71236,65772,5464
Pelotas,431440,RS,Sul,PFIZER/BIONTECH,7458,7333,125
Penaforte,231060,CE,Nordeste,BUTANTAN/SINOVAC,1577,878,699
Penaforte,231060,CE,Nordeste,FIOCRUZ/ASTRAZENECA,1036,919,117
Penaforte,231060,CE,Nordeste,PFIZER/BIONTECH,42,42,0
Penalva,210830,MA,Nordeste,FIOCRUZ/ASTRAZENECA,5980,5673,307
Penalva,210830,MA,Nordeste,BUTANTAN/SINOVAC,4269,2181,2088
Penápolis,353730,SP,Sudeste,BUTANTAN/SINOVAC,16568,9162,7406
Penápolis,353730,SP,Sudeste,FIOCRUZ/ASTRAZENECA,16246,14701,1545
Penápolis,353730,SP,Sudeste,PFIZER/BIONTECH,1799,1791,8
Pendências,240990,RN,Nordeste,BUTANTAN/SINOVAC,2626,1260,1366
Pendências,240990,RN,Nordeste,FIOCRUZ/ASTRAZENECA,2476,2246,230
Pendências,240990,RN,Nordeste,PFIZER/BIONTECH,382,382,0
Penedo,270670,AL,Nordeste,FIOCRUZ/ASTRAZENECA,14833,13707,1126
Penedo,270670,AL,Nordeste,BUTANTAN/SINOVAC,10946,5630,5316
Penedo,270670,AL,Nordeste,PFIZER/BIONTECH,1693,1693,0
Penha,421250,SC,Sul,FIOCRUZ/ASTRAZENECA,6710,6559,151
Penha,421250,SC,Sul,BUTANTAN/SINOVAC,6606,3413,3193
Penha,421250,SC,Sul,PFIZER/BIONTECH,542,542,0
Pentecoste,231070,CE,Nordeste,BUTANTAN/SINOVAC,2474,2029,445
Pentecoste,231070,CE,Nordeste,FIOCRUZ/ASTRAZENECA,1186,1182,4
Pequeri,314950,MG,Sudeste,FIOCRUZ/ASTRAZENECA,978,903,75
Pequeri,314950,MG,Sudeste,BUTANTAN/SINOVAC,706,360,346
Pequeri,314950,MG,Sudeste,PFIZER/BIONTECH,22,21,1
Pequi,314960,MG,Sudeste,BUTANTAN/SINOVAC,1123,578,545
Pequi,314960,MG,Sudeste,FIOCRUZ/ASTRAZENECA,1079,977,102
Pequi,314960,MG,Sudeste,PFIZER/BIONTECH,101,101,0
Pequizeiro,171665,TO,Norte,FIOCRUZ/ASTRAZENECA,1150,1107,43
Pequizeiro,171665,TO,Norte,BUTANTAN/SINOVAC,981,492,489
Perdigão,314970,MG,Sudeste,BUTANTAN/SINOVAC,1235,759,476
Perdigão,314970,MG,Sudeste,FIOCRUZ/ASTRAZENECA,670,670,0
Perdizes,314980,MG,Sudeste,FIOCRUZ/ASTRAZENECA,1000,760,240
Perdizes,314980,MG,Sudeste,BUTANTAN/SINOVAC,975,497,478
Perdizes,314980,MG,Sudeste,PFIZER/BIONTECH,113,113,0
Perdões,314990,MG,Sudeste,FIOCRUZ/ASTRAZENECA,4420,4322,98
Perdões,314990,MG,Sudeste,BUTANTAN/SINOVAC,3151,2167,984
Perdões,314990,MG,Sudeste,PFIZER/BIONTECH,228,228,0
Pereira Barreto,353740,SP,Sudeste,FIOCRUZ/ASTRAZENECA,7299,6684,615
Pereira Barreto,353740,SP,Sudeste,BUTANTAN/SINOVAC,6761,3449,3312
Pereira Barreto,353740,SP,Sudeste,PFIZER/BIONTECH,238,238,0
Pereiras,353750,SP,Sudeste,FIOCRUZ/ASTRAZENECA,2041,1873,168
Pereiras,353750,SP,Sudeste,BUTANTAN/SINOVAC,1853,947,906
Pereiras,353750,SP,Sudeste,PFIZER/BIONTECH,54,54,0
Pereiro,231080,CE,Nordeste,BUTANTAN/SINOVAC,2861,1450,1411
Pereiro,231080,CE,Nordeste,FIOCRUZ/ASTRAZENECA,1302,1152,150
Peri Mirim,210840,MA,Nordeste,FIOCRUZ/ASTRAZENECA,2618,2514,104
Peri Mirim,210840,MA,Nordeste,BUTANTAN/SINOVAC,1807,948,859
Periquito,314995,MG,Sudeste,FIOCRUZ/ASTRAZENECA,1184,1093,91
Periquito,314995,MG,Sudeste,BUTANTAN/SINOVAC,1125,610,515
Periquito,314995,MG,Sudeste,PFIZER/BIONTECH,33,33,0
Peritiba,421260,SC,Sul,BUTANTAN/SINOVAC,1019,510,509
Peritiba,421260,SC,Sul,FIOCRUZ/ASTRAZENECA,451,357,94
Peritoró,210845,MA,Nordeste,FIOCRUZ/ASTRAZENECA,4662,4417,245
Peritoró,210845,MA,Nordeste,BUTANTAN/SINOVAC,3472,1795,1677
Perobal,411885,PR,Sul,FIOCRUZ/ASTRAZENECA,1443,1328,115
Perobal,411885,PR,Sul,BUTANTAN/SINOVAC,1281,686,595
Perobal,411885,PR,Sul,PFIZER/BIONTECH,29,29,0
Pérola,411890,PR,Sul,BUTANTAN/SINOVAC,2685,1452,1233
Pérola,411890,PR,Sul,FIOCRUZ/ASTRAZENECA,2391,2175,216
Pérola,411890,PR,Sul,PFIZER/BIONTECH,150,150,0
Pérola D'Oeste,411900,PR,Sul,FIOCRUZ/ASTRAZENECA,2036,1864,172
Pérola D'Oeste,411900,PR,Sul,BUTANTAN/SINOVAC,1662,845,817
Pérola D'Oeste,411900,PR,Sul,PFIZER/BIONTECH,37,37,0
Perolândia,521645,GO,Centro-Oeste,FIOCRUZ/ASTRAZENECA,851,790,61
Perolândia,521645,GO,Centro-Oeste,BUTANTAN/SINOVAC,717,383,334
Peruíbe,353760,SP,Sudeste,BUTANTAN/SINOVAC,15765,9014,6751
Peruíbe,353760,SP,Sudeste,FIOCRUZ/ASTRAZENECA,14507,13516,991
Peruíbe,353760,SP,Sudeste,PFIZER/BIONTECH,976,976,0
Pescador,315000,MG,Sudeste,BUTANTAN/SINOVAC,1432,733,699
Pescador,315000,MG,Sudeste,FIOCRUZ/ASTRAZENECA,765,698,67
Pescaria Brava,421265,SC,Sul,FIOCRUZ/ASTRAZENECA,2662,2501,161
Pescaria Brava,421265,SC,Sul,BUTANTAN/SINOVAC,2148,1103,1045
Pescaria Brava,421265,SC,Sul,PFIZER/BIONTECH,281,281,0
Pesqueira,261090,PE,Nordeste,BUTANTAN/SINOVAC,22394,11937,10457
Pesqueira,261090,PE,Nordeste,FIOCRUZ/ASTRAZENECA,6187,5455,732
Pesqueira,261090,PE,Nordeste,PFIZER/BIONTECH,1,1,0
Petrolândia,261100,PE,Nordeste,FIOCRUZ/ASTRAZENECA,6060,5759,301
Petrolândia,261100,PE,Nordeste,BUTANTAN/SINOVAC,4072,2164,1908
Petrolândia,261100,PE,Nordeste,PFIZER/BIONTECH,473,473,0
Petrolândia,421270,SC,Sul,BUTANTAN/SINOVAC,1375,744,631
Petrolândia,421270,SC,Sul,FIOCRUZ/ASTRAZENECA,1370,1230,140
Petrolândia,421270,SC,Sul,PFIZER/BIONTECH,90,90,0
Petrolina,261110,PE,Nordeste,BUTANTAN/SINOVAC,56946,31786,25160
Petrolina,261110,PE,Nordeste,FIOCRUZ/ASTRAZENECA,50551,46929,3622
Petrolina,261110,PE,Nordeste,PFIZER/BIONTECH,6346,6340,6
Petrolina De Goiás,521680,GO,Centro-Oeste,FIOCRUZ/ASTRAZENECA,2419,2288,131
Petrolina De Goiás,521680,GO,Centro-Oeste,BUTANTAN/SINOVAC,1886,959,927
Petrolina De Goiás,521680,GO,Centro-Oeste,PFIZER/BIONTECH,186,186,0
Petrópolis,330390,RJ,Sudeste,BUTANTAN/SINOVAC,58563,32491,26072
Petrópolis,330390,RJ,Sudeste,FIOCRUZ/ASTRAZENECA,46764,43510,3254
Petrópolis,330390,RJ,Sudeste,PFIZER/BIONTECH,3257,3254,3
Piaçabuçu,270680,AL,Nordeste,FIOCRUZ/ASTRAZENECA,3102,2802,300
Piaçabuçu,270680,AL,Nordeste,BUTANTAN/SINOVAC,2722,1385,1337
Piacatu,353770,SP,Sudeste,BUTANTAN/SINOVAC,1601,923,678
Piacatu,353770,SP,Sudeste,FIOCRUZ/ASTRAZENECA,1094,1008,86
Piacatu,353770,SP,Sudeste,PFIZER/BIONTECH,234,234,0
Piancó,251130,PB,Nordeste,BUTANTAN/SINOVAC,4343,2209,2134
Piancó,251130,PB,Nordeste,FIOCRUZ/ASTRAZENECA,2992,2665,327
Piancó,251130,PB,Nordeste,PFIZER/BIONTECH,193,193,0
Piatã,292430,BA,Nordeste,FIOCRUZ/ASTRAZENECA,7520,6487,1033
Piatã,292430,BA,Nordeste,BUTANTAN/SINOVAC,3848,1971,1877
Piatã,292430,BA,Nordeste,PFIZER/BIONTECH,108,108,0
Piau,315010,MG,Sudeste,BUTANTAN/SINOVAC,869,451,418
Piau,315010,MG,Sudeste,FIOCRUZ/ASTRAZENECA,849,780,69
Piau,315010,MG,Sudeste,PFIZER/BIONTECH,40,40,0
Picada Café,431442,RS,Sul,FIOCRUZ/ASTRAZENECA,1782,1543,239
Picada Café,431442,RS,Sul,BUTANTAN/SINOVAC,1408,707,701
Picada Café,431442,RS,Sul,PFIZER/BIONTECH,156,156,0
Piçarra,150563,PA,Norte,FIOCRUZ/ASTRAZENECA,1433,1340,93
Piçarra,150563,PA,Norte,BUTANTAN/SINOVAC,613,372,241
Picos,220800,PI,Nordeste,FIOCRUZ/ASTRAZENECA,14533,12665,1868
Picos,220800,PI,Nordeste,BUTANTAN/SINOVAC,13884,7008,6876
Picos,220800,PI,Nordeste,PFIZER/BIONTECH,2321,2321,0
Picuí,251140,PB,Nordeste,BUTANTAN/SINOVAC,4517,2292,2225
Picuí,251140,PB,Nordeste,FIOCRUZ/ASTRAZENECA,3783,3388,395
Picuí,251140,PB,Nordeste,PFIZER/BIONTECH,354,354,0
Piedade,353780,SP,Sudeste,BUTANTAN/SINOVAC,10216,5136,5080
Piedade,353780,SP,Sudeste,FIOCRUZ/ASTRAZENECA,9274,8499,775
Piedade,353780,SP,Sudeste,PFIZER/BIONTECH,747,746,1
Piedade De Caratinga,315015,MG,Sudeste,FIOCRUZ/ASTRAZENECA,1475,1343,132
Piedade De Caratinga,315015,MG,Sudeste,BUTANTAN/SINOVAC,1394,705,689
Piedade De Caratinga,315015,MG,Sudeste,PFIZER/BIONTECH,42,42,0
Piedade De Ponte Nova,315020,MG,Sudeste,BUTANTAN/SINOVAC,1144,576,568
Piedade De Ponte Nova,315020,MG,Sudeste,FIOCRUZ/ASTRAZENECA,991,912,79
Piedade De Ponte Nova,315020,MG,Sudeste,PFIZER/BIONTECH,46,46,0
Piedade Do Rio Grande,315030,MG,Sudeste,FIOCRUZ/ASTRAZENECA,1349,1243,106
Piedade Do Rio Grande,315030,MG,Sudeste,BUTANTAN/SINOVAC,1274,663,611
Piedade Do Rio Grande,315030,MG,Sudeste,PFIZER/BIONTECH,18,17,1
Piedade Dos Gerais,315040,MG,Sudeste,BUTANTAN/SINOVAC,1286,654,632
Piedade Dos Gerais,315040,MG,Sudeste,FIOCRUZ/ASTRAZENECA,1278,1169,109
Piedade Dos Gerais,315040,MG,Sudeste,PFIZER/BIONTECH,82,82,0
Piên,411910,PR,Sul,FIOCRUZ/ASTRAZENECA,2842,2715,127
Piên,411910,PR,Sul,BUTANTAN/SINOVAC,1755,941,814
Piên,411910,PR,Sul,PFIZER/BIONTECH,43,35,8
Pilão Arcado,292440,BA,Nordeste,BUTANTAN/SINOVAC,5880,3469,2411
Pilão Arcado,292440,BA,Nordeste,FIOCRUZ/ASTRAZENECA,5093,4817,276
Pilão Arcado,292440,BA,Nordeste,PFIZER/BIONTECH,371,370,1
Pilar,251150,PB,Nordeste,BUTANTAN/SINOVAC,2560,1312,1248
Pilar,251150,PB,Nordeste,FIOCRUZ/ASTRAZENECA,2553,2363,190
Pilar,251150,PB,Nordeste,PFIZER/BIONTECH,317,317,0
Pilar,270690,AL,Nordeste,FIOCRUZ/ASTRAZENECA,7879,7360,519
Pilar,270690,AL,Nordeste,BUTANTAN/SINOVAC,5948,3021,2927
Pilar De Goiás,521690,GO,Centro-Oeste,FIOCRUZ/ASTRAZENECA,1299,1250,49
Pilar De Goiás,521690,GO,Centro-Oeste,BUTANTAN/SINOVAC,599,322,277
Pilar De Goiás,521690,GO,Centro-Oeste,PFIZER/BIONTECH,6,6,0
Pilar Do Sul,353790,SP,Sudeste,BUTANTAN/SINOVAC,7090,3819,3271
Pilar Do Sul,353790,SP,Sudeste,FIOCRUZ/ASTRAZENECA,5739,5255,484
Pilar Do Sul,353790,SP,Sudeste,PFIZER/BIONTECH,697,697,0
Pilões,241000,RN,Nordeste,BUTANTAN/SINOVAC,3463,1771,1692
Pilões,241000,RN,Nordeste,FIOCRUZ/ASTRAZENECA,2900,2692,208
Pilões,241000,RN,Nordeste,PFIZER/BIONTECH,277,277,0
Pilões,251160,PB,Nordeste,BUTANTAN/SINOVAC,1516,780,736
Pilões,251160,PB,Nordeste,FIOCRUZ/ASTRAZENECA,789,720,69
Pilões,251160,PB,Nordeste,PFIZER/BIONTECH,61,61,0
Pilõezinhos,251170,PB,Nordeste,BUTANTAN/SINOVAC,912,468,444
Pilõezinhos,251170,PB,Nordeste,FIOCRUZ/ASTRAZENECA,540,510,30
Pilõezinhos,251170,PB,Nordeste,PFIZER/BIONTECH,12,12,0
Pimenta,315050,MG,Sudeste,FIOCRUZ/ASTRAZENECA,1888,1772,116
Pimenta,315050,MG,Sudeste,BUTANTAN/SINOVAC,1673,843,830
Pimenta,315050,MG,Sudeste,PFIZER/BIONTECH,72,72,0
Pimenta Bueno,110018,RO,Norte,FIOCRUZ/ASTRAZENECA,6389,6120,269
Pimenta Bueno,110018,RO,Norte,BUTANTAN/SINOVAC,5765,3041,2724
Pimenta Bueno,110018,RO,Norte,PFIZER/BIONTECH,1328,1327,1
Pimenteiras,220810,PI,Nordeste,FIOCRUZ/ASTRAZENECA,2254,2072,182
Pimenteiras,220810,PI,Nordeste,BUTANTAN/SINOVAC,2032,1029,1003
Pimenteiras,220810,PI,Nordeste,PFIZER/BIONTECH,120,120,0
Pimenteiras Do Oeste,110146,RO,Norte,BUTANTAN/SINOVAC,749,438,311
Pimenteiras Do Oeste,110146,RO,Norte,FIOCRUZ/ASTRAZENECA,721,686,35
Pimenteiras Do Oeste,110146,RO,Norte,PFIZER/BIONTECH,42,42,0
Pindaí,292450,BA,Nordeste,BUTANTAN/SINOVAC,3529,1819,1710
Pindaí,292450,BA,Nordeste,FIOCRUZ/ASTRAZENECA,3492,3242,250
Pindamonhangaba,353800,SP,Sudeste,FIOCRUZ/ASTRAZENECA,33235,31359,1876
Pindamonhangaba,353800,SP,Sudeste,BUTANTAN/SINOVAC,30228,16083,14145
Pindamonhangaba,353800,SP,Sudeste,PFIZER/BIONTECH,2504,2503,1
Pindaré-Mirim,210850,MA,Nordeste,FIOCRUZ/ASTRAZENECA,6703,6358,345
Pindaré-Mirim,210850,MA,Nordeste,BUTANTAN/SINOVAC,4982,2731,2251
Pindoba,270700,AL,Nordeste,BUTANTAN/SINOVAC,579,294,285
Pindoba,270700,AL,Nordeste,FIOCRUZ/ASTRAZENECA,572,521,51
Pindobaçu,292460,BA,Nordeste,FIOCRUZ/ASTRAZENECA,4833,4780,53
Pindobaçu,292460,BA,Nordeste,BUTANTAN/SINOVAC,3230,1775,1455
Pindobaçu,292460,BA,Nordeste,PFIZER/BIONTECH,17,17,0
Pindorama,353810,SP,Sudeste,BUTANTAN/SINOVAC,4796,2717,2079
Pindorama,353810,SP,Sudeste,FIOCRUZ/ASTRAZENECA,4134,3731,403
Pindorama,353810,SP,Sudeste,PFIZER/BIONTECH,311,311,0
Pindorama Do Tocantins,171700,TO,Norte,BUTANTAN/SINOVAC,740,381,359
Pindorama Do Tocantins,171700,TO,Norte,FIOCRUZ/ASTRAZENECA,630,598,32
Pindoretama,231085,CE,Nordeste,BUTANTAN/SINOVAC,1054,726,328
Pindoretama,231085,CE,Nordeste,FIOCRUZ/ASTRAZENECA,515,514,1
Pingo-D'Água,315053,MG,Sudeste,BUTANTAN/SINOVAC,873,439,434
Pingo-D'Água,315053,MG,Sudeste,FIOCRUZ/ASTRAZENECA,785,733,52
Pinhais,411915,PR,Sul,FIOCRUZ/ASTRAZENECA,29315,27938,1377
Pinhais,411915,PR,Sul,BUTANTAN/SINOVAC,19663,10269,9394
Pinhais,411915,PR,Sul,PFIZER/BIONTECH,6686,6686,0
Pinhal,431445,RS,Sul,BUTANTAN/SINOVAC,862,441,421
Pinhal,431445,RS,Sul,FIOCRUZ/ASTRAZENECA,708,656,52
Pinhal,431445,RS,Sul,PFIZER/BIONTECH,127,127,0
Pinhal Da Serra,431446,RS,Sul,FIOCRUZ/ASTRAZENECA,917,825,92
Pinhal Da Serra,431446,RS,Sul,BUTANTAN/SINOVAC,492,244,248
Pinhal Da Serra,431446,RS,Sul,PFIZER/BIONTECH,73,73,0
Pinhal De São Bento,411925,PR,Sul,FIOCRUZ/ASTRAZENECA,988,935,53
Pinhal De São Bento,411925,PR,Sul,BUTANTAN/SINOVAC,787,489,298
Pinhal De São Bento,411925,PR,Sul,PFIZER/BIONTECH,23,23,0
Pinhal Grande,431447,RS,Sul,FIOCRUZ/ASTRAZENECA,1398,1224,174
Pinhal Grande,431447,RS,Sul,BUTANTAN/SINOVAC,1201,604,597
Pinhal Grande,431447,RS,Sul,PFIZER/BIONTECH,181,181,0
Pinhalão,411920,PR,Sul,FIOCRUZ/ASTRAZENECA,1889,1727,162
Pinhalão,411920,PR,Sul,BUTANTAN/SINOVAC,1566,855,711
Pinhalão,411920,PR,Sul,PFIZER/BIONTECH,30,30,0
Pinhalzinho,353820,SP,Sudeste,BUTANTAN/SINOVAC,3648,1905,1743
Pinhalzinho,353820,SP,Sudeste,FIOCRUZ/ASTRAZENECA,3407,3169,238
Pinhalzinho,353820,SP,Sudeste,PFIZER/BIONTECH,340,340,0
Pinhalzinho,421290,SC,Sul,FIOCRUZ/ASTRAZENECA,5080,4573,507
Pinhalzinho,421290,SC,Sul,BUTANTAN/SINOVAC,3691,1940,1751
Pinhalzinho,421290,SC,Sul,PFIZER/BIONTECH,567,567,0
Pinhão,280520,SE,Nordeste,BUTANTAN/SINOVAC,1741,894,847
Pinhão,280520,SE,Nordeste,FIOCRUZ/ASTRAZENECA,745,745,0
Pinhão,280520,SE,Nordeste,PFIZER/BIONTECH,62,62,0
Pinhão,411930,PR,Sul,FIOCRUZ/ASTRAZENECA,7368,7136,232
Pinhão,411930,PR,Sul,BUTANTAN/SINOVAC,4817,2521,2296
Pinhão,411930,PR,Sul,PFIZER/BIONTECH,318,318,0
Pinheiral,330395,RJ,Sudeste,FIOCRUZ/ASTRAZENECA,8444,6656,1788
Pinheiral,330395,RJ,Sudeste,BUTANTAN/SINOVAC,8022,4248,3774
Pinheiral,330395,RJ,Sudeste,PFIZER/BIONTECH,1541,1540,1
Pinheirinho Do Vale,431449,RS,Sul,BUTANTAN/SINOVAC,1305,663,642
Pinheirinho Do Vale,431449,RS,Sul,FIOCRUZ/ASTRAZENECA,1201,1152,49
Pinheirinho Do Vale,431449,RS,Sul,PFIZER/BIONTECH,125,125,0
Pinheiro,210860,MA,Nordeste,FIOCRUZ/ASTRAZENECA,25575,24443,1132
Pinheiro,210860,MA,Nordeste,BUTANTAN/SINOVAC,12359,6246,6113
Pinheiro,210860,MA,Nordeste,PFIZER/BIONTECH,431,430,1
Pinheiro Machado,431450,RS,Sul,FIOCRUZ/ASTRAZENECA,3548,3178,370
Pinheiro Machado,431450,RS,Sul,BUTANTAN/SINOVAC,3494,1773,1721
Pinheiro Machado,431450,RS,Sul,PFIZER/BIONTECH,430,430,0
Pinheiro Preto,421300,SC,Sul,FIOCRUZ/ASTRAZENECA,1003,939,64
Pinheiro Preto,421300,SC,Sul,BUTANTAN/SINOVAC,718,378,340
Pinheiro Preto,421300,SC,Sul,PFIZER/BIONTECH,53,53,0
Pinheiros,320410,ES,Sudeste,BUTANTAN/SINOVAC,6255,3208,3047
Pinheiros,320410,ES,Sudeste,FIOCRUZ/ASTRAZENECA,4882,4659,223
Pinheiros,320410,ES,Sudeste,PFIZER/BIONTECH,1020,1020,0
Pintadas,292465,BA,Nordeste,BUTANTAN/SINOVAC,2474,1319,1155
Pintadas,292465,BA,Nordeste,FIOCRUZ/ASTRAZENECA,2000,1696,304
Pintadas,292465,BA,Nordeste,PFIZER/BIONTECH,285,284,1
Pinto Bandeira,431454,RS,Sul,BUTANTAN/SINOVAC,1250,633,617
Pinto Bandeira,431454,RS,Sul,FIOCRUZ/ASTRAZENECA,716,563,153
Pinto Bandeira,431454,RS,Sul,PFIZER/BIONTECH,28,28,0
Pintópolis,315057,MG,Sudeste,BUTANTAN/SINOVAC,1450,763,687
Pintópolis,315057,MG,Sudeste,FIOCRUZ/ASTRAZENECA,1372,1248,124
Pintópolis,315057,MG,Sudeste,PFIZER/BIONTECH,34,34,0
Pio Ix,220820,PI,Nordeste,FIOCRUZ/ASTRAZENECA,2486,2299,187
Pio Ix,220820,PI,Nordeste,BUTANTAN/SINOVAC,2357,1259,1098
Pio Ix,220820,PI,Nordeste,PFIZER/BIONTECH,176,176,0
Pio Xii,210870,MA,Nordeste,BUTANTAN/SINOVAC,4476,2624,1852
Pio Xii,210870,MA,Nordeste,FIOCRUZ/ASTRAZENECA,4252,3955,297
Piquerobi,353830,SP,Sudeste,BUTANTAN/SINOVAC,1331,755,576
Piquerobi,353830,SP,Sudeste,FIOCRUZ/ASTRAZENECA,1098,1001,97
Piquerobi,353830,SP,Sudeste,PFIZER/BIONTECH,108,108,0
Piquet Carneiro,231090,CE,Nordeste,BUTANTAN/SINOVAC,3504,1786,1718
Piquet Carneiro,231090,CE,Nordeste,FIOCRUZ/ASTRAZENECA,1879,1544,335
Piquete,353850,SP,Sudeste,BUTANTAN/SINOVAC,3825,2088,1737
Piquete,353850,SP,Sudeste,FIOCRUZ/ASTRAZENECA,3732,3424,308
Piquete,353850,SP,Sudeste,PFIZER/BIONTECH,1,1,0
Piracaia,353860,SP,Sudeste,BUTANTAN/SINOVAC,6209,3501,2708
Piracaia,353860,SP,Sudeste,FIOCRUZ/ASTRAZENECA,5651,5187,464
Piracaia,353860,SP,Sudeste,PFIZER/BIONTECH,878,878,0
Piracanjuba,521710,GO,Centro-Oeste,FIOCRUZ/ASTRAZENECA,6703,6219,484
Piracanjuba,521710,GO,Centro-Oeste,BUTANTAN/SINOVAC,6342,3317,3025
Piracanjuba,521710,GO,Centro-Oeste,PFIZER/BIONTECH,205,205,0
Piracema,315060,MG,Sudeste,FIOCRUZ/ASTRAZENECA,1730,1586,144
Piracema,315060,MG,Sudeste,BUTANTAN/SINOVAC,1626,838,788
Piracema,315060,MG,Sudeste,PFIZER/BIONTECH,94,94,0
Piracicaba,353870,SP,Sudeste,BUTANTAN/SINOVAC,88409,49106,39303
Piracicaba,353870,SP,Sudeste,FIOCRUZ/ASTRAZENECA,79622,72905,6717
Piracicaba,353870,SP,Sudeste,PFIZER/BIONTECH,5780,5776,4
Piracuruca,220830,PI,Nordeste,FIOCRUZ/ASTRAZENECA,5846,5496,350
Piracuruca,220830,PI,Nordeste,BUTANTAN/SINOVAC,4410,2303,2107
Piraí,330400,RJ,Sudeste,FIOCRUZ/ASTRAZENECA,6784,6143,641
Piraí,330400,RJ,Sudeste,BUTANTAN/SINOVAC,5744,2924,2820
Piraí,330400,RJ,Sudeste,PFIZER/BIONTECH,668,668,0
Piraí Do Norte,292467,BA,Nordeste,FIOCRUZ/ASTRAZENECA,1393,1292,101
Piraí Do Norte,292467,BA,Nordeste,BUTANTAN/SINOVAC,1233,702,531
Piraí Do Norte,292467,BA,Nordeste,PFIZER/BIONTECH,34,24,10
Piraí Do Sul,411940,PR,Sul,FIOCRUZ/ASTRAZENECA,5393,5078,315
Piraí Do Sul,411940,PR,Sul,BUTANTAN/SINOVAC,4887,2529,2358
Piraí Do Sul,411940,PR,Sul,PFIZER/BIONTECH,216,216,0
Piraju,353880,SP,Sudeste,BUTANTAN/SINOVAC,8544,4700,3844
Piraju,353880,SP,Sudeste,FIOCRUZ/ASTRAZENECA,7698,7118,580
Piraju,353880,SP,Sudeste,PFIZER/BIONTECH,1096,1096,0
Pirajuba,315070,MG,Sudeste,BUTANTAN/SINOVAC,730,361,369
Pirajuba,315070,MG,Sudeste,FIOCRUZ/ASTRAZENECA,688,597,91
Pirajuí,353890,SP,Sudeste,BUTANTAN/SINOVAC,6640,3567,3073
Pirajuí,353890,SP,Sudeste,FIOCRUZ/ASTRAZENECA,3957,3513,444
Pirajuí,353890,SP,Sudeste,PFIZER/BIONTECH,188,188,0
Pirambu,280530,SE,Nordeste,BUTANTAN/SINOVAC,1764,892,872
Pirambu,280530,SE,Nordeste,FIOCRUZ/ASTRAZENECA,589,582,7
Piranga,315080,MG,Sudeste,FIOCRUZ/ASTRAZENECA,1286,1118,168
Piranga,315080,MG,Sudeste,BUTANTAN/SINOVAC,1189,688,501
Pirangi,353900,SP,Sudeste,BUTANTAN/SINOVAC,3408,1853,1555
Pirangi,353900,SP,Sudeste,FIOCRUZ/ASTRAZENECA,2625,2359,266
Pirangi,353900,SP,Sudeste,PFIZER/BIONTECH,220,220,0
Piranguçu,315090,MG,Sudeste,BUTANTAN/SINOVAC,1465,770,695
Piranguçu,315090,MG,Sudeste,FIOCRUZ/ASTRAZENECA,1240,1147,93
Piranguçu,315090,MG,Sudeste,PFIZER/BIONTECH,175,175,0
Piranguinho,315100,MG,Sudeste,BUTANTAN/SINOVAC,1764,902,862
Piranguinho,315100,MG,Sudeste,FIOCRUZ/ASTRAZENECA,1291,1201,90
Piranguinho,315100,MG,Sudeste,PFIZER/BIONTECH,44,44,0
Piranhas,270710,AL,Nordeste,BUTANTAN/SINOVAC,3995,2228,1767
Piranhas,270710,AL,Nordeste,FIOCRUZ/ASTRAZENECA,3488,3206,282
Piranhas,521720,GO,Centro-Oeste,FIOCRUZ/ASTRAZENECA,3101,2904,197
Piranhas,521720,GO,Centro-Oeste,BUTANTAN/SINOVAC,2677,1420,1257
Pirapemas,210880,MA,Nordeste,FIOCRUZ/ASTRAZENECA,3297,3098,199
Pirapemas,210880,MA,Nordeste,BUTANTAN/SINOVAC,2684,1421,1263
Pirapetinga,315110,MG,Sudeste,FIOCRUZ/ASTRAZENECA,2643,2429,214
Pirapetinga,315110,MG,Sudeste,BUTANTAN/SINOVAC,2143,1278,865
Pirapetinga,315110,MG,Sudeste,PFIZER/BIONTECH,143,143,0
Pirapó,431455,RS,Sul,BUTANTAN/SINOVAC,1112,572,540
Pirapó,431455,RS,Sul,FIOCRUZ/ASTRAZENECA,743,695,48
Pirapó,431455,RS,Sul,PFIZER/BIONTECH,117,117,0
Pirapora,315120,MG,Sudeste,BUTANTAN/SINOVAC,11120,5886,5234
Pirapora,315120,MG,Sudeste,FIOCRUZ/ASTRAZENECA,10879,10051,828
Pirapora,315120,MG,Sudeste,PFIZER/BIONTECH,2845,2845,0
Pirapora Do Bom Jesus,353910,SP,Sudeste,FIOCRUZ/ASTRAZENECA,3053,2887,166
Pirapora Do Bom Jesus,353910,SP,Sudeste,BUTANTAN/SINOVAC,2227,1243,984
Pirapora Do Bom Jesus,353910,SP,Sudeste,PFIZER/BIONTECH,265,264,1
Pirapozinho,353920,SP,Sudeste,FIOCRUZ/ASTRAZENECA,6336,5913,423
Pirapozinho,353920,SP,Sudeste,BUTANTAN/SINOVAC,6240,3553,2687
Pirapozinho,353920,SP,Sudeste,PFIZER/BIONTECH,668,667,1
Piraquara,411950,PR,Sul,FIOCRUZ/ASTRAZENECA,20794,19876,918
Piraquara,411950,PR,Sul,BUTANTAN/SINOVAC,15614,8484,7130
Piraquara,411950,PR,Sul,PFIZER/BIONTECH,3513,3510,3
Piraquê,171720,TO,Norte,BUTANTAN/SINOVAC,691,375,316
Piraquê,171720,TO,Norte,FIOCRUZ/ASTRAZENECA,426,404,22
Pirassununga,353930,SP,Sudeste,BUTANTAN/SINOVAC,19887,10521,9366
Pirassununga,353930,SP,Sudeste,FIOCRUZ/ASTRAZENECA,18019,16635,1384
Pirassununga,353930,SP,Sudeste,PFIZER/BIONTECH,2227,2226,1
Piratini,431460,RS,Sul,FIOCRUZ/ASTRAZENECA,5966,5477,489
Piratini,431460,RS,Sul,BUTANTAN/SINOVAC,5891,2965,2926
Piratini,431460,RS,Sul,PFIZER/BIONTECH,353,353,0
Piratininga,353940,SP,Sudeste,BUTANTAN/SINOVAC,4169,2377,1792
Piratininga,353940,SP,Sudeste,FIOCRUZ/ASTRAZENECA,3987,3565,422
Piratininga,353940,SP,Sudeste,PFIZER/BIONTECH,307,307,0
Piratuba,421310,SC,Sul,BUTANTAN/SINOVAC,1439,722,717
Piratuba,421310,SC,Sul,FIOCRUZ/ASTRAZENECA,1264,1136,128
Piratuba,421310,SC,Sul,PFIZER/BIONTECH,113,113,0
Piraúba,315130,MG,Sudeste,FIOCRUZ/ASTRAZENECA,2834,2677,157
Piraúba,315130,MG,Sudeste,BUTANTAN/SINOVAC,2834,1461,1373
Piraúba,315130,MG,Sudeste,PFIZER/BIONTECH,379,379,0
Pirenópolis,521730,GO,Centro-Oeste,FIOCRUZ/ASTRAZENECA,7333,6847,486
Pirenópolis,521730,GO,Centro-Oeste,BUTANTAN/SINOVAC,4884,2621,2263
Pirenópolis,521730,GO,Centro-Oeste,PFIZER/BIONTECH,75,75,0
Pires Do Rio,521740,GO,Centro-Oeste,FIOCRUZ/ASTRAZENECA,10657,9447,1210
Pires Do Rio,521740,GO,Centro-Oeste,BUTANTAN/SINOVAC,5869,3247,2622
Pires Ferreira,231095,CE,Nordeste,FIOCRUZ/ASTRAZENECA,3385,3138,247
Pires Ferreira,231095,CE,Nordeste,BUTANTAN/SINOVAC,2313,1211,1102
Pires Ferreira,231095,CE,Nordeste,PFIZER/BIONTECH,289,289,0
Piripá,292470,BA,Nordeste,BUTANTAN/SINOVAC,3078,1610,1468
Piripá,292470,BA,Nordeste,FIOCRUZ/ASTRAZENECA,2396,2210,186
Piripá,292470,BA,Nordeste,PFIZER/BIONTECH,167,167,0
Piripiri,220840,PI,Nordeste,FIOCRUZ/ASTRAZENECA,13011,12005,1006
Piripiri,220840,PI,Nordeste,BUTANTAN/SINOVAC,11233,6010,5223
Piripiri,220840,PI,Nordeste,PFIZER/BIONTECH,1786,1786,0
Piritiba,292480,BA,Nordeste,BUTANTAN/SINOVAC,4651,2408,2243
Piritiba,292480,BA,Nordeste,FIOCRUZ/ASTRAZENECA,4416,3871,545
Piritiba,292480,BA,Nordeste,PFIZER/BIONTECH,68,68,0
Pirpirituba,251180,PB,Nordeste,BUTANTAN/SINOVAC,2928,1700,1228
Pirpirituba,251180,PB,Nordeste,FIOCRUZ/ASTRAZENECA,1800,1641,159
Pirpirituba,251180,PB,Nordeste,PFIZER/BIONTECH,169,169,0
Pitanga,411960,PR,Sul,FIOCRUZ/ASTRAZENECA,9799,9460,339
Pitanga,411960,PR,Sul,BUTANTAN/SINOVAC,6614,3506,3108
Pitanga,411960,PR,Sul,PFIZER/BIONTECH,1122,1122,0
Pitangueiras,353950,SP,Sudeste,BUTANTAN/SINOVAC,6878,3601,3277
Pitangueiras,353950,SP,Sudeste,FIOCRUZ/ASTRAZENECA,6537,5969,568
Pitangueiras,353950,SP,Sudeste,PFIZER/BIONTECH,618,618,0
Pitangueiras,411965,PR,Sul,FIOCRUZ/ASTRAZENECA,1273,1221,52
Pitangueiras,411965,PR,Sul,BUTANTAN/SINOVAC,763,391,372
Pitangui,315140,MG,Sudeste,BUTANTAN/SINOVAC,4774,2501,2273
Pitangui,315140,MG,Sudeste,FIOCRUZ/ASTRAZENECA,4022,3676,346
Pitimbu,251190,PB,Nordeste,BUTANTAN/SINOVAC,2721,1614,1107
Pitimbu,251190,PB,Nordeste,FIOCRUZ/ASTRAZENECA,497,377,120
Pium,171750,TO,Norte,BUTANTAN/SINOVAC,1716,909,807
Pium,171750,TO,Norte,FIOCRUZ/ASTRAZENECA,1395,1328,67
Piúma,320420,ES,Sudeste,BUTANTAN/SINOVAC,5392,2993,2399
Piúma,320420,ES,Sudeste,FIOCRUZ/ASTRAZENECA,3656,3544,112
Piúma,320420,ES,Sudeste,PFIZER/BIONTECH,538,538,0
Piumhi,315150,MG,Sudeste,BUTANTAN/SINOVAC,8012,4084,3928
Piumhi,315150,MG,Sudeste,FIOCRUZ/ASTRAZENECA,6241,5885,356
Piumhi,315150,MG,Sudeste,PFIZER/BIONTECH,669,669,0
Placas,150565,PA,Norte,FIOCRUZ/ASTRAZENECA,3001,2556,445
Placas,150565,PA,Norte,BUTANTAN/SINOVAC,1168,652,516
Plácido De Castro,120038,AC,Norte,FIOCRUZ/ASTRAZENECA,3962,3505,457
Plácido De Castro,120038,AC,Norte,BUTANTAN/SINOVAC,1699,950,749
Plácido De Castro,120038,AC,Norte,PFIZER/BIONTECH,203,202,1
Planaltina,521760,GO,Centro-Oeste,FIOCRUZ/ASTRAZENECA,20638,19508,1130
Planaltina,521760,GO,Centro-Oeste,BUTANTAN/SINOVAC,8287,4347,3940
Planaltina,521760,GO,Centro-Oeste,PFIZER/BIONTECH,1329,1328,1
Planaltina Do Paraná,411970,PR,Sul,FIOCRUZ/ASTRAZENECA,1165,1078,87
Planaltina Do Paraná,411970,PR,Sul,BUTANTAN/SINOVAC,1093,579,514
Planaltina Do Paraná,411970,PR,Sul,PFIZER/BIONTECH,17,17,0
Planaltino,292490,BA,Nordeste,BUTANTAN/SINOVAC,149,79,70
Planaltino,292490,BA,Nordeste,FIOCRUZ/ASTRAZENECA,83,83,0
Planalto,292500,BA,Nordeste,BUTANTAN/SINOVAC,4072,2009,2063
Planalto,292500,BA,Nordeste,FIOCRUZ/ASTRAZENECA,3641,3336,305
Planalto,292500,BA,Nordeste,PFIZER/BIONTECH,54,54,0
Planalto,353960,SP,Sudeste,BUTANTAN/SINOVAC,1206,691,515
Planalto,353960,SP,Sudeste,FIOCRUZ/ASTRAZENECA,1107,1019,88
Planalto,353960,SP,Sudeste,PFIZER/BIONTECH,111,111,0
Planalto,411980,PR,Sul,FIOCRUZ/ASTRAZENECA,3702,3502,200
Planalto,411980,PR,Sul,BUTANTAN/SINOVAC,3452,1774,1678
Planalto,411980,PR,Sul,PFIZER/BIONTECH,179,179,0
Planalto,431470,RS,Sul,BUTANTAN/SINOVAC,4862,2533,2329
Planalto,431470,RS,Sul,FIOCRUZ/ASTRAZENECA,2143,2004,139
Planalto,431470,RS,Sul,PFIZER/BIONTECH,344,344,0
Planalto Alegre,421315,SC,Sul,BUTANTAN/SINOVAC,1496,787,709
Planalto Alegre,421315,SC,Sul,FIOCRUZ/ASTRAZENECA,1310,1150,160
Planalto Alegre,421315,SC,Sul,PFIZER/BIONTECH,40,40,0
Planalto Da Serra,510645,MT,Centro-Oeste,BUTANTAN/SINOVAC,686,346,340
Planalto Da Serra,510645,MT,Centro-Oeste,FIOCRUZ/ASTRAZENECA,573,448,125
Planalto Da Serra,510645,MT,Centro-Oeste,PFIZER/BIONTECH,53,53,0
Planura,315160,MG,Sudeste,BUTANTAN/SINOVAC,1742,874,868
Planura,315160,MG,Sudeste,FIOCRUZ/ASTRAZENECA,913,803,110
Platina,353970,SP,Sudeste,FIOCRUZ/ASTRAZENECA,813,743,70
Platina,353970,SP,Sudeste,BUTANTAN/SINOVAC,778,386,392
Platina,353970,SP,Sudeste,PFIZER/BIONTECH,111,110,1
Poá,353980,SP,Sudeste,FIOCRUZ/ASTRAZENECA,22458,20828,1630
Poá,353980,SP,Sudeste,BUTANTAN/SINOVAC,18867,10655,8212
Poá,353980,SP,Sudeste,PFIZER/BIONTECH,1063,1059,4
Poção,261120,PE,Nordeste,FIOCRUZ/ASTRAZENECA,2404,2208,196
Poção,261120,PE,Nordeste,BUTANTAN/SINOVAC,1994,1000,994
Poção,261120,PE,Nordeste,PFIZER/BIONTECH,307,307,0
Poção De Pedras,210890,MA,Nordeste,FIOCRUZ/ASTRAZENECA,4551,4322,229
Poção De Pedras,210890,MA,Nordeste,BUTANTAN/SINOVAC,3209,1661,1548
Pocinhos,251200,PB,Nordeste,BUTANTAN/SINOVAC,3827,1963,1864
Pocinhos,251200,PB,Nordeste,FIOCRUZ/ASTRAZENECA,2996,2715,281
Pocinhos,251200,PB,Nordeste,PFIZER/BIONTECH,364,364,0
Poço Branco,241010,RN,Nordeste,BUTANTAN/SINOVAC,2416,1250,1166
Poço Branco,241010,RN,Nordeste,FIOCRUZ/ASTRAZENECA,1970,1845,125
Poço Branco,241010,RN,Nordeste,PFIZER/BIONTECH,282,282,0
Poço Dantas,251203,PB,Nordeste,BUTANTAN/SINOVAC,731,376,355
Poço Dantas,251203,PB,Nordeste,FIOCRUZ/ASTRAZENECA,619,560,59
Poço Dantas,251203,PB,Nordeste,PFIZER/BIONTECH,72,72,0
Poço Das Antas,431475,RS,Sul,BUTANTAN/SINOVAC,786,392,394
Poço Das Antas,431475,RS,Sul,FIOCRUZ/ASTRAZENECA,590,491,99
Poço Das Antas,431475,RS,Sul,PFIZER/BIONTECH,72,72,0
Poço Das Trincheiras,270720,AL,Nordeste,FIOCRUZ/ASTRAZENECA,3683,3510,173
Poço Das Trincheiras,270720,AL,Nordeste,BUTANTAN/SINOVAC,1541,820,721
Poço De José De Moura,251207,PB,Nordeste,BUTANTAN/SINOVAC,1196,607,589
Poço De José De Moura,251207,PB,Nordeste,FIOCRUZ/ASTRAZENECA,1049,958,91
Poço De José De Moura,251207,PB,Nordeste,PFIZER/BIONTECH,111,111,0
Poço Fundo,315170,MG,Sudeste,BUTANTAN/SINOVAC,3926,1924,2002
Poço Fundo,315170,MG,Sudeste,FIOCRUZ/ASTRAZENECA,3055,2867,188
Poço Fundo,315170,MG,Sudeste,PFIZER/BIONTECH,126,126,0
Poço Redondo,280540,SE,Nordeste,BUTANTAN/SINOVAC,5481,2806,2675
Poço Redondo,280540,SE,Nordeste,FIOCRUZ/ASTRAZENECA,4771,4590,181
Poço Redondo,280540,SE,Nordeste,PFIZER/BIONTECH,379,379,0
Poço Verde,280550,SE,Nordeste,BUTANTAN/SINOVAC,5030,2738,2292
Poço Verde,280550,SE,Nordeste,FIOCRUZ/ASTRAZENECA,3573,3498,75
Poço Verde,280550,SE,Nordeste,PFIZER/BIONTECH,192,192,0
Poções,292510,BA,Nordeste,BUTANTAN/SINOVAC,10820,6262,4558
Poções,292510,BA,Nordeste,FIOCRUZ/ASTRAZENECA,7647,7224,423
Poções,292510,BA,Nordeste,PFIZER/BIONTECH,108,108,0
Poconé,510650,MT,Centro-Oeste,FIOCRUZ/ASTRAZENECA,10985,10137,848
Poconé,510650,MT,Centro-Oeste,BUTANTAN/SINOVAC,5973,3189,2784
Poconé,510650,MT,Centro-Oeste,PFIZER/BIONTECH,223,223,0
Poços De Caldas,315180,MG,Sudeste,BUTANTAN/SINOVAC,40688,20880,19808
Poços De Caldas,315180,MG,Sudeste,FIOCRUZ/ASTRAZENECA,38945,35553,3392
Poços De Caldas,315180,MG,Sudeste,PFIZER/BIONTECH,5703,5687,16
Pocrane,315190,MG,Sudeste,BUTANTAN/SINOVAC,2434,1228,1206
Pocrane,315190,MG,Sudeste,FIOCRUZ/ASTRAZENECA,1967,1819,148
Pocrane,315190,MG,Sudeste,PFIZER/BIONTECH,278,278,0
Pojuca,292520,BA,Nordeste,FIOCRUZ/ASTRAZENECA,6076,5595,481
Pojuca,292520,BA,Nordeste,BUTANTAN/SINOVAC,5223,2680,2543
Pojuca,292520,BA,Nordeste,PFIZER/BIONTECH,937,937,0
Poloni,353990,SP,Sudeste,BUTANTAN/SINOVAC,1934,1052,882
Poloni,353990,SP,Sudeste,FIOCRUZ/ASTRAZENECA,1543,1372,171
Poloni,353990,SP,Sudeste,PFIZER/BIONTECH,243,243,0
Pombal,251210,PB,Nordeste,FIOCRUZ/ASTRAZENECA,8321,7689,632
Pombal,251210,PB,Nordeste,BUTANTAN/SINOVAC,8036,4165,3871
Pombal,251210,PB,Nordeste,PFIZER/BIONTECH,551,550,1
Pombos,261130,PE,Nordeste,BUTANTAN/SINOVAC,4429,2553,1876
Pombos,261130,PE,Nordeste,FIOCRUZ/ASTRAZENECA,3692,3443,249
Pombos,261130,PE,Nordeste,PFIZER/BIONTECH,135,135,0
Pomerode,421320,SC,Sul,BUTANTAN/SINOVAC,11262,6211,5051
Pomerode,421320,SC,Sul,FIOCRUZ/ASTRAZENECA,6847,6616,231
Pomerode,421320,SC,Sul,PFIZER/BIONTECH,679,679,0
Pompéia,354000,SP,Sudeste,BUTANTAN/SINOVAC,6292,3450,2842
Pompéia,354000,SP,Sudeste,FIOCRUZ/ASTRAZENECA,4946,4415,531
Pompéia,354000,SP,Sudeste,PFIZER/BIONTECH,326,326,0
Pompéu,315200,MG,Sudeste,FIOCRUZ/ASTRAZENECA,5364,4959,405
Pompéu,315200,MG,Sudeste,BUTANTAN/SINOVAC,5114,2568,2546
Pompéu,315200,MG,Sudeste,PFIZER/BIONTECH,1079,1079,0
Pongaí,354010,SP,Sudeste,BUTANTAN/SINOVAC,1923,1069,854
Pongaí,354010,SP,Sudeste,FIOCRUZ/ASTRAZENECA,1350,1219,131
Pongaí,354010,SP,Sudeste,PFIZER/BIONTECH,78,78,0
Ponta De Pedras,150570,PA,Norte,FIOCRUZ/ASTRAZENECA,10142,9177,965
Ponta De Pedras,150570,PA,Norte,BUTANTAN/SINOVAC,1684,895,789
Ponta Grossa,411990,PR,Sul,FIOCRUZ/ASTRAZENECA,58542,53261,5281
Ponta Grossa,411990,PR,Sul,BUTANTAN/SINOVAC,55271,27723,27548
Ponta Grossa,411990,PR,Sul,PFIZER/BIONTECH,7886,7866,20
Ponta Porã,500660,MS,Centro-Oeste,FIOCRUZ/ASTRAZENECA,21363,19234,2129
Ponta Porã,500660,MS,Centro-Oeste,BUTANTAN/SINOVAC,19049,10325,8724
Ponta Porã,500660,MS,Centro-Oeste,PFIZER/BIONTECH,3041,3036,5
Pontal,354020,SP,Sudeste,FIOCRUZ/ASTRAZENECA,8314,7729,585
Pontal,354020,SP,Sudeste,BUTANTAN/SINOVAC,6828,3779,3049
Pontal,354020,SP,Sudeste,PFIZER/BIONTECH,614,609,5
Pontal Do Araguaia,510665,MT,Centro-Oeste,BUTANTAN/SINOVAC,1105,552,553
Pontal Do Araguaia,510665,MT,Centro-Oeste,FIOCRUZ/ASTRAZENECA,890,820,70
Pontal Do Araguaia,510665,MT,Centro-Oeste,PFIZER/BIONTECH,141,141,0
Pontal Do Paraná,411995,PR,Sul,FIOCRUZ/ASTRAZENECA,9561,9195,366
Pontal Do Paraná,411995,PR,Sul,BUTANTAN/SINOVAC,6764,3577,3187
Pontal Do Paraná,411995,PR,Sul,PFIZER/BIONTECH,384,384,0
Pontalina,521770,GO,Centro-Oeste,FIOCRUZ/ASTRAZENECA,4552,4303,249
Pontalina,521770,GO,Centro-Oeste,BUTANTAN/SINOVAC,3930,1986,1944
Pontalinda,354025,SP,Sudeste,BUTANTAN/SINOVAC,1645,895,750
Pontalinda,354025,SP,Sudeste,FIOCRUZ/ASTRAZENECA,1216,1115,101
Pontalinda,354025,SP,Sudeste,PFIZER/BIONTECH,215,215,0
Pontão,431477,RS,Sul,FIOCRUZ/ASTRAZENECA,1169,1011,158
Pontão,431477,RS,Sul,BUTANTAN/SINOVAC,908,484,424
Pontão,431477,RS,Sul,PFIZER/BIONTECH,140,140,0
Ponte Alta,421330,SC,Sul,FIOCRUZ/ASTRAZENECA,1880,1778,102
Ponte Alta,421330,SC,Sul,BUTANTAN/SINOVAC,1550,823,727
Ponte Alta,421330,SC,Sul,PFIZER/BIONTECH,41,41,0
Ponte Alta Do Bom Jesus,171780,TO,Norte,BUTANTAN/SINOVAC,1092,559,533
Ponte Alta Do Bom Jesus,171780,TO,Norte,FIOCRUZ/ASTRAZENECA,939,900,39
Ponte Alta Do Norte,421335,SC,Sul,FIOCRUZ/ASTRAZENECA,781,725,56
Ponte Alta Do Norte,421335,SC,Sul,BUTANTAN/SINOVAC,648,329,319
Ponte Alta Do Tocantins,171790,TO,Norte,BUTANTAN/SINOVAC,1185,614,571
Ponte Alta Do Tocantins,171790,TO,Norte,FIOCRUZ/ASTRAZENECA,1011,951,60
Ponte Branca,510670,MT,Centro-Oeste,BUTANTAN/SINOVAC,613,320,293
Ponte Branca,510670,MT,Centro-Oeste,FIOCRUZ/ASTRAZENECA,531,503,28
Ponte Branca,510670,MT,Centro-Oeste,PFIZER/BIONTECH,30,30,0
Ponte Nova,315210,MG,Sudeste,BUTANTAN/SINOVAC,15277,7768,7509
Ponte Nova,315210,MG,Sudeste,FIOCRUZ/ASTRAZENECA,11423,9976,1447
Ponte Nova,315210,MG,Sudeste,PFIZER/BIONTECH,1570,1570,0
Ponte Preta,431478,RS,Sul,BUTANTAN/SINOVAC,658,333,325
Ponte Preta,431478,RS,Sul,FIOCRUZ/ASTRAZENECA,458,401,57
Ponte Preta,431478,RS,Sul,PFIZER/BIONTECH,60,60,0
Ponte Serrada,421340,SC,Sul,FIOCRUZ/ASTRAZENECA,2401,2253,148
Ponte Serrada,421340,SC,Sul,BUTANTAN/SINOVAC,2140,1089,1051
Ponte Serrada,421340,SC,Sul,PFIZER/BIONTECH,135,134,1
Pontes E Lacerda,510675,MT,Centro-Oeste,FIOCRUZ/ASTRAZENECA,5914,5558,356
Pontes E Lacerda,510675,MT,Centro-Oeste,BUTANTAN/SINOVAC,5757,2970,2787
Pontes E Lacerda,510675,MT,Centro-Oeste,PFIZER/BIONTECH,532,532,0
Pontes Gestal,354030,SP,Sudeste,BUTANTAN/SINOVAC,872,493,379
Pontes Gestal,354030,SP,Sudeste,FIOCRUZ/ASTRAZENECA,706,649,57
Pontes Gestal,354030,SP,Sudeste,PFIZER/BIONTECH,71,71,0
Ponto Belo,320425,ES,Sudeste,BUTANTAN/SINOVAC,1901,1124,777
Ponto Belo,320425,ES,Sudeste,FIOCRUZ/ASTRAZENECA,1702,1608,94
Ponto Belo,320425,ES,Sudeste,PFIZER/BIONTECH,151,151,0
Ponto Chique,315213,MG,Sudeste,BUTANTAN/SINOVAC,956,526,430
Ponto Chique,315213,MG,Sudeste,FIOCRUZ/ASTRAZENECA,491,466,25
Ponto Dos Volantes,315217,MG,Sudeste,BUTANTAN/SINOVAC,2369,1193,1176
Ponto Dos Volantes,315217,MG,Sudeste,FIOCRUZ/ASTRAZENECA,2067,1933,134
Ponto Dos Volantes,315217,MG,Sudeste,PFIZER/BIONTECH,228,228,0
Ponto Novo,292525,BA,Nordeste,FIOCRUZ/ASTRAZENECA,3047,2765,282
Ponto Novo,292525,BA,Nordeste,BUTANTAN/SINOVAC,2879,1525,1354
Ponto Novo,292525,BA,Nordeste,PFIZER/BIONTECH,296,296,0
Populina,354040,SP,Sudeste,BUTANTAN/SINOVAC,1503,858,645
Populina,354040,SP,Sudeste,FIOCRUZ/ASTRAZENECA,1261,1130,131
Populina,354040,SP,Sudeste,PFIZER/BIONTECH,129,129,0
Poranga,231100,CE,Nordeste,BUTANTAN/SINOVAC,4723,2429,2294
Poranga,231100,CE,Nordeste,FIOCRUZ/ASTRAZENECA,1762,1430,332
Porangaba,354050,SP,Sudeste,BUTANTAN/SINOVAC,2811,1683,1128
Porangaba,354050,SP,Sudeste,FIOCRUZ/ASTRAZENECA,2173,1994,179
Porangaba,354050,SP,Sudeste,PFIZER/BIONTECH,248,248,0
Porangatu,521800,GO,Centro-Oeste,FIOCRUZ/ASTRAZENECA,9745,9079,666
Porangatu,521800,GO,Centro-Oeste,BUTANTAN/SINOVAC,6774,3662,3112
Porangatu,521800,GO,Centro-Oeste,PFIZER/BIONTECH,1445,1444,1
Porciúncula,330410,RJ,Sudeste,BUTANTAN/SINOVAC,4313,2256,2057
Porciúncula,330410,RJ,Sudeste,FIOCRUZ/ASTRAZENECA,2326,2020,306
Porecatu,412000,PR,Sul,FIOCRUZ/ASTRAZENECA,3557,3236,321
Porecatu,412000,PR,Sul,BUTANTAN/SINOVAC,3110,1592,1518
Porecatu,412000,PR,Sul,PFIZER/BIONTECH,414,414,0
Portalegre,241020,RN,Nordeste,FIOCRUZ/ASTRAZENECA,2710,2428,282
Portalegre,241020,RN,Nordeste,BUTANTAN/SINOVAC,1759,898,861
Portalegre,241020,RN,Nordeste,PFIZER/BIONTECH,246,246,0
Portão,431480,RS,Sul,FIOCRUZ/ASTRAZENECA,8374,7980,394
Portão,431480,RS,Sul,BUTANTAN/SINOVAC,7480,3779,3701
Portão,431480,RS,Sul,PFIZER/BIONTECH,1323,1323,0
Porteirão,521805,GO,Centro-Oeste,FIOCRUZ/ASTRAZENECA,887,810,77
Porteirão,521805,GO,Centro-Oeste,BUTANTAN/SINOVAC,641,334,307
Porteirão,521805,GO,Centro-Oeste,PFIZER/BIONTECH,66,66,0
Porteiras,231110,CE,Nordeste,BUTANTAN/SINOVAC,2643,1354,1289
Porteiras,231110,CE,Nordeste,FIOCRUZ/ASTRAZENECA,2602,2322,280
Porteirinha,315220,MG,Sudeste,BUTANTAN/SINOVAC,8934,4602,4332
Porteirinha,315220,MG,Sudeste,FIOCRUZ/ASTRAZENECA,6578,6066,512
Porteirinha,315220,MG,Sudeste,PFIZER/BIONTECH,898,896,2
Portel,150580,PA,Norte,FIOCRUZ/ASTRAZENECA,14168,13638,530
Portel,150580,PA,Norte,BUTANTAN/SINOVAC,2072,1124,948
Portelândia,521810,GO,Centro-Oeste,BUTANTAN/SINOVAC,858,465,393
Portelândia,521810,GO,Centro-Oeste,FIOCRUZ/ASTRAZENECA,826,766,60
Porto,220850,PI,Nordeste,BUTANTAN/SINOVAC,1527,774,753
Porto,220850,PI,Nordeste,FIOCRUZ/ASTRAZENECA,937,873,64
Porto Acre,120080,AC,Norte,FIOCRUZ/ASTRAZENECA,3590,3255,335
Porto Acre,120080,AC,Norte,BUTANTAN/SINOVAC,1765,997,768
Porto Alegre,431490,RS,Sul,BUTANTAN/SINOVAC,547070,278703,268367
Porto Alegre,431490,RS,Sul,FIOCRUZ/ASTRAZENECA,332431,282373,50058
Porto Alegre,431490,RS,Sul,PFIZER/BIONTECH,105706,72036,33670
Porto Alegre Do Norte,510677,MT,Centro-Oeste,BUTANTAN/SINOVAC,2081,1109,972
Porto Alegre Do Norte,510677,MT,Centro-Oeste,FIOCRUZ/ASTRAZENECA,914,806,108
Porto Alegre Do Norte,510677,MT,Centro-Oeste,PFIZER/BIONTECH,29,29,0
Porto Alegre Do Piauí,220855,PI,Nordeste,BUTANTAN/SINOVAC,547,285,262
Porto Alegre Do Piauí,220855,PI,Nordeste,FIOCRUZ/ASTRAZENECA,426,387,39
Porto Alegre Do Piauí,220855,PI,Nordeste,PFIZER/BIONTECH,29,29,0
Porto Alegre Do Tocantins,171800,TO,Norte,FIOCRUZ/ASTRAZENECA,697,596,101
Porto Alegre Do Tocantins,171800,TO,Norte,BUTANTAN/SINOVAC,634,322,312
Porto Amazonas,412010,PR,Sul,FIOCRUZ/ASTRAZENECA,1021,942,79
Porto Amazonas,412010,PR,Sul,BUTANTAN/SINOVAC,912,471,441
Porto Barreiro,412015,PR,Sul,FIOCRUZ/ASTRAZENECA,941,913,28
Porto Barreiro,412015,PR,Sul,BUTANTAN/SINOVAC,745,390,355
Porto Barreiro,412015,PR,Sul,PFIZER/BIONTECH,18,18,0
Porto Belo,421350,SC,Sul,FIOCRUZ/ASTRAZENECA,3742,3664,78
Porto Belo,421350,SC,Sul,BUTANTAN/SINOVAC,3643,2029,1614
Porto Belo,421350,SC,Sul,PFIZER/BIONTECH,282,282,0
Porto Calvo,270730,AL,Nordeste,FIOCRUZ/ASTRAZENECA,3963,3694,269
Porto Calvo,270730,AL,Nordeste,BUTANTAN/SINOVAC,3505,1848,1657
Porto Da Folha,280560,SE,Nordeste,BUTANTAN/SINOVAC,6150,3141,3009
Porto Da Folha,280560,SE,Nordeste,FIOCRUZ/ASTRAZENECA,3876,3876,0
Porto Da Folha,280560,SE,Nordeste,PFIZER/BIONTECH,351,351,0
Porto De Moz,150590,PA,Norte,FIOCRUZ/ASTRAZENECA,6077,4791,1286
Porto De Moz,150590,PA,Norte,BUTANTAN/SINOVAC,3596,2126,1470
Porto De Pedras,270740,AL,Nordeste,FIOCRUZ/ASTRAZENECA,1249,1161,88
Porto De Pedras,270740,AL,Nordeste,BUTANTAN/SINOVAC,1108,607,501
Porto Do Mangue,241025,RN,Nordeste,BUTANTAN/SINOVAC,847,455,392
Porto Do Mangue,241025,RN,Nordeste,FIOCRUZ/ASTRAZENECA,442,422,20
Porto Do Mangue,241025,RN,Nordeste,PFIZER/BIONTECH,48,48,0
Porto Dos Gaúchos,510680,MT,Centro-Oeste,BUTANTAN/SINOVAC,1041,547,494
Porto Dos Gaúchos,510680,MT,Centro-Oeste,FIOCRUZ/ASTRAZENECA,760,679,81
Porto Dos Gaúchos,510680,MT,Centro-Oeste,PFIZER/BIONTECH,123,123,0
Porto Esperidião,510682,MT,Centro-Oeste,BUTANTAN/SINOVAC,3123,1627,1496
Porto Esperidião,510682,MT,Centro-Oeste,FIOCRUZ/ASTRAZENECA,2054,1921,133
Porto Esperidião,510682,MT,Centro-Oeste,PFIZER/BIONTECH,18,18,0
Porto Estrela,510685,MT,Centro-Oeste,FIOCRUZ/ASTRAZENECA,1374,1341,33
Porto Estrela,510685,MT,Centro-Oeste,BUTANTAN/SINOVAC,657,333,324
Porto Estrela,510685,MT,Centro-Oeste,PFIZER/BIONTECH,15,15,0
Porto Feliz,354060,SP,Sudeste,BUTANTAN/SINOVAC,9865,5171,4694
Porto Feliz,354060,SP,Sudeste,FIOCRUZ/ASTRAZENECA,9272,8384,888
Porto Feliz,354060,SP,Sudeste,PFIZER/BIONTECH,507,507,0
Porto Ferreira,354070,SP,Sudeste,FIOCRUZ/ASTRAZENECA,13547,12704,843
Porto Ferreira,354070,SP,Sudeste,BUTANTAN/SINOVAC,12339,6645,5694
Porto Ferreira,354070,SP,Sudeste,PFIZER/BIONTECH,778,778,0
Porto Firme,315230,MG,Sudeste,BUTANTAN/SINOVAC,2337,1217,1120
Porto Firme,315230,MG,Sudeste,FIOCRUZ/ASTRAZENECA,1817,1643,174
Porto Franco,210900,MA,Nordeste,FIOCRUZ/ASTRAZENECA,5143,4838,305
Porto Franco,210900,MA,Nordeste,BUTANTAN/SINOVAC,3245,1690,1555
Porto Grande,160053,AP,Norte,BUTANTAN/SINOVAC,2519,1319,1200
Porto Grande,160053,AP,Norte,FIOCRUZ/ASTRAZENECA,1185,1135,50
Porto Grande,160053,AP,Norte,PFIZER/BIONTECH,285,285,0
Porto Lucena,431500,RS,Sul,BUTANTAN/SINOVAC,2123,1067,1056
Porto Lucena,431500,RS,Sul,FIOCRUZ/ASTRAZENECA,1592,1448,144
Porto Lucena,431500,RS,Sul,PFIZER/BIONTECH,192,192,0
Porto Mauá,431505,RS,Sul,BUTANTAN/SINOVAC,1040,547,493
Porto Mauá,431505,RS,Sul,FIOCRUZ/ASTRAZENECA,688,598,90
Porto Mauá,431505,RS,Sul,PFIZER/BIONTECH,105,105,0
Porto Murtinho,500690,MS,Centro-Oeste,FIOCRUZ/ASTRAZENECA,4224,3726,498
Porto Murtinho,500690,MS,Centro-Oeste,BUTANTAN/SINOVAC,3516,1926,1590
Porto Murtinho,500690,MS,Centro-Oeste,PFIZER/BIONTECH,550,549,1
Porto Nacional,171820,TO,Norte,FIOCRUZ/ASTRAZENECA,11306,10473,833
Porto Nacional,171820,TO,Norte,BUTANTAN/SINOVAC,9658,5020,4638
Porto Nacional,171820,TO,Norte,PFIZER/BIONTECH,2847,2839,8
Porto Real,330411,RJ,Sudeste,BUTANTAN/SINOVAC,4291,2212,2079
Porto Real,330411,RJ,Sudeste,FIOCRUZ/ASTRAZENECA,3709,3401,308
Porto Real,330411,RJ,Sudeste,PFIZER/BIONTECH,915,915,0
Porto Real Do Colégio,270750,AL,Nordeste,BUTANTAN/SINOVAC,5631,3138,2493
Porto Real Do Colégio,270750,AL,Nordeste,FIOCRUZ/ASTRAZENECA,3388,3036,352
Porto Rico,412020,PR,Sul,BUTANTAN/SINOVAC,584,298,286
Porto Rico,412020,PR,Sul,FIOCRUZ/ASTRAZENECA,518,487,31
Porto Rico Do Maranhão,210905,MA,Nordeste,FIOCRUZ/ASTRAZENECA,1919,1556,363
Porto Rico Do Maranhão,210905,MA,Nordeste,BUTANTAN/SINOVAC,1447,703,744
Porto Seguro,292530,BA,Nordeste,BUTANTAN/SINOVAC,15633,8742,6891
Porto Seguro,292530,BA,Nordeste,FIOCRUZ/ASTRAZENECA,8068,7231,837
Porto Seguro,292530,BA,Nordeste,PFIZER/BIONTECH,1258,1255,3
Porto União,421360,SC,Sul,FIOCRUZ/ASTRAZENECA,9955,9272,683
Porto União,421360,SC,Sul,BUTANTAN/SINOVAC,6993,3858,3135
Porto União,421360,SC,Sul,PFIZER/BIONTECH,450,450,0
Porto Velho,110020,RO,Norte,FIOCRUZ/ASTRAZENECA,86463,80129,6334
Porto Velho,110020,RO,Norte,BUTANTAN/SINOVAC,83777,42900,40877
Porto Velho,110020,RO,Norte,PFIZER/BIONTECH,27030,26990,40
Porto Vera Cruz,431507,RS,Sul,FIOCRUZ/ASTRAZENECA,548,492,56
Porto Vera Cruz,431507,RS,Sul,BUTANTAN/SINOVAC,537,266,271
Porto Vera Cruz,431507,RS,Sul,PFIZER/BIONTECH,74,74,0
Porto Vitória,412030,PR,Sul,FIOCRUZ/ASTRAZENECA,1161,1102,59
Porto Vitória,412030,PR,Sul,BUTANTAN/SINOVAC,998,504,494
Porto Walter,120039,AC,Norte,BUTANTAN/SINOVAC,3545,2114,1431
Porto Walter,120039,AC,Norte,FIOCRUZ/ASTRAZENECA,1042,916,126
Porto Xavier,431510,RS,Sul,BUTANTAN/SINOVAC,2912,1485,1427
Porto Xavier,431510,RS,Sul,FIOCRUZ/ASTRAZENECA,2787,2447,340
Porto Xavier,431510,RS,Sul,PFIZER/BIONTECH,395,395,0
Posse,521830,GO,Centro-Oeste,FIOCRUZ/ASTRAZENECA,9226,8514,712
Posse,521830,GO,Centro-Oeste,BUTANTAN/SINOVAC,2360,1218,1142
Posse,521830,GO,Centro-Oeste,PFIZER/BIONTECH,1634,1633,1
Poté,315240,MG,Sudeste,BUTANTAN/SINOVAC,3628,1880,1748
Poté,315240,MG,Sudeste,FIOCRUZ/ASTRAZENECA,3085,2862,223
Poté,315240,MG,Sudeste,PFIZER/BIONTECH,60,60,0
Potengi,231120,CE,Nordeste,FIOCRUZ/ASTRAZENECA,2429,2032,397
Potengi,231120,CE,Nordeste,BUTANTAN/SINOVAC,1886,920,966
Potim,354075,SP,Sudeste,BUTANTAN/SINOVAC,4208,2268,1940
Potim,354075,SP,Sudeste,FIOCRUZ/ASTRAZENECA,3772,3578,194
Potim,354075,SP,Sudeste,PFIZER/BIONTECH,6,6,0
Potiraguá,292540,BA,Nordeste,FIOCRUZ/ASTRAZENECA,2031,1928,103
Potiraguá,292540,BA,Nordeste,BUTANTAN/SINOVAC,1831,973,858
Potiraguá,292540,BA,Nordeste,PFIZER/BIONTECH,57,57,0
Potirendaba,354080,SP,Sudeste,BUTANTAN/SINOVAC,4564,2702,1862
Potirendaba,354080,SP,Sudeste,FIOCRUZ/ASTRAZENECA,4403,3976,427
Potirendaba,354080,SP,Sudeste,PFIZER/BIONTECH,355,355,0
Potiretama,231123,CE,Nordeste,BUTANTAN/SINOVAC,1291,658,633
Potiretama,231123,CE,Nordeste,FIOCRUZ/ASTRAZENECA,1046,951,95
Pouso Alegre,315250,MG,Sudeste,BUTANTAN/SINOVAC,34050,17412,16638
Pouso Alegre,315250,MG,Sudeste,FIOCRUZ/ASTRAZENECA,27820,24705,3115
Pouso Alegre,315250,MG,Sudeste,PFIZER/BIONTECH,2809,2809,0
Pouso Alto,315260,MG,Sudeste,BUTANTAN/SINOVAC,1781,898,883
Pouso Alto,315260,MG,Sudeste,FIOCRUZ/ASTRAZENECA,1506,1356,150
Pouso Alto,315260,MG,Sudeste,PFIZER/BIONTECH,59,59,0
Pouso Novo,431513,RS,Sul,BUTANTAN/SINOVAC,604,303,301
Pouso Novo,431513,RS,Sul,FIOCRUZ/ASTRAZENECA,590,523,67
Pouso Novo,431513,RS,Sul,PFIZER/BIONTECH,42,42,0
Pouso Redondo,421370,SC,Sul,BUTANTAN/SINOVAC,3135,1596,1539
Pouso Redondo,421370,SC,Sul,FIOCRUZ/ASTRAZENECA,3126,2947,179
Pouso Redondo,421370,SC,Sul,PFIZER/BIONTECH,423,423,0
Poxoréu,510700,MT,Centro-Oeste,BUTANTAN/SINOVAC,3738,2206,1532
Poxoréu,510700,MT,Centro-Oeste,FIOCRUZ/ASTRAZENECA,3494,3353,141
Poxoréu,510700,MT,Centro-Oeste,PFIZER/BIONTECH,223,223,0
Pracinha,354085,SP,Sudeste,BUTANTAN/SINOVAC,797,411,386
Pracinha,354085,SP,Sudeste,FIOCRUZ/ASTRAZENECA,687,652,35
Pracinha,354085,SP,Sudeste,PFIZER/BIONTECH,26,26,0
Pracuúba,160055,AP,Norte,BUTANTAN/SINOVAC,606,308,298
Pracuúba,160055,AP,Norte,FIOCRUZ/ASTRAZENECA,142,124,18
Pracuúba,160055,AP,Norte,PFIZER/BIONTECH,113,113,0
Prado,292550,BA,Nordeste,BUTANTAN/SINOVAC,5139,2694,2445
Prado,292550,BA,Nordeste,FIOCRUZ/ASTRAZENECA,1823,1746,77
Prado Ferreira,412033,PR,Sul,FIOCRUZ/ASTRAZENECA,1293,1234,59
Prado Ferreira,412033,PR,Sul,BUTANTAN/SINOVAC,859,467,392
Prado Ferreira,412033,PR,Sul,PFIZER/BIONTECH,16,16,0
Pradópolis,354090,SP,Sudeste,FIOCRUZ/ASTRAZENECA,4036,3837,199
Pradópolis,354090,SP,Sudeste,BUTANTAN/SINOVAC,3417,1991,1426
Pradópolis,354090,SP,Sudeste,PFIZER/BIONTECH,277,276,1
Prados,315270,MG,Sudeste,FIOCRUZ/ASTRAZENECA,2287,2116,171
Prados,315270,MG,Sudeste,BUTANTAN/SINOVAC,1707,875,832
Prados,315270,MG,Sudeste,PFIZER/BIONTECH,147,147,0
Praia Grande,354100,SP,Sudeste,FIOCRUZ/ASTRAZENECA,67584,63445,4139
Praia Grande,354100,SP,Sudeste,BUTANTAN/SINOVAC,66737,38618,28119
Praia Grande,354100,SP,Sudeste,PFIZER/BIONTECH,3429,3415,14
Praia Grande,421380,SC,Sul,FIOCRUZ/ASTRAZENECA,2017,1873,144
Praia Grande,421380,SC,Sul,BUTANTAN/SINOVAC,1811,950,861
Praia Grande,421380,SC,Sul,PFIZER/BIONTECH,111,111,0
Praia Norte,171830,TO,Norte,BUTANTAN/SINOVAC,1102,572,530
Praia Norte,171830,TO,Norte,FIOCRUZ/ASTRAZENECA,934,896,38
Prainha,150600,PA,Norte,FIOCRUZ/ASTRAZENECA,5886,4332,1554
Prainha,150600,PA,Norte,BUTANTAN/SINOVAC,1290,687,603
Pranchita,412035,PR,Sul,FIOCRUZ/ASTRAZENECA,1592,1490,102
Pranchita,412035,PR,Sul,BUTANTAN/SINOVAC,1405,723,682
Pranchita,412035,PR,Sul,PFIZER/BIONTECH,35,35,0
Prata,251220,PB,Nordeste,BUTANTAN/SINOVAC,1165,598,567
Prata,251220,PB,Nordeste,FIOCRUZ/ASTRAZENECA,844,760,84
Prata,251220,PB,Nordeste,PFIZER/BIONTECH,123,123,0
Prata,315280,MG,Sudeste,FIOCRUZ/ASTRAZENECA,6056,5368,688
Prata,315280,MG,Sudeste,BUTANTAN/SINOVAC,5346,2774,2572
Prata,315280,MG,Sudeste,PFIZER/BIONTECH,420,419,1
Prata Do Piauí,220860,PI,Nordeste,FIOCRUZ/ASTRAZENECA,1051,981,70
Prata Do Piauí,220860,PI,Nordeste,BUTANTAN/SINOVAC,1022,536,486
Pratânia,354105,SP,Sudeste,FIOCRUZ/ASTRAZENECA,977,915,62
Pratânia,354105,SP,Sudeste,BUTANTAN/SINOVAC,790,428,362
Pratânia,354105,SP,Sudeste,PFIZER/BIONTECH,101,101,0
Pratápolis,315290,MG,Sudeste,FIOCRUZ/ASTRAZENECA,2858,2653,205
Pratápolis,315290,MG,Sudeste,BUTANTAN/SINOVAC,2765,1420,1345
Pratápolis,315290,MG,Sudeste,PFIZER/BIONTECH,119,119,0
Pratinha,315300,MG,Sudeste,BUTANTAN/SINOVAC,1117,566,551
Pratinha,315300,MG,Sudeste,FIOCRUZ/ASTRAZENECA,849,771,78
Pratinha,315300,MG,Sudeste,PFIZER/BIONTECH,30,30,0
Presidente Alves,354110,SP,Sudeste,BUTANTAN/SINOVAC,1319,679,640
Presidente Alves,354110,SP,Sudeste,FIOCRUZ/ASTRAZENECA,1093,967,126
Presidente Alves,354110,SP,Sudeste,PFIZER/BIONTECH,147,147,0
Presidente Bernardes,315310,MG,Sudeste,BUTANTAN/SINOVAC,1560,808,752
Presidente Bernardes,315310,MG,Sudeste,FIOCRUZ/ASTRAZENECA,1350,1288,62
Presidente Bernardes,315310,MG,Sudeste,PFIZER/BIONTECH,91,91,0
Presidente Bernardes,354120,SP,Sudeste,BUTANTAN/SINOVAC,5324,2994,2330
Presidente Bernardes,354120,SP,Sudeste,FIOCRUZ/ASTRAZENECA,4162,3770,392
Presidente Bernardes,354120,SP,Sudeste,PFIZER/BIONTECH,274,274,0
Presidente Castello Branco,421390,SC,Sul,FIOCRUZ/ASTRAZENECA,536,478,58
Presidente Castello Branco,421390,SC,Sul,BUTANTAN/SINOVAC,536,273,263
Presidente Castello Branco,421390,SC,Sul,PFIZER/BIONTECH,25,25,0
Presidente Castelo Branco,412040,PR,Sul,FIOCRUZ/ASTRAZENECA,1421,1338,83
Presidente Castelo Branco,412040,PR,Sul,BUTANTAN/SINOVAC,1102,567,535
Presidente Castelo Branco,412040,PR,Sul,PFIZER/BIONTECH,24,24,0
Presidente Dutra,210910,MA,Nordeste,FIOCRUZ/ASTRAZENECA,9695,8797,898
Presidente Dutra,210910,MA,Nordeste,BUTANTAN/SINOVAC,8118,4436,3682
Presidente Dutra,210910,MA,Nordeste,PFIZER/BIONTECH,832,832,0
Presidente Dutra,292560,BA,Nordeste,BUTANTAN/SINOVAC,4425,2423,2002
Presidente Dutra,292560,BA,Nordeste,FIOCRUZ/ASTRAZENECA,4157,3748,409
Presidente Dutra,292560,BA,Nordeste,PFIZER/BIONTECH,281,281,0
Presidente Epitácio,354130,SP,Sudeste,FIOCRUZ/ASTRAZENECA,9656,9127,529
Presidente Epitácio,354130,SP,Sudeste,BUTANTAN/SINOVAC,9021,4719,4302
Presidente Epitácio,354130,SP,Sudeste,PFIZER/BIONTECH,1413,1413,0
Presidente Figueiredo,130353,AM,Norte,FIOCRUZ/ASTRAZENECA,5733,4789,944
Presidente Figueiredo,130353,AM,Norte,BUTANTAN/SINOVAC,4511,2604,1907
Presidente Getúlio,421400,SC,Sul,FIOCRUZ/ASTRAZENECA,3892,3559,333
Presidente Getúlio,421400,SC,Sul,BUTANTAN/SINOVAC,3305,1766,1539
Presidente Getúlio,421400,SC,Sul,PFIZER/BIONTECH,391,391,0
Presidente Jânio Quadros,292570,BA,Nordeste,BUTANTAN/SINOVAC,3672,1965,1707
Presidente Jânio Quadros,292570,BA,Nordeste,FIOCRUZ/ASTRAZENECA,2712,2394,318
Presidente Jânio Quadros,292570,BA,Nordeste,PFIZER/BIONTECH,4,3,1
Presidente Juscelino,210920,MA,Nordeste,FIOCRUZ/ASTRAZENECA,3709,3596,113
Presidente Juscelino,210920,MA,Nordeste,BUTANTAN/SINOVAC,1347,716,631
Presidente Juscelino,315320,MG,Sudeste,FIOCRUZ/ASTRAZENECA,1362,1281,81
Presidente Juscelino,315320,MG,Sudeste,BUTANTAN/SINOVAC,975,492,483
Presidente Juscelino,315320,MG,Sudeste,PFIZER/BIONTECH,28,28,0
Presidente Kennedy,171840,TO,Norte,BUTANTAN/SINOVAC,766,399,367
Presidente Kennedy,171840,TO,Norte,FIOCRUZ/ASTRAZENECA,586,559,27
Presidente Kennedy,320430,ES,Sudeste,FIOCRUZ/ASTRAZENECA,3907,3766,141
Presidente Kennedy,320430,ES,Sudeste,BUTANTAN/SINOVAC,3457,1785,1672
Presidente Kennedy,320430,ES,Sudeste,PFIZER/BIONTECH,389,389,0
Presidente Kubitschek,315330,MG,Sudeste,FIOCRUZ/ASTRAZENECA,1202,1115,87
Presidente Kubitschek,315330,MG,Sudeste,BUTANTAN/SINOVAC,783,397,386
Presidente Kubitschek,315330,MG,Sudeste,PFIZER/BIONTECH,40,40,0
Presidente Lucena,431514,RS,Sul,BUTANTAN/SINOVAC,757,380,377
Presidente Lucena,431514,RS,Sul,FIOCRUZ/ASTRAZENECA,695,632,63
Presidente Lucena,431514,RS,Sul,PFIZER/BIONTECH,120,120,0
Presidente Médici,110025,RO,Norte,FIOCRUZ/ASTRAZENECA,5319,5179,140
Presidente Médici,110025,RO,Norte,BUTANTAN/SINOVAC,3769,2331,1438
Presidente Médici,110025,RO,Norte,PFIZER/BIONTECH,513,513,0
Presidente Médici,210923,MA,Nordeste,FIOCRUZ/ASTRAZENECA,1207,1133,74
Presidente Médici,210923,MA,Nordeste,BUTANTAN/SINOVAC,1187,643,544
Presidente Nereu,421410,SC,Sul,FIOCRUZ/ASTRAZENECA,663,615,48
Presidente Nereu,421410,SC,Sul,BUTANTAN/SINOVAC,544,279,265
Presidente Nereu,421410,SC,Sul,PFIZER/BIONTECH,30,30,0
Presidente Olegário,315340,MG,Sudeste,FIOCRUZ/ASTRAZENECA,4635,4337,298
Presidente Olegário,315340,MG,Sudeste,BUTANTAN/SINOVAC,3883,1982,1901
Presidente Olegário,315340,MG,Sudeste,PFIZER/BIONTECH,569,568,1
Presidente Prudente,354140,SP,Sudeste,BUTANTAN/SINOVAC,63114,34360,28754
Presidente Prudente,354140,SP,Sudeste,FIOCRUZ/ASTRAZENECA,61575,56272,5303
Presidente Prudente,354140,SP,Sudeste,PFIZER/BIONTECH,4325,4319,6
Presidente Sarney,210927,MA,Nordeste,FIOCRUZ/ASTRAZENECA,5018,3969,1049
Presidente Sarney,210927,MA,Nordeste,BUTANTAN/SINOVAC,2284,1196,1088
Presidente Tancredo Neves,292575,BA,Nordeste,BUTANTAN/SINOVAC,4278,2132,2146
Presidente Tancredo Neves,292575,BA,Nordeste,FIOCRUZ/ASTRAZENECA,3723,3512,211
Presidente Tancredo Neves,292575,BA,Nordeste,PFIZER/BIONTECH,625,620,5
Presidente Vargas,210930,MA,Nordeste,FIOCRUZ/ASTRAZENECA,5355,5050,305
Presidente Vargas,210930,MA,Nordeste,BUTANTAN/SINOVAC,2555,1357,1198
Presidente Venceslau,354150,SP,Sudeste,BUTANTAN/SINOVAC,12044,6806,5238
Presidente Venceslau,354150,SP,Sudeste,FIOCRUZ/ASTRAZENECA,10144,9146,998
Primavera,150610,PA,Norte,FIOCRUZ/ASTRAZENECA,2364,2154,210
Primavera,150610,PA,Norte,BUTANTAN/SINOVAC,1354,794,560
Primavera,261140,PE,Nordeste,FIOCRUZ/ASTRAZENECA,2124,2059,65
Primavera,261140,PE,Nordeste,BUTANTAN/SINOVAC,1746,1112,634
Primavera,261140,PE,Nordeste,PFIZER/BIONTECH,49,49,0
Primavera De Rondônia,110147,RO,Norte,BUTANTAN/SINOVAC,940,481,459
Primavera De Rondônia,110147,RO,Norte,FIOCRUZ/ASTRAZENECA,670,637,33
Primavera De Rondônia,110147,RO,Norte,PFIZER/BIONTECH,34,34,0
Primavera Do Leste,510704,MT,Centro-Oeste,FIOCRUZ/ASTRAZENECA,11610,10812,798
Primavera Do Leste,510704,MT,Centro-Oeste,BUTANTAN/SINOVAC,9041,4724,4317
Primavera Do Leste,510704,MT,Centro-Oeste,PFIZER/BIONTECH,1912,1911,1
Primeira Cruz,210940,MA,Nordeste,FIOCRUZ/ASTRAZENECA,2700,2224,476
Primeira Cruz,210940,MA,Nordeste,BUTANTAN/SINOVAC,1888,988,900
Primeiro De Maio,412050,PR,Sul,BUTANTAN/SINOVAC,2769,1427,1342
Primeiro De Maio,412050,PR,Sul,FIOCRUZ/ASTRAZENECA,2750,2510,240
Princesa,421415,SC,Sul,FIOCRUZ/ASTRAZENECA,744,679,65
Princesa,421415,SC,Sul,BUTANTAN/SINOVAC,668,343,325
Princesa,421415,SC,Sul,PFIZER/BIONTECH,39,39,0
Princesa Isabel,251230,PB,Nordeste,BUTANTAN/SINOVAC,5632,2847,2785
Princesa Isabel,251230,PB,Nordeste,FIOCRUZ/ASTRAZENECA,4316,3844,472
Princesa Isabel,251230,PB,Nordeste,PFIZER/BIONTECH,270,270,0
Professor Jamil,521839,GO,Centro-Oeste,BUTANTAN/SINOVAC,1936,987,949
Professor Jamil,521839,GO,Centro-Oeste,FIOCRUZ/ASTRAZENECA,968,890,78
Progresso,431515,RS,Sul,BUTANTAN/SINOVAC,1850,933,917
Progresso,431515,RS,Sul,FIOCRUZ/ASTRAZENECA,1464,1323,141
Progresso,431515,RS,Sul,PFIZER/BIONTECH,263,263,0
Promissão,354160,SP,Sudeste,FIOCRUZ/ASTRAZENECA,13850,12966,884
Promissão,354160,SP,Sudeste,BUTANTAN/SINOVAC,13770,7556,6214
Promissão,354160,SP,Sudeste,PFIZER/BIONTECH,728,726,2
Propriá,280570,SE,Nordeste,BUTANTAN/SINOVAC,2987,1674,1313
Propriá,280570,SE,Nordeste,FIOCRUZ/ASTRAZENECA,2268,2192,76
Protásio Alves,431517,RS,Sul,BUTANTAN/SINOVAC,664,329,335
Protásio Alves,431517,RS,Sul,FIOCRUZ/ASTRAZENECA,643,521,122
Protásio Alves,431517,RS,Sul,PFIZER/BIONTECH,95,95,0
Prudente De Morais,315360,MG,Sudeste,FIOCRUZ/ASTRAZENECA,1636,1522,114
Prudente De Morais,315360,MG,Sudeste,BUTANTAN/SINOVAC,1475,775,700
Prudente De Morais,315360,MG,Sudeste,PFIZER/BIONTECH,85,85,0
Prudentópolis,412060,PR,Sul,FIOCRUZ/ASTRAZENECA,10645,10198,447
Prudentópolis,412060,PR,Sul,BUTANTAN/SINOVAC,9262,5000,4262
Prudentópolis,412060,PR,Sul,PFIZER/BIONTECH,534,534,0
Pugmil,171845,TO,Norte,FIOCRUZ/ASTRAZENECA,513,483,30
Pugmil,171845,TO,Norte,BUTANTAN/SINOVAC,425,222,203
Pureza,241040,RN,Nordeste,FIOCRUZ/ASTRAZENECA,3504,3380,124
Pureza,241040,RN,Nordeste,BUTANTAN/SINOVAC,3025,1809,1216
Pureza,241040,RN,Nordeste,PFIZER/BIONTECH,520,519,1
Putinga,431520,RS,Sul,BUTANTAN/SINOVAC,1386,699,687
Putinga,431520,RS,Sul,FIOCRUZ/ASTRAZENECA,1347,1173,174
Putinga,431520,RS,Sul,PFIZER/BIONTECH,168,168,0
Puxinanã,251240,PB,Nordeste,BUTANTAN/SINOVAC,2892,1463,1429
Puxinanã,251240,PB,Nordeste,FIOCRUZ/ASTRAZENECA,2172,1954,218
Puxinanã,251240,PB,Nordeste,PFIZER/BIONTECH,163,163,0
Quadra,354165,SP,Sudeste,BUTANTAN/SINOVAC,1022,599,423
Quadra,354165,SP,Sudeste,FIOCRUZ/ASTRAZENECA,845,811,34
Quadra,354165,SP,Sudeste,PFIZER/BIONTECH,81,81,0
Quaraí,431530,RS,Sul,BUTANTAN/SINOVAC,6417,3284,3133
Quaraí,431530,RS,Sul,FIOCRUZ/ASTRAZENECA,5845,5406,439
Quaraí,431530,RS,Sul,PFIZER/BIONTECH,1150,1149,1
Quartel Geral,315370,MG,Sudeste,FIOCRUZ/ASTRAZENECA,902,822,80
Quartel Geral,315370,MG,Sudeste,BUTANTAN/SINOVAC,889,461,428
Quartel Geral,315370,MG,Sudeste,PFIZER/BIONTECH,97,97,0
Quarto Centenário,412065,PR,Sul,FIOCRUZ/ASTRAZENECA,1455,1367,88
Quarto Centenário,412065,PR,Sul,BUTANTAN/SINOVAC,1037,534,503
Quarto Centenário,412065,PR,Sul,PFIZER/BIONTECH,24,24,0
Quatá,354170,SP,Sudeste,BUTANTAN/SINOVAC,3427,2066,1361
Quatá,354170,SP,Sudeste,FIOCRUZ/ASTRAZENECA,3261,3033,228
Quatá,354170,SP,Sudeste,PFIZER/BIONTECH,353,353,0
Quatiguá,412070,PR,Sul,FIOCRUZ/ASTRAZENECA,2220,2059,161
Quatiguá,412070,PR,Sul,BUTANTAN/SINOVAC,2192,1128,1064
Quatiguá,412070,PR,Sul,PFIZER/BIONTECH,106,106,0
Quatipuru,150611,PA,Norte,FIOCRUZ/ASTRAZENECA,1829,1684,145
Quatipuru,150611,PA,Norte,BUTANTAN/SINOVAC,1601,846,755
Quatis,330412,RJ,Sudeste,FIOCRUZ/ASTRAZENECA,3698,3397,301
Quatis,330412,RJ,Sudeste,BUTANTAN/SINOVAC,2728,1439,1289
Quatro Barras,412080,PR,Sul,FIOCRUZ/ASTRAZENECA,5262,5059,203
Quatro Barras,412080,PR,Sul,BUTANTAN/SINOVAC,3495,1811,1684
Quatro Barras,412080,PR,Sul,PFIZER/BIONTECH,264,264,0
Quatro Irmãos,431531,RS,Sul,BUTANTAN/SINOVAC,475,239,236
Quatro Irmãos,431531,RS,Sul,FIOCRUZ/ASTRAZENECA,423,391,32
Quatro Irmãos,431531,RS,Sul,PFIZER/BIONTECH,71,71,0
Quatro Pontes,412085,PR,Sul,FIOCRUZ/ASTRAZENECA,1150,1069,81
Quatro Pontes,412085,PR,Sul,BUTANTAN/SINOVAC,1059,552,507
Quatro Pontes,412085,PR,Sul,PFIZER/BIONTECH,10,10,0
Quebrangulo,270760,AL,Nordeste,FIOCRUZ/ASTRAZENECA,2422,2090,332
Quebrangulo,270760,AL,Nordeste,BUTANTAN/SINOVAC,1886,947,939
Quedas Do Iguaçu,412090,PR,Sul,FIOCRUZ/ASTRAZENECA,8123,7792,331
Quedas Do Iguaçu,412090,PR,Sul,BUTANTAN/SINOVAC,6245,3263,2982
Quedas Do Iguaçu,412090,PR,Sul,PFIZER/BIONTECH,927,926,1
Queimada Nova,220865,PI,Nordeste,FIOCRUZ/ASTRAZENECA,1617,1539,78
Queimada Nova,220865,PI,Nordeste,BUTANTAN/SINOVAC,1400,712,688
Queimadas,251250,PB,Nordeste,FIOCRUZ/ASTRAZENECA,8371,7215,1156
Queimadas,251250,PB,Nordeste,BUTANTAN/SINOVAC,7251,3778,3473
Queimadas,251250,PB,Nordeste,PFIZER/BIONTECH,619,619,0
Queimadas,292580,BA,Nordeste,BUTANTAN/SINOVAC,5179,2714,2465
Queimadas,292580,BA,Nordeste,FIOCRUZ/ASTRAZENECA,4448,4055,393
Queimadas,292580,BA,Nordeste,PFIZER/BIONTECH,367,367,0
Queimados,330414,RJ,Sudeste,BUTANTAN/SINOVAC,21264,10989,10275
Queimados,330414,RJ,Sudeste,FIOCRUZ/ASTRAZENECA,18621,17572,1049
Queimados,330414,RJ,Sudeste,PFIZER/BIONTECH,177,177,0
Queiroz,354180,SP,Sudeste,BUTANTAN/SINOVAC,810,455,355
Queiroz,354180,SP,Sudeste,FIOCRUZ/ASTRAZENECA,637,582,55
Queiroz,354180,SP,Sudeste,PFIZER/BIONTECH,91,91,0
Queluz,354190,SP,Sudeste,BUTANTAN/SINOVAC,2320,1296,1024
Queluz,354190,SP,Sudeste,FIOCRUZ/ASTRAZENECA,1985,1885,100
Queluz,354190,SP,Sudeste,PFIZER/BIONTECH,127,127,0
Queluzito,315380,MG,Sudeste,BUTANTAN/SINOVAC,717,385,332
Queluzito,315380,MG,Sudeste,FIOCRUZ/ASTRAZENECA,578,520,58
Queluzito,315380,MG,Sudeste,PFIZER/BIONTECH,4,4,0
Querência,510706,MT,Centro-Oeste,BUTANTAN/SINOVAC,1910,1020,890
Querência,510706,MT,Centro-Oeste,FIOCRUZ/ASTRAZENECA,1705,1526,179
Querência,510706,MT,Centro-Oeste,PFIZER/BIONTECH,45,45,0
Querência Do Norte,412100,PR,Sul,FIOCRUZ/ASTRAZENECA,4090,3873,217
Querência Do Norte,412100,PR,Sul,BUTANTAN/SINOVAC,2445,1263,1182
Querência Do Norte,412100,PR,Sul,PFIZER/BIONTECH,155,155,0
Quevedos,431532,RS,Sul,FIOCRUZ/ASTRAZENECA,774,727,47
Quevedos,431532,RS,Sul,BUTANTAN/SINOVAC,615,344,271
Quevedos,431532,RS,Sul,PFIZER/BIONTECH,115,115,0
Quijingue,292590,BA,Nordeste,BUTANTAN/SINOVAC,5907,3087,2820
Quijingue,292590,BA,Nordeste,FIOCRUZ/ASTRAZENECA,5263,4729,534
Quijingue,292590,BA,Nordeste,PFIZER/BIONTECH,793,792,1
Quilombo,421420,SC,Sul,BUTANTAN/SINOVAC,3696,2220,1476
Quilombo,421420,SC,Sul,FIOCRUZ/ASTRAZENECA,3685,3402,283
Quilombo,421420,SC,Sul,PFIZER/BIONTECH,240,240,0
Quinta Do Sol,412110,PR,Sul,FIOCRUZ/ASTRAZENECA,1448,1361,87
Quinta Do Sol,412110,PR,Sul,BUTANTAN/SINOVAC,1252,653,599
Quinta Do Sol,412110,PR,Sul,PFIZER/BIONTECH,24,24,0
Quintana,354200,SP,Sudeste,BUTANTAN/SINOVAC,2108,1155,953
Quintana,354200,SP,Sudeste,FIOCRUZ/ASTRAZENECA,1743,1576,167
Quintana,354200,SP,Sudeste,PFIZER/BIONTECH,220,220,0
Quinze De Novembro,431535,RS,Sul,BUTANTAN/SINOVAC,1411,726,685
Quinze De Novembro,431535,RS,Sul,FIOCRUZ/ASTRAZENECA,998,912,86
Quinze De Novembro,431535,RS,Sul,PFIZER/BIONTECH,120,120,0
Quipapá,261150,PE,Nordeste,FIOCRUZ/ASTRAZENECA,4044,3618,426
Quipapá,261150,PE,Nordeste,BUTANTAN/SINOVAC,3215,1610,1605
Quipapá,261150,PE,Nordeste,PFIZER/BIONTECH,183,183,0
Quirinópolis,521850,GO,Centro-Oeste,FIOCRUZ/ASTRAZENECA,12548,12055,493
Quirinópolis,521850,GO,Centro-Oeste,BUTANTAN/SINOVAC,8911,4705,4206
Quissamã,330415,RJ,Sudeste,BUTANTAN/SINOVAC,5896,3223,2673
Quissamã,330415,RJ,Sudeste,FIOCRUZ/ASTRAZENECA,3847,3311,536
Quitandinha,412120,PR,Sul,BUTANTAN/SINOVAC,4105,2258,1847
Quitandinha,412120,PR,Sul,FIOCRUZ/ASTRAZENECA,3763,3621,142
Quitandinha,412120,PR,Sul,PFIZER/BIONTECH,184,184,0
Quiterianópolis,231126,CE,Nordeste,BUTANTAN/SINOVAC,5307,2926,2381
Quiterianópolis,231126,CE,Nordeste,FIOCRUZ/ASTRAZENECA,3259,2928,331
Quiterianópolis,231126,CE,Nordeste,PFIZER/BIONTECH,9,9,0
Quixaba,251260,PB,Nordeste,BUTANTAN/SINOVAC,759,420,339
Quixaba,251260,PB,Nordeste,FIOCRUZ/ASTRAZENECA,369,337,32
Quixaba,251260,PB,Nordeste,PFIZER/BIONTECH,46,46,0
Quixaba,261153,PE,Nordeste,FIOCRUZ/ASTRAZENECA,1806,1540,266
Quixaba,261153,PE,Nordeste,BUTANTAN/SINOVAC,1558,831,727
Quixaba,261153,PE,Nordeste,PFIZER/BIONTECH,100,100,0
Quixabeira,292593,BA,Nordeste,BUTANTAN/SINOVAC,3286,1941,1345
Quixabeira,292593,BA,Nordeste,FIOCRUZ/ASTRAZENECA,3121,3000,121
Quixabeira,292593,BA,Nordeste,PFIZER/BIONTECH,43,43,0
Quixadá,231130,CE,Nordeste,BUTANTAN/SINOVAC,3543,2809,734
Quixadá,231130,CE,Nordeste,FIOCRUZ/ASTRAZENECA,2422,2412,10
Quixelô,231135,CE,Nordeste,BUTANTAN/SINOVAC,4488,2584,1904
Quixelô,231135,CE,Nordeste,FIOCRUZ/ASTRAZENECA,2753,2386,367
Quixeramobim,231140,CE,Nordeste,BUTANTAN/SINOVAC,12032,6426,5606
Quixeramobim,231140,CE,Nordeste,FIOCRUZ/ASTRAZENECA,6103,5480,623
Quixeramobim,231140,CE,Nordeste,PFIZER/BIONTECH,1,1,0
Quixeré,231150,CE,Nordeste,BUTANTAN/SINOVAC,3265,1647,1618
Quixeré,231150,CE,Nordeste,FIOCRUZ/ASTRAZENECA,1682,1424,258
Rafael Fernandes,241050,RN,Nordeste,BUTANTAN/SINOVAC,1473,745,728
Rafael Fernandes,241050,RN,Nordeste,FIOCRUZ/ASTRAZENECA,1268,1207,61
Rafael Fernandes,241050,RN,Nordeste,PFIZER/BIONTECH,161,161,0
Rafael Godeiro,241060,RN,Nordeste,BUTANTAN/SINOVAC,877,434,443
Rafael Godeiro,241060,RN,Nordeste,FIOCRUZ/ASTRAZENECA,789,738,51
Rafael Godeiro,241060,RN,Nordeste,PFIZER/BIONTECH,29,29,0
Rafael Jambeiro,292595,BA,Nordeste,FIOCRUZ/ASTRAZENECA,5212,4716,496
Rafael Jambeiro,292595,BA,Nordeste,BUTANTAN/SINOVAC,4754,2376,2378
Rafael Jambeiro,292595,BA,Nordeste,PFIZER/BIONTECH,633,633,0
Rafard,354210,SP,Sudeste,BUTANTAN/SINOVAC,2013,1167,846
Rafard,354210,SP,Sudeste,FIOCRUZ/ASTRAZENECA,1882,1706,176
Rafard,354210,SP,Sudeste,PFIZER/BIONTECH,231,231,0
Ramilândia,412125,PR,Sul,FIOCRUZ/ASTRAZENECA,975,940,35
Ramilândia,412125,PR,Sul,BUTANTAN/SINOVAC,803,446,357
Rancharia,354220,SP,Sudeste,FIOCRUZ/ASTRAZENECA,8452,7751,701
Rancharia,354220,SP,Sudeste,BUTANTAN/SINOVAC,7549,4444,3105
Rancharia,354220,SP,Sudeste,PFIZER/BIONTECH,852,852,0
Rancho Alegre,412130,PR,Sul,FIOCRUZ/ASTRAZENECA,1375,1284,91
Rancho Alegre,412130,PR,Sul,BUTANTAN/SINOVAC,1161,603,558
Rancho Alegre,412130,PR,Sul,PFIZER/BIONTECH,17,17,0
Rancho Alegre D'Oeste,412135,PR,Sul,FIOCRUZ/ASTRAZENECA,1214,1142,72
Rancho Alegre D'Oeste,412135,PR,Sul,BUTANTAN/SINOVAC,693,351,342
Rancho Queimado,421430,SC,Sul,BUTANTAN/SINOVAC,1295,734,561
Rancho Queimado,421430,SC,Sul,FIOCRUZ/ASTRAZENECA,1013,877,136
Rancho Queimado,421430,SC,Sul,PFIZER/BIONTECH,75,75,0
Raposa,210945,MA,Nordeste,FIOCRUZ/ASTRAZENECA,11756,11520,236
Raposa,210945,MA,Nordeste,BUTANTAN/SINOVAC,2997,1551,1446
Raposa,210945,MA,Nordeste,PFIZER/BIONTECH,1783,1783,0
Raposos,315390,MG,Sudeste,FIOCRUZ/ASTRAZENECA,1596,1387,209
Raposos,315390,MG,Sudeste,BUTANTAN/SINOVAC,240,83,157
Raposos,315390,MG,Sudeste,PFIZER/BIONTECH,125,125,0
Raul Soares,315400,MG,Sudeste,FIOCRUZ/ASTRAZENECA,5930,5425,505
Raul Soares,315400,MG,Sudeste,BUTANTAN/SINOVAC,5829,3055,2774
Raul Soares,315400,MG,Sudeste,PFIZER/BIONTECH,304,304,0
Realeza,412140,PR,Sul,FIOCRUZ/ASTRAZENECA,4228,3997,231
Realeza,412140,PR,Sul,BUTANTAN/SINOVAC,3780,1928,1852
Realeza,412140,PR,Sul,PFIZER/BIONTECH,658,657,1
Rebouças,412150,PR,Sul,FIOCRUZ/ASTRAZENECA,3097,2927,170
Rebouças,412150,PR,Sul,BUTANTAN/SINOVAC,2844,1508,1336
Rebouças,412150,PR,Sul,PFIZER/BIONTECH,186,186,0
Recife,261160,PE,Nordeste,BUTANTAN/SINOVAC,455547,232507,223040
Recife,261160,PE,Nordeste,FIOCRUZ/ASTRAZENECA,230315,197991,32324
Recife,261160,PE,Nordeste,PFIZER/BIONTECH,14672,14667,5
Recreio,315410,MG,Sudeste,BUTANTAN/SINOVAC,3258,1717,1541
Recreio,315410,MG,Sudeste,FIOCRUZ/ASTRAZENECA,2657,2407,250
Recreio,315410,MG,Sudeste,PFIZER/BIONTECH,390,389,1
Recursolândia,171850,TO,Norte,BUTANTAN/SINOVAC,616,335,281
Recursolândia,171850,TO,Norte,FIOCRUZ/ASTRAZENECA,437,419,18
Redenção,150613,PA,Norte,FIOCRUZ/ASTRAZENECA,12737,9820,2917
Redenção,150613,PA,Norte,BUTANTAN/SINOVAC,9788,5383,4405
Redenção,231160,CE,Nordeste,BUTANTAN/SINOVAC,3458,1921,1537
Redenção,231160,CE,Nordeste,FIOCRUZ/ASTRAZENECA,1624,1418,206
Redenção Da Serra,354230,SP,Sudeste,BUTANTAN/SINOVAC,1142,643,499
Redenção Da Serra,354230,SP,Sudeste,FIOCRUZ/ASTRAZENECA,845,770,75
Redenção Da Serra,354230,SP,Sudeste,PFIZER/BIONTECH,61,61,0
Redenção Do Gurguéia,220870,PI,Nordeste,FIOCRUZ/ASTRAZENECA,1181,1109,72
Redenção Do Gurguéia,220870,PI,Nordeste,BUTANTAN/SINOVAC,1122,567,555
Redentora,431540,RS,Sul,BUTANTAN/SINOVAC,5145,2840,2305
Redentora,431540,RS,Sul,FIOCRUZ/ASTRAZENECA,1483,1245,238
Redentora,431540,RS,Sul,PFIZER/BIONTECH,363,363,0
Reduto,315415,MG,Sudeste,BUTANTAN/SINOVAC,1331,690,641
Reduto,315415,MG,Sudeste,FIOCRUZ/ASTRAZENECA,1144,1033,111
Reduto,315415,MG,Sudeste,PFIZER/BIONTECH,71,70,1
Regeneração,220880,PI,Nordeste,BUTANTAN/SINOVAC,3044,1602,1442
Regeneração,220880,PI,Nordeste,FIOCRUZ/ASTRAZENECA,2445,2268,177
Regente Feijó,354240,SP,Sudeste,FIOCRUZ/ASTRAZENECA,5154,4778,376
Regente Feijó,354240,SP,Sudeste,BUTANTAN/SINOVAC,5037,2885,2152
Regente Feijó,354240,SP,Sudeste,PFIZER/BIONTECH,555,555,0
Reginópolis,354250,SP,Sudeste,BUTANTAN/SINOVAC,2121,1192,929
Reginópolis,354250,SP,Sudeste,FIOCRUZ/ASTRAZENECA,1966,1813,153
Reginópolis,354250,SP,Sudeste,PFIZER/BIONTECH,178,178,0
Registro,354260,SP,Sudeste,BUTANTAN/SINOVAC,16741,8881,7860
Registro,354260,SP,Sudeste,FIOCRUZ/ASTRAZENECA,14990,14077,913
Registro,354260,SP,Sudeste,PFIZER/BIONTECH,943,943,0
Relvado,431545,RS,Sul,BUTANTAN/SINOVAC,969,486,483
Relvado,431545,RS,Sul,FIOCRUZ/ASTRAZENECA,600,501,99
Relvado,431545,RS,Sul,PFIZER/BIONTECH,33,33,0
Remanso,292600,BA,Nordeste,BUTANTAN/SINOVAC,9087,5433,3654
Remanso,292600,BA,Nordeste,FIOCRUZ/ASTRAZENECA,8746,7658,1088
Remanso,292600,BA,Nordeste,PFIZER/BIONTECH,392,384,8
Remígio,251270,PB,Nordeste,BUTANTAN/SINOVAC,4893,2506,2387
Remígio,251270,PB,Nordeste,FIOCRUZ/ASTRAZENECA,2366,2087,279
Remígio,251270,PB,Nordeste,PFIZER/BIONTECH,80,80,0
Renascença,412160,PR,Sul,FIOCRUZ/ASTRAZENECA,1985,1874,111
Renascença,412160,PR,Sul,BUTANTAN/SINOVAC,1352,700,652
Renascença,412160,PR,Sul,PFIZER/BIONTECH,17,17,0
Reriutaba,231170,CE,Nordeste,FIOCRUZ/ASTRAZENECA,5223,4829,394
Reriutaba,231170,CE,Nordeste,BUTANTAN/SINOVAC,4008,2119,1889
Reriutaba,231170,CE,Nordeste,PFIZER/BIONTECH,132,132,0
Resende,330420,RJ,Sudeste,FIOCRUZ/ASTRAZENECA,31129,28626,2503
Resende,330420,RJ,Sudeste,BUTANTAN/SINOVAC,29633,15793,13840
Resende,330420,RJ,Sudeste,PFIZER/BIONTECH,2409,2409,0
Resende Costa,315420,MG,Sudeste,FIOCRUZ/ASTRAZENECA,2975,2725,250
Resende Costa,315420,MG,Sudeste,BUTANTAN/SINOVAC,2885,1451,1434
Resende Costa,315420,MG,Sudeste,PFIZER/BIONTECH,69,69,0
Reserva,412170,PR,Sul,FIOCRUZ/ASTRAZENECA,5197,5069,128
Reserva,412170,PR,Sul,BUTANTAN/SINOVAC,4112,2173,1939
Reserva,412170,PR,Sul,PFIZER/BIONTECH,572,572,0
Reserva Do Cabaçal,510715,MT,Centro-Oeste,FIOCRUZ/ASTRAZENECA,727,685,42
Reserva Do Cabaçal,510715,MT,Centro-Oeste,BUTANTAN/SINOVAC,556,282,274
Reserva Do Cabaçal,510715,MT,Centro-Oeste,PFIZER/BIONTECH,6,6,0
Reserva Do Iguaçu,412175,PR,Sul,FIOCRUZ/ASTRAZENECA,1877,1811,66
Reserva Do Iguaçu,412175,PR,Sul,BUTANTAN/SINOVAC,1155,611,544
Reserva Do Iguaçu,412175,PR,Sul,PFIZER/BIONTECH,29,29,0
Resplendor,315430,MG,Sudeste,BUTANTAN/SINOVAC,5073,2570,2503
Resplendor,315430,MG,Sudeste,FIOCRUZ/ASTRAZENECA,3485,3206,279
Resplendor,315430,MG,Sudeste,PFIZER/BIONTECH,325,325,0
Ressaquinha,315440,MG,Sudeste,FIOCRUZ/ASTRAZENECA,1097,1090,7
Ressaquinha,315440,MG,Sudeste,BUTANTAN/SINOVAC,993,527,466
Ressaquinha,315440,MG,Sudeste,PFIZER/BIONTECH,11,11,0
Restinga,354270,SP,Sudeste,FIOCRUZ/ASTRAZENECA,1709,1607,102
Restinga,354270,SP,Sudeste,BUTANTAN/SINOVAC,1358,691,667
Restinga,354270,SP,Sudeste,PFIZER/BIONTECH,142,142,0
Restinga Seca,431550,RS,Sul,FIOCRUZ/ASTRAZENECA,5235,4726,509
Restinga Seca,431550,RS,Sul,BUTANTAN/SINOVAC,4105,2010,2095
Restinga Seca,431550,RS,Sul,PFIZER/BIONTECH,571,571,0
Retirolândia,292610,BA,Nordeste,FIOCRUZ/ASTRAZENECA,3336,2855,481
Retirolândia,292610,BA,Nordeste,BUTANTAN/SINOVAC,3048,1597,1451
Retirolândia,292610,BA,Nordeste,PFIZER/BIONTECH,464,463,1
Riachão,210950,MA,Nordeste,FIOCRUZ/ASTRAZENECA,3415,3217,198
Riachão,210950,MA,Nordeste,BUTANTAN/SINOVAC,3032,1558,1474
Riachão,251274,PB,Nordeste,BUTANTAN/SINOVAC,851,441,410
Riachão,251274,PB,Nordeste,FIOCRUZ/ASTRAZENECA,559,500,59
Riachão,251274,PB,Nordeste,PFIZER/BIONTECH,53,53,0
Riachão Das Neves,292620,BA,Nordeste,FIOCRUZ/ASTRAZENECA,4460,4127,333
Riachão Das Neves,292620,BA,Nordeste,BUTANTAN/SINOVAC,3825,2009,1816
Riachão Das Neves,292620,BA,Nordeste,PFIZER/BIONTECH,162,162,0
Riachão Do Bacamarte,251275,PB,Nordeste,FIOCRUZ/ASTRAZENECA,1115,1039,76
Riachão Do Bacamarte,251275,PB,Nordeste,BUTANTAN/SINOVAC,1025,544,481
Riachão Do Bacamarte,251275,PB,Nordeste,PFIZER/BIONTECH,82,82,0
Riachão Do Dantas,280580,SE,Nordeste,BUTANTAN/SINOVAC,3799,1990,1809
Riachão Do Dantas,280580,SE,Nordeste,FIOCRUZ/ASTRAZENECA,2945,2754,191
Riachão Do Dantas,280580,SE,Nordeste,PFIZER/BIONTECH,306,306,0
Riachão Do Jacuípe,292630,BA,Nordeste,BUTANTAN/SINOVAC,7950,4016,3934
Riachão Do Jacuípe,292630,BA,Nordeste,FIOCRUZ/ASTRAZENECA,7207,6295,912
Riachão Do Jacuípe,292630,BA,Nordeste,PFIZER/BIONTECH,1029,1029,0
Riachão Do Poço,251276,PB,Nordeste,BUTANTAN/SINOVAC,809,465,344
Riachão Do Poço,251276,PB,Nordeste,FIOCRUZ/ASTRAZENECA,528,467,61
Riachão Do Poço,251276,PB,Nordeste,PFIZER/BIONTECH,8,8,0
Riachinho,171855,TO,Norte,BUTANTAN/SINOVAC,960,494,466
Riachinho,171855,TO,Norte,FIOCRUZ/ASTRAZENECA,788,760,28
Riachinho,315445,MG,Sudeste,BUTANTAN/SINOVAC,2338,1315,1023
Riachinho,315445,MG,Sudeste,FIOCRUZ/ASTRAZENECA,1477,1340,137
Riachinho,315445,MG,Sudeste,PFIZER/BIONTECH,227,227,0
Riacho Da Cruz,241070,RN,Nordeste,BUTANTAN/SINOVAC,1156,587,569
Riacho Da Cruz,241070,RN,Nordeste,FIOCRUZ/ASTRAZENECA,702,654,48
Riacho Da Cruz,241070,RN,Nordeste,PFIZER/BIONTECH,87,87,0
Riacho Das Almas,261170,PE,Nordeste,FIOCRUZ/ASTRAZENECA,4491,4126,365
Riacho Das Almas,261170,PE,Nordeste,BUTANTAN/SINOVAC,3854,1955,1899
Riacho Das Almas,261170,PE,Nordeste,PFIZER/BIONTECH,228,228,0
Riacho De Santana,241080,RN,Nordeste,BUTANTAN/SINOVAC,317,216,101
Riacho De Santana,241080,RN,Nordeste,FIOCRUZ/ASTRAZENECA,196,196,0
Riacho De Santana,292640,BA,Nordeste,FIOCRUZ/ASTRAZENECA,6483,6123,360
Riacho De Santana,292640,BA,Nordeste,BUTANTAN/SINOVAC,6124,3182,2942
Riacho De Santo Antônio,251278,PB,Nordeste,BUTANTAN/SINOVAC,481,263,218
Riacho De Santo Antônio,251278,PB,Nordeste,FIOCRUZ/ASTRAZENECA,327,300,27
Riacho De Santo Antônio,251278,PB,Nordeste,PFIZER/BIONTECH,36,36,0
Riacho Dos Cavalos,251280,PB,Nordeste,BUTANTAN/SINOVAC,1913,989,924
Riacho Dos Cavalos,251280,PB,Nordeste,FIOCRUZ/ASTRAZENECA,1909,1760,149
Riacho Dos Cavalos,251280,PB,Nordeste,PFIZER/BIONTECH,254,254,0
Riacho Dos Machados,315450,MG,Sudeste,FIOCRUZ/ASTRAZENECA,845,824,21
Riacho Dos Machados,315450,MG,Sudeste,BUTANTAN/SINOVAC,775,429,346
Riacho Frio,220885,PI,Nordeste,FIOCRUZ/ASTRAZENECA,703,665,38
Riacho Frio,220885,PI,Nordeste,BUTANTAN/SINOVAC,480,247,233
Riachuelo,241090,RN,Nordeste,FIOCRUZ/ASTRAZENECA,2176,2033,143
Riachuelo,241090,RN,Nordeste,BUTANTAN/SINOVAC,1887,960,927
Riachuelo,241090,RN,Nordeste,PFIZER/BIONTECH,394,393,1
Riachuelo,280590,SE,Nordeste,FIOCRUZ/ASTRAZENECA,1786,1720,66
Riachuelo,280590,SE,Nordeste,BUTANTAN/SINOVAC,1634,883,751
Riachuelo,280590,SE,Nordeste,PFIZER/BIONTECH,155,155,0
Rialma,521860,GO,Centro-Oeste,FIOCRUZ/ASTRAZENECA,3022,2749,273
Rialma,521860,GO,Centro-Oeste,BUTANTAN/SINOVAC,1740,894,846
Rianápolis,521870,GO,Centro-Oeste,FIOCRUZ/ASTRAZENECA,1452,1295,157
Rianápolis,521870,GO,Centro-Oeste,BUTANTAN/SINOVAC,676,373,303
Rianápolis,521870,GO,Centro-Oeste,PFIZER/BIONTECH,72,72,0
Ribamar Fiquene,210955,MA,Nordeste,FIOCRUZ/ASTRAZENECA,1380,1272,108
Ribamar Fiquene,210955,MA,Nordeste,BUTANTAN/SINOVAC,1175,677,498
Ribas Do Rio Pardo,500710,MS,Centro-Oeste,FIOCRUZ/ASTRAZENECA,4548,4149,399
Ribas Do Rio Pardo,500710,MS,Centro-Oeste,BUTANTAN/SINOVAC,3197,1724,1473
Ribas Do Rio Pardo,500710,MS,Centro-Oeste,PFIZER/BIONTECH,821,821,0
Ribeira,354280,SP,Sudeste,BUTANTAN/SINOVAC,832,432,400
Ribeira,354280,SP,Sudeste,FIOCRUZ/ASTRAZENECA,576,511,65
Ribeira,354280,SP,Sudeste,PFIZER/BIONTECH,101,101,0
Ribeira Do Amparo,292650,BA,Nordeste,FIOCRUZ/ASTRAZENECA,3412,3191,221
Ribeira Do Amparo,292650,BA,Nordeste,BUTANTAN/SINOVAC,2841,1564,1277
Ribeira Do Amparo,292650,BA,Nordeste,PFIZER/BIONTECH,170,170,0
Ribeira Do Piauí,220887,PI,Nordeste,FIOCRUZ/ASTRAZENECA,843,798,45
Ribeira Do Piauí,220887,PI,Nordeste,BUTANTAN/SINOVAC,611,332,279
Ribeira Do Piauí,220887,PI,Nordeste,PFIZER/BIONTECH,96,96,0
Ribeira Do Pombal,292660,BA,Nordeste,FIOCRUZ/ASTRAZENECA,11936,10516,1420
Ribeira Do Pombal,292660,BA,Nordeste,BUTANTAN/SINOVAC,9857,5090,4767
Ribeira Do Pombal,292660,BA,Nordeste,PFIZER/BIONTECH,1030,1029,1
Ribeirão,261180,PE,Nordeste,BUTANTAN/SINOVAC,7513,3907,3606
Ribeirão,261180,PE,Nordeste,FIOCRUZ/ASTRAZENECA,7038,6483,555
Ribeirão,261180,PE,Nordeste,PFIZER/BIONTECH,163,163,0
Ribeirão Bonito,354290,SP,Sudeste,FIOCRUZ/ASTRAZENECA,3122,2889,233
Ribeirão Bonito,354290,SP,Sudeste,BUTANTAN/SINOVAC,3119,1756,1363
Ribeirão Bonito,354290,SP,Sudeste,PFIZER/BIONTECH,221,220,1
Ribeirão Branco,354300,SP,Sudeste,FIOCRUZ/ASTRAZENECA,3535,3347,188
Ribeirão Branco,354300,SP,Sudeste,BUTANTAN/SINOVAC,3325,1923,1402
Ribeirão Branco,354300,SP,Sudeste,PFIZER/BIONTECH,450,450,0
Ribeirão Cascalheira,510718,MT,Centro-Oeste,FIOCRUZ/ASTRAZENECA,2139,2028,111
Ribeirão Cascalheira,510718,MT,Centro-Oeste,BUTANTAN/SINOVAC,1569,799,770
Ribeirão Cascalheira,510718,MT,Centro-Oeste,PFIZER/BIONTECH,177,177,0
Ribeirão Claro,412180,PR,Sul,BUTANTAN/SINOVAC,2826,1647,1179
Ribeirão Claro,412180,PR,Sul,FIOCRUZ/ASTRAZENECA,2375,2253,122
Ribeirão Claro,412180,PR,Sul,PFIZER/BIONTECH,24,24,0
Ribeirão Corrente,354310,SP,Sudeste,BUTANTAN/SINOVAC,1538,952,586
Ribeirão Corrente,354310,SP,Sudeste,FIOCRUZ/ASTRAZENECA,1118,1018,100
Ribeirão Corrente,354310,SP,Sudeste,PFIZER/BIONTECH,118,117,1
Ribeirão Das Neves,315460,MG,Sudeste,BUTANTAN/SINOVAC,42923,23224,19699
Ribeirão Das Neves,315460,MG,Sudeste,FIOCRUZ/ASTRAZENECA,36312,34697,1615
Ribeirão Das Neves,315460,MG,Sudeste,PFIZER/BIONTECH,1057,1056,1
Ribeirão Do Largo,292665,BA,Nordeste,BUTANTAN/SINOVAC,1119,619,500
Ribeirão Do Largo,292665,BA,Nordeste,FIOCRUZ/ASTRAZENECA,743,678,65
Ribeirão Do Largo,292665,BA,Nordeste,PFIZER/BIONTECH,19,19,0
Ribeirão Do Pinhal,412190,PR,Sul,FIOCRUZ/ASTRAZENECA,3869,3629,240
Ribeirão Do Pinhal,412190,PR,Sul,BUTANTAN/SINOVAC,3167,1623,1544
Ribeirão Do Pinhal,412190,PR,Sul,PFIZER/BIONTECH,177,177,0
Ribeirão Do Sul,354320,SP,Sudeste,BUTANTAN/SINOVAC,1331,736,595
Ribeirão Do Sul,354320,SP,Sudeste,FIOCRUZ/ASTRAZENECA,1224,1130,94
Ribeirão Do Sul,354320,SP,Sudeste,PFIZER/BIONTECH,93,93,0
Ribeirão Dos Índios,354323,SP,Sudeste,BUTANTAN/SINOVAC,972,516,456
Ribeirão Dos Índios,354323,SP,Sudeste,FIOCRUZ/ASTRAZENECA,811,698,113
Ribeirão Dos Índios,354323,SP,Sudeste,PFIZER/BIONTECH,78,78,0
Ribeirão Grande,354325,SP,Sudeste,FIOCRUZ/ASTRAZENECA,2737,2626,111
Ribeirão Grande,354325,SP,Sudeste,BUTANTAN/SINOVAC,2348,1300,1048
Ribeirão Grande,354325,SP,Sudeste,PFIZER/BIONTECH,263,263,0
Ribeirão Pires,354330,SP,Sudeste,FIOCRUZ/ASTRAZENECA,23964,22313,1651
Ribeirão Pires,354330,SP,Sudeste,BUTANTAN/SINOVAC,23406,12135,11271
Ribeirão Pires,354330,SP,Sudeste,PFIZER/BIONTECH,90,90,0
Ribeirão Preto,354340,SP,Sudeste,FIOCRUZ/ASTRAZENECA,192504,178774,13730
Ribeirão Preto,354340,SP,Sudeste,BUTANTAN/SINOVAC,172145,88778,83367
Ribeirão Preto,354340,SP,Sudeste,PFIZER/BIONTECH,10200,10185,15
Ribeirão Vermelho,315470,MG,Sudeste,FIOCRUZ/ASTRAZENECA,887,808,79
Ribeirão Vermelho,315470,MG,Sudeste,BUTANTAN/SINOVAC,629,468,161
Ribeirão Vermelho,315470,MG,Sudeste,PFIZER/BIONTECH,71,71,0
Ribeirãozinho,510719,MT,Centro-Oeste,BUTANTAN/SINOVAC,872,503,369
Ribeirãozinho,510719,MT,Centro-Oeste,FIOCRUZ/ASTRAZENECA,810,762,48
Ribeirãozinho,510719,MT,Centro-Oeste,PFIZER/BIONTECH,76,76,0
Ribeiro Gonçalves,220890,PI,Nordeste,FIOCRUZ/ASTRAZENECA,1316,1198,118
Ribeiro Gonçalves,220890,PI,Nordeste,BUTANTAN/SINOVAC,693,364,329
Ribeiro Gonçalves,220890,PI,Nordeste,PFIZER/BIONTECH,90,90,0
Ribeirópolis,280600,SE,Nordeste,BUTANTAN/SINOVAC,4803,2452,2351
Ribeirópolis,280600,SE,Nordeste,FIOCRUZ/ASTRAZENECA,3353,3342,11
Ribeirópolis,280600,SE,Nordeste,PFIZER/BIONTECH,454,454,0
Rifaina,354360,SP,Sudeste,BUTANTAN/SINOVAC,1085,611,474
Rifaina,354360,SP,Sudeste,FIOCRUZ/ASTRAZENECA,1050,949,101
Rifaina,354360,SP,Sudeste,PFIZER/BIONTECH,80,80,0
Rincão,354370,SP,Sudeste,BUTANTAN/SINOVAC,3235,1766,1469
Rincão,354370,SP,Sudeste,FIOCRUZ/ASTRAZENECA,2516,2305,211
Rincão,354370,SP,Sudeste,PFIZER/BIONTECH,202,202,0
Rinópolis,354380,SP,Sudeste,BUTANTAN/SINOVAC,2865,1592,1273
Rinópolis,354380,SP,Sudeste,FIOCRUZ/ASTRAZENECA,2438,2166,272
Rinópolis,354380,SP,Sudeste,PFIZER/BIONTECH,88,88,0
Rio Acima,315480,MG,Sudeste,FIOCRUZ/ASTRAZENECA,2340,2192,148
Rio Acima,315480,MG,Sudeste,BUTANTAN/SINOVAC,1551,782,769
Rio Acima,315480,MG,Sudeste,PFIZER/BIONTECH,112,112,0
Rio Azul,412200,PR,Sul,FIOCRUZ/ASTRAZENECA,2902,2705,197
Rio Azul,412200,PR,Sul,BUTANTAN/SINOVAC,2605,1362,1243
Rio Azul,412200,PR,Sul,PFIZER/BIONTECH,180,180,0
Rio Bananal,320435,ES,Sudeste,BUTANTAN/SINOVAC,4641,2437,2204
Rio Bananal,320435,ES,Sudeste,FIOCRUZ/ASTRAZENECA,3940,3766,174
Rio Bananal,320435,ES,Sudeste,PFIZER/BIONTECH,644,643,1
Rio Bom,412210,PR,Sul,FIOCRUZ/ASTRAZENECA,1356,1285,71
Rio Bom,412210,PR,Sul,BUTANTAN/SINOVAC,1123,584,539
Rio Bom,412210,PR,Sul,PFIZER/BIONTECH,23,23,0
Rio Bonito,330430,RJ,Sudeste,BUTANTAN/SINOVAC,13603,7062,6541
Rio Bonito,330430,RJ,Sudeste,FIOCRUZ/ASTRAZENECA,11454,10279,1175
Rio Bonito,330430,RJ,Sudeste,PFIZER/BIONTECH,231,231,0
Rio Bonito Do Iguaçu,412215,PR,Sul,FIOCRUZ/ASTRAZENECA,4070,3942,128
Rio Bonito Do Iguaçu,412215,PR,Sul,BUTANTAN/SINOVAC,2419,1271,1148
Rio Bonito Do Iguaçu,412215,PR,Sul,PFIZER/BIONTECH,170,170,0
Rio Branco,120040,AC,Norte,FIOCRUZ/ASTRAZENECA,98906,87277,11629
Rio Branco,120040,AC,Norte,BUTANTAN/SINOVAC,43487,23185,20302
Rio Branco,120040,AC,Norte,PFIZER/BIONTECH,15692,15675,17
Rio Branco,510720,MT,Centro-Oeste,FIOCRUZ/ASTRAZENECA,1438,1387,51
Rio Branco,510720,MT,Centro-Oeste,BUTANTAN/SINOVAC,1007,532,475
Rio Branco,510720,MT,Centro-Oeste,PFIZER/BIONTECH,35,35,0
Rio Branco Do Ivaí,412217,PR,Sul,FIOCRUZ/ASTRAZENECA,917,866,51
Rio Branco Do Ivaí,412217,PR,Sul,BUTANTAN/SINOVAC,896,460,436
Rio Branco Do Sul,412220,PR,Sul,FIOCRUZ/ASTRAZENECA,5462,5246,216
Rio Branco Do Sul,412220,PR,Sul,BUTANTAN/SINOVAC,3842,2036,1806
Rio Branco Do Sul,412220,PR,Sul,PFIZER/BIONTECH,356,356,0
Rio Brilhante,500720,MS,Centro-Oeste,FIOCRUZ/ASTRAZENECA,6993,6332,661
Rio Brilhante,500720,MS,Centro-Oeste,BUTANTAN/SINOVAC,5573,2952,2621
Rio Brilhante,500720,MS,Centro-Oeste,PFIZER/BIONTECH,1315,1314,1
Rio Casca,315490,MG,Sudeste,BUTANTAN/SINOVAC,3156,1681,1475
Rio Casca,315490,MG,Sudeste,FIOCRUZ/ASTRAZENECA,2942,2766,176
Rio Casca,315490,MG,Sudeste,PFIZER/BIONTECH,329,329,0
Rio Claro,330440,RJ,Sudeste,FIOCRUZ/ASTRAZENECA,4176,3769,407
Rio Claro,330440,RJ,Sudeste,BUTANTAN/SINOVAC,4097,2135,1962
Rio Claro,330440,RJ,Sudeste,PFIZER/BIONTECH,156,156,0
Rio Claro,354390,SP,Sudeste,BUTANTAN/SINOVAC,45983,25905,20078
Rio Claro,354390,SP,Sudeste,FIOCRUZ/ASTRAZENECA,41923,37763,4160
Rio Claro,354390,SP,Sudeste,PFIZER/BIONTECH,2911,2909,2
Rio Crespo,110026,RO,Norte,BUTANTAN/SINOVAC,946,502,444
Rio Crespo,110026,RO,Norte,FIOCRUZ/ASTRAZENECA,829,806,23
Rio Crespo,110026,RO,Norte,PFIZER/BIONTECH,82,82,0
Rio Da Conceição,171865,TO,Norte,BUTANTAN/SINOVAC,373,196,177
Rio Da Conceição,171865,TO,Norte,FIOCRUZ/ASTRAZENECA,326,297,29
Rio Das Antas,421440,SC,Sul,FIOCRUZ/ASTRAZENECA,1459,1339,120
Rio Das Antas,421440,SC,Sul,BUTANTAN/SINOVAC,1226,646,580
Rio Das Antas,421440,SC,Sul,PFIZER/BIONTECH,109,109,0
Rio Das Flores,330450,RJ,Sudeste,FIOCRUZ/ASTRAZENECA,3082,2826,256
Rio Das Flores,330450,RJ,Sudeste,BUTANTAN/SINOVAC,2484,1323,1161
Rio Das Ostras,330452,RJ,Sudeste,BUTANTAN/SINOVAC,28846,14704,14142
Rio Das Ostras,330452,RJ,Sudeste,FIOCRUZ/ASTRAZENECA,18074,16554,1520
Rio Das Ostras,330452,RJ,Sudeste,PFIZER/BIONTECH,1569,1568,1
Rio Das Pedras,354400,SP,Sudeste,FIOCRUZ/ASTRAZENECA,7178,6832,346
Rio Das Pedras,354400,SP,Sudeste,BUTANTAN/SINOVAC,6216,3524,2692
Rio Das Pedras,354400,SP,Sudeste,PFIZER/BIONTECH,353,352,1
Rio De Contas,292670,BA,Nordeste,BUTANTAN/SINOVAC,4394,2305,2089
Rio De Contas,292670,BA,Nordeste,FIOCRUZ/ASTRAZENECA,4336,3720,616
Rio De Contas,292670,BA,Nordeste,PFIZER/BIONTECH,257,257,0
Rio De Janeiro,330455,RJ,Sudeste,FIOCRUZ/ASTRAZENECA,1781483,1629473,152010
Rio De Janeiro,330455,RJ,Sudeste,BUTANTAN/SINOVAC,1771194,926139,845055
Rio De Janeiro,330455,RJ,Sudeste,PFIZER/BIONTECH,278641,277891,750
Rio Do Antônio,292680,BA,Nordeste,BUTANTAN/SINOVAC,2772,1561,1211
Rio Do Antônio,292680,BA,Nordeste,FIOCRUZ/ASTRAZENECA,2290,2005,285
Rio Do Antônio,292680,BA,Nordeste,PFIZER/BIONTECH,145,144,1
Rio Do Campo,421450,SC,Sul,FIOCRUZ/ASTRAZENECA,1417,1327,90
Rio Do Campo,421450,SC,Sul,BUTANTAN/SINOVAC,1165,652,513
Rio Do Campo,421450,SC,Sul,PFIZER/BIONTECH,134,134,0
Rio Do Fogo,240895,RN,Nordeste,BUTANTAN/SINOVAC,1732,892,840
Rio Do Fogo,240895,RN,Nordeste,FIOCRUZ/ASTRAZENECA,1524,1386,138
Rio Do Fogo,240895,RN,Nordeste,PFIZER/BIONTECH,132,132,0
Rio Do Oeste,421460,SC,Sul,BUTANTAN/SINOVAC,2007,1033,974
Rio Do Oeste,421460,SC,Sul,FIOCRUZ/ASTRAZENECA,1829,1683,146
Rio Do Pires,292690,BA,Nordeste,BUTANTAN/SINOVAC,2790,1413,1377
Rio Do Pires,292690,BA,Nordeste,FIOCRUZ/ASTRAZENECA,2478,2274,204
Rio Do Prado,315510,MG,Sudeste,BUTANTAN/SINOVAC,1237,626,611
Rio Do Prado,315510,MG,Sudeste,FIOCRUZ/ASTRAZENECA,1031,928,103
Rio Do Prado,315510,MG,Sudeste,PFIZER/BIONTECH,20,20,0
Rio Do Sul,421480,SC,Sul,FIOCRUZ/ASTRAZENECA,15973,14635,1338
Rio Do Sul,421480,SC,Sul,BUTANTAN/SINOVAC,12882,6794,6088
Rio Do Sul,421480,SC,Sul,PFIZER/BIONTECH,1606,1606,0
Rio Doce,315500,MG,Sudeste,FIOCRUZ/ASTRAZENECA,1304,1265,39
Rio Doce,315500,MG,Sudeste,BUTANTAN/SINOVAC,584,310,274
Rio Doce,315500,MG,Sudeste,PFIZER/BIONTECH,34,34,0
Rio Dos Bois,171870,TO,Norte,BUTANTAN/SINOVAC,610,330,280
Rio Dos Bois,171870,TO,Norte,FIOCRUZ/ASTRAZENECA,494,469,25
Rio Dos Cedros,421470,SC,Sul,BUTANTAN/SINOVAC,3293,1658,1635
Rio Dos Cedros,421470,SC,Sul,FIOCRUZ/ASTRAZENECA,2341,2286,55
Rio Dos Cedros,421470,SC,Sul,PFIZER/BIONTECH,288,288,0
Rio Dos Índios,431555,RS,Sul,BUTANTAN/SINOVAC,925,458,467
Rio Dos Índios,431555,RS,Sul,FIOCRUZ/ASTRAZENECA,695,602,93
Rio Dos Índios,431555,RS,Sul,PFIZER/BIONTECH,71,71,0
Rio Espera,315520,MG,Sudeste,FIOCRUZ/ASTRAZENECA,1052,796,256
Rio Espera,315520,MG,Sudeste,BUTANTAN/SINOVAC,968,673,295
Rio Formoso,261190,PE,Nordeste,FIOCRUZ/ASTRAZENECA,3633,3522,111
Rio Formoso,261190,PE,Nordeste,BUTANTAN/SINOVAC,2785,1492,1293
Rio Formoso,261190,PE,Nordeste,PFIZER/BIONTECH,446,446,0
Rio Fortuna,421490,SC,Sul,FIOCRUZ/ASTRAZENECA,1257,1121,136
Rio Fortuna,421490,SC,Sul,BUTANTAN/SINOVAC,1185,622,563
Rio Fortuna,421490,SC,Sul,PFIZER/BIONTECH,392,392,0
Rio Grande,431560,RS,Sul,FIOCRUZ/ASTRAZENECA,45450,42812,2638
Rio Grande,431560,RS,Sul,BUTANTAN/SINOVAC,43285,24878,18407
Rio Grande,431560,RS,Sul,PFIZER/BIONTECH,792,792,0
Rio Grande Da Serra,354410,SP,Sudeste,BUTANTAN/SINOVAC,6713,3740,2973
Rio Grande Da Serra,354410,SP,Sudeste,FIOCRUZ/ASTRAZENECA,6632,6296,336
Rio Grande Da Serra,354410,SP,Sudeste,PFIZER/BIONTECH,362,361,1
Rio Grande Do Piauí,220900,PI,Nordeste,FIOCRUZ/ASTRAZENECA,1479,1343,136
Rio Grande Do Piauí,220900,PI,Nordeste,BUTANTAN/SINOVAC,1402,701,701
Rio Largo,270770,AL,Nordeste,FIOCRUZ/ASTRAZENECA,17438,16878,560
Rio Largo,270770,AL,Nordeste,BUTANTAN/SINOVAC,11767,6787,4980
Rio Largo,270770,AL,Nordeste,PFIZER/BIONTECH,1568,1563,5
Rio Manso,315530,MG,Sudeste,BUTANTAN/SINOVAC,1540,791,749
Rio Manso,315530,MG,Sudeste,FIOCRUZ/ASTRAZENECA,1408,1277,131
Rio Manso,315530,MG,Sudeste,PFIZER/BIONTECH,67,67,0
Rio Maria,150616,PA,Norte,FIOCRUZ/ASTRAZENECA,3689,2964,725
Rio Maria,150616,PA,Norte,BUTANTAN/SINOVAC,2131,1127,1004
Rio Negrinho,421500,SC,Sul,BUTANTAN/SINOVAC,3372,2407,965
Rio Negrinho,421500,SC,Sul,FIOCRUZ/ASTRAZENECA,564,559,5
Rio Negro,412230,PR,Sul,FIOCRUZ/ASTRAZENECA,6998,6932,66
Rio Negro,412230,PR,Sul,BUTANTAN/SINOVAC,5783,3132,2651
Rio Negro,412230,PR,Sul,PFIZER/BIONTECH,379,379,0
Rio Negro,500730,MS,Centro-Oeste,BUTANTAN/SINOVAC,1590,803,787
Rio Negro,500730,MS,Centro-Oeste,FIOCRUZ/ASTRAZENECA,1178,1022,156
Rio Negro,500730,MS,Centro-Oeste,PFIZER/BIONTECH,130,130,0
Rio Novo,315540,MG,Sudeste,FIOCRUZ/ASTRAZENECA,2301,2118,183
Rio Novo,315540,MG,Sudeste,BUTANTAN/SINOVAC,2144,1077,1067
Rio Novo,315540,MG,Sudeste,PFIZER/BIONTECH,164,164,0
Rio Novo Do Sul,320440,ES,Sudeste,BUTANTAN/SINOVAC,3311,1711,1600
Rio Novo Do Sul,320440,ES,Sudeste,FIOCRUZ/ASTRAZENECA,2610,2467,143
Rio Novo Do Sul,320440,ES,Sudeste,PFIZER/BIONTECH,416,416,0
Rio Paranaíba,315550,MG,Sudeste,BUTANTAN/SINOVAC,3596,1822,1774
Rio Paranaíba,315550,MG,Sudeste,FIOCRUZ/ASTRAZENECA,2467,2279,188
Rio Paranaíba,315550,MG,Sudeste,PFIZER/BIONTECH,365,365,0
Rio Pardo,431570,RS,Sul,BUTANTAN/SINOVAC,11278,5771,5507
Rio Pardo,431570,RS,Sul,FIOCRUZ/ASTRAZENECA,10571,9516,1055
Rio Pardo,431570,RS,Sul,PFIZER/BIONTECH,1177,1177,0
Rio Pardo De Minas,315560,MG,Sudeste,BUTANTAN/SINOVAC,6016,3100,2916
Rio Pardo De Minas,315560,MG,Sudeste,FIOCRUZ/ASTRAZENECA,4496,4148,348
Rio Pardo De Minas,315560,MG,Sudeste,PFIZER/BIONTECH,785,785,0
Rio Piracicaba,315570,MG,Sudeste,FIOCRUZ/ASTRAZENECA,5808,4498,1310
Rio Piracicaba,315570,MG,Sudeste,BUTANTAN/SINOVAC,3244,1708,1536
Rio Piracicaba,315570,MG,Sudeste,PFIZER/BIONTECH,233,233,0
Rio Pomba,315580,MG,Sudeste,BUTANTAN/SINOVAC,3607,2082,1525
Rio Pomba,315580,MG,Sudeste,FIOCRUZ/ASTRAZENECA,2620,2276,344
Rio Pomba,315580,MG,Sudeste,PFIZER/BIONTECH,316,316,0
Rio Preto,315590,MG,Sudeste,FIOCRUZ/ASTRAZENECA,1469,1352,117
Rio Preto,315590,MG,Sudeste,BUTANTAN/SINOVAC,1367,672,695
Rio Preto,315590,MG,Sudeste,PFIZER/BIONTECH,74,74,0
Rio Preto Da Eva,130356,AM,Norte,FIOCRUZ/ASTRAZENECA,3742,2894,848
Rio Preto Da Eva,130356,AM,Norte,BUTANTAN/SINOVAC,2772,1721,1051
Rio Quente,521878,GO,Centro-Oeste,FIOCRUZ/ASTRAZENECA,963,886,77
Rio Quente,521878,GO,Centro-Oeste,BUTANTAN/SINOVAC,579,291,288
Rio Quente,521878,GO,Centro-Oeste,PFIZER/BIONTECH,71,71,0
Rio Real,292700,BA,Nordeste,FIOCRUZ/ASTRAZENECA,5965,5452,513
Rio Real,292700,BA,Nordeste,BUTANTAN/SINOVAC,3730,2363,1367
Rio Rufino,421505,SC,Sul,FIOCRUZ/ASTRAZENECA,758,719,39
Rio Rufino,421505,SC,Sul,BUTANTAN/SINOVAC,712,412,300
Rio Rufino,421505,SC,Sul,PFIZER/BIONTECH,24,24,0
Rio Sono,171875,TO,Norte,BUTANTAN/SINOVAC,1195,671,524
Rio Sono,171875,TO,Norte,FIOCRUZ/ASTRAZENECA,445,413,32
Rio Tinto,251290,PB,Nordeste,BUTANTAN/SINOVAC,8951,4570,4381
Rio Tinto,251290,PB,Nordeste,FIOCRUZ/ASTRAZENECA,3610,3314,296
Rio Tinto,251290,PB,Nordeste,PFIZER/BIONTECH,293,293,0
Rio Verde,521880,GO,Centro-Oeste,FIOCRUZ/ASTRAZENECA,43603,38693,4910
Rio Verde,521880,GO,Centro-Oeste,BUTANTAN/SINOVAC,34317,18783,15534
Rio Verde,521880,GO,Centro-Oeste,PFIZER/BIONTECH,10078,10068,10
Rio Verde De Mato Grosso,500740,MS,Centro-Oeste,BUTANTAN/SINOVAC,5519,2896,2623
Rio Verde De Mato Grosso,500740,MS,Centro-Oeste,FIOCRUZ/ASTRAZENECA,5330,4692,638
Rio Verde De Mato Grosso,500740,MS,Centro-Oeste,PFIZER/BIONTECH,407,407,0
Rio Vermelho,315600,MG,Sudeste,BUTANTAN/SINOVAC,2527,1446,1081
Rio Vermelho,315600,MG,Sudeste,FIOCRUZ/ASTRAZENECA,1175,1098,77
Riolândia,354420,SP,Sudeste,BUTANTAN/SINOVAC,2654,1554,1100
Riolândia,354420,SP,Sudeste,FIOCRUZ/ASTRAZENECA,1919,1781,138
Riolândia,354420,SP,Sudeste,PFIZER/BIONTECH,196,196,0
Riozinho,431575,RS,Sul,BUTANTAN/SINOVAC,1315,661,654
Riozinho,431575,RS,Sul,FIOCRUZ/ASTRAZENECA,1003,928,75
Riozinho,431575,RS,Sul,PFIZER/BIONTECH,186,186,0
Riqueza,421507,SC,Sul,BUTANTAN/SINOVAC,1329,728,601
Riqueza,421507,SC,Sul,FIOCRUZ/ASTRAZENECA,1211,1128,83
Riqueza,421507,SC,Sul,PFIZER/BIONTECH,120,120,0
Ritápolis,315610,MG,Sudeste,FIOCRUZ/ASTRAZENECA,1501,1376,125
Ritápolis,315610,MG,Sudeste,BUTANTAN/SINOVAC,1357,709,648
Ritápolis,315610,MG,Sudeste,PFIZER/BIONTECH,29,29,0
Riversul,354350,SP,Sudeste,BUTANTAN/SINOVAC,1496,833,663
Riversul,354350,SP,Sudeste,FIOCRUZ/ASTRAZENECA,1461,1346,115
Riversul,354350,SP,Sudeste,PFIZER/BIONTECH,216,216,0
Roca Sales,431580,RS,Sul,BUTANTAN/SINOVAC,3062,1677,1385
Roca Sales,431580,RS,Sul,FIOCRUZ/ASTRAZENECA,2756,2454,302
Roca Sales,431580,RS,Sul,PFIZER/BIONTECH,364,363,1
Rochedo,500750,MS,Centro-Oeste,FIOCRUZ/ASTRAZENECA,1589,1413,176
Rochedo,500750,MS,Centro-Oeste,BUTANTAN/SINOVAC,1211,626,585
Rochedo,500750,MS,Centro-Oeste,PFIZER/BIONTECH,197,197,0
Rochedo De Minas,315620,MG,Sudeste,FIOCRUZ/ASTRAZENECA,727,678,49
Rochedo De Minas,315620,MG,Sudeste,BUTANTAN/SINOVAC,588,298,290
Rochedo De Minas,315620,MG,Sudeste,PFIZER/BIONTECH,58,58,0
Rodeio,421510,SC,Sul,BUTANTAN/SINOVAC,2894,1478,1416
Rodeio,421510,SC,Sul,FIOCRUZ/ASTRAZENECA,2606,2550,56
Rodeio,421510,SC,Sul,PFIZER/BIONTECH,279,279,0
Rodeio Bonito,431590,RS,Sul,BUTANTAN/SINOVAC,1867,935,932
Rodeio Bonito,431590,RS,Sul,FIOCRUZ/ASTRAZENECA,1586,1409,177
Rodeio Bonito,431590,RS,Sul,PFIZER/BIONTECH,200,200,0
Rodeiro,315630,MG,Sudeste,BUTANTAN/SINOVAC,1172,643,529
Rodeiro,315630,MG,Sudeste,FIOCRUZ/ASTRAZENECA,908,841,67
Rodeiro,315630,MG,Sudeste,PFIZER/BIONTECH,20,20,0
Rodelas,292710,BA,Nordeste,BUTANTAN/SINOVAC,3165,1666,1499
Rodelas,292710,BA,Nordeste,FIOCRUZ/ASTRAZENECA,1122,1104,18
Rodolfo Fernandes,241100,RN,Nordeste,BUTANTAN/SINOVAC,1074,569,505
Rodolfo Fernandes,241100,RN,Nordeste,FIOCRUZ/ASTRAZENECA,1013,952,61
Rodolfo Fernandes,241100,RN,Nordeste,PFIZER/BIONTECH,129,129,0
Rodrigues Alves,120042,AC,Norte,BUTANTAN/SINOVAC,2797,1574,1223
Rodrigues Alves,120042,AC,Norte,FIOCRUZ/ASTRAZENECA,1325,1165,160
Rolador,431595,RS,Sul,BUTANTAN/SINOVAC,805,399,406
Rolador,431595,RS,Sul,FIOCRUZ/ASTRAZENECA,711,626,85
Rolador,431595,RS,Sul,PFIZER/BIONTECH,125,125,0
Rolândia,412240,PR,Sul,BUTANTAN/SINOVAC,12396,6376,6020
Rolândia,412240,PR,Sul,FIOCRUZ/ASTRAZENECA,11765,9983,1782
Rolândia,412240,PR,Sul,PFIZER/BIONTECH,762,761,1
Rolante,431600,RS,Sul,BUTANTAN/SINOVAC,5240,2690,2550
Rolante,431600,RS,Sul,FIOCRUZ/ASTRAZENECA,4728,4504,224
Rolante,431600,RS,Sul,PFIZER/BIONTECH,156,156,0
Rolim De Moura,110028,RO,Norte,BUTANTAN/SINOVAC,10212,5450,4762
Rolim De Moura,110028,RO,Norte,FIOCRUZ/ASTRAZENECA,8586,8140,446
Rolim De Moura,110028,RO,Norte,PFIZER/BIONTECH,960,960,0
Romaria,315640,MG,Sudeste,FIOCRUZ/ASTRAZENECA,863,811,52
Romaria,315640,MG,Sudeste,BUTANTAN/SINOVAC,783,404,379
Romaria,315640,MG,Sudeste,PFIZER/BIONTECH,71,71,0
Romelândia,421520,SC,Sul,BUTANTAN/SINOVAC,1358,678,680
Romelândia,421520,SC,Sul,FIOCRUZ/ASTRAZENECA,1273,1154,119
Romelândia,421520,SC,Sul,PFIZER/BIONTECH,87,87,0
Roncador,412250,PR,Sul,FIOCRUZ/ASTRAZENECA,2389,2266,123
Roncador,412250,PR,Sul,BUTANTAN/SINOVAC,2019,1057,962
Ronda Alta,431610,RS,Sul,BUTANTAN/SINOVAC,4026,2029,1997
Ronda Alta,431610,RS,Sul,FIOCRUZ/ASTRAZENECA,2742,2380,362
Ronda Alta,431610,RS,Sul,PFIZER/BIONTECH,390,388,2
Rondinha,431620,RS,Sul,BUTANTAN/SINOVAC,2354,1185,1169
Rondinha,431620,RS,Sul,FIOCRUZ/ASTRAZENECA,1615,1368,247
Rondinha,431620,RS,Sul,PFIZER/BIONTECH,198,197,1
Rondolândia,510757,MT,Centro-Oeste,BUTANTAN/SINOVAC,542,284,258
Rondolândia,510757,MT,Centro-Oeste,FIOCRUZ/ASTRAZENECA,505,472,33
Rondolândia,510757,MT,Centro-Oeste,PFIZER/BIONTECH,51,51,0
Rondon,412260,PR,Sul,FIOCRUZ/ASTRAZENECA,2584,2453,131
Rondon,412260,PR,Sul,BUTANTAN/SINOVAC,1934,1006,928
Rondon,412260,PR,Sul,PFIZER/BIONTECH,125,125,0
Rondon Do Pará,150618,PA,Norte,FIOCRUZ/ASTRAZENECA,6883,6361,522
Rondon Do Pará,150618,PA,Norte,BUTANTAN/SINOVAC,1970,1056,914
Rondonópolis,510760,MT,Centro-Oeste,FIOCRUZ/ASTRAZENECA,47761,44343,3418
Rondonópolis,510760,MT,Centro-Oeste,BUTANTAN/SINOVAC,40195,21212,18983
Rondonópolis,510760,MT,Centro-Oeste,PFIZER/BIONTECH,1651,1651,0
Roque Gonzales,431630,RS,Sul,BUTANTAN/SINOVAC,2081,1084,997
Roque Gonzales,431630,RS,Sul,FIOCRUZ/ASTRAZENECA,2007,1778,229
Roque Gonzales,431630,RS,Sul,PFIZER/BIONTECH,218,217,1
Rorainópolis,140047,RR,Norte,BUTANTAN/SINOVAC,4263,2207,2056
Rorainópolis,140047,RR,Norte,FIOCRUZ/ASTRAZENECA,3453,3392,61
Rosana,354425,SP,Sudeste,BUTANTAN/SINOVAC,5310,2823,2487
Rosana,354425,SP,Sudeste,FIOCRUZ/ASTRAZENECA,4731,4450,281
Rosana,354425,SP,Sudeste,PFIZER/BIONTECH,627,627,0
Rosário,210960,MA,Nordeste,FIOCRUZ/ASTRAZENECA,9737,9234,503
Rosário,210960,MA,Nordeste,BUTANTAN/SINOVAC,5152,2693,2459
Rosário,210960,MA,Nordeste,PFIZER/BIONTECH,1484,1484,0
Rosário Da Limeira,315645,MG,Sudeste,BUTANTAN/SINOVAC,1238,635,603
Rosário Da Limeira,315645,MG,Sudeste,FIOCRUZ/ASTRAZENECA,1142,1047,95
Rosário Da Limeira,315645,MG,Sudeste,PFIZER/BIONTECH,134,134,0
Rosário Do Catete,280610,SE,Nordeste,FIOCRUZ/ASTRAZENECA,1495,1495,0
Rosário Do Catete,280610,SE,Nordeste,BUTANTAN/SINOVAC,1213,800,413
Rosário Do Catete,280610,SE,Nordeste,PFIZER/BIONTECH,172,172,0
Rosário Do Ivaí,412265,PR,Sul,FIOCRUZ/ASTRAZENECA,1621,1524,97
Rosário Do Ivaí,412265,PR,Sul,BUTANTAN/SINOVAC,1387,718,669
Rosário Do Ivaí,412265,PR,Sul,PFIZER/BIONTECH,20,20,0
Rosário Do Sul,431640,RS,Sul,BUTANTAN/SINOVAC,11071,5726,5345
Rosário Do Sul,431640,RS,Sul,FIOCRUZ/ASTRAZENECA,9646,8960,686
Rosário Do Sul,431640,RS,Sul,PFIZER/BIONTECH,1451,1451,0
Rosário Oeste,510770,MT,Centro-Oeste,BUTANTAN/SINOVAC,3366,1692,1674
Rosário Oeste,510770,MT,Centro-Oeste,FIOCRUZ/ASTRAZENECA,2881,2677,204
Rosário Oeste,510770,MT,Centro-Oeste,PFIZER/BIONTECH,12,12,0
Roseira,354430,SP,Sudeste,BUTANTAN/SINOVAC,2226,1236,990
Roseira,354430,SP,Sudeste,FIOCRUZ/ASTRAZENECA,2207,2037,170
Roseira,354430,SP,Sudeste,PFIZER/BIONTECH,105,105,0
Roteiro,270780,AL,Nordeste,BUTANTAN/SINOVAC,871,444,427
Roteiro,270780,AL,Nordeste,FIOCRUZ/ASTRAZENECA,802,641,161
Roteiro,270780,AL,Nordeste,PFIZER/BIONTECH,367,366,1
Rubelita,315650,MG,Sudeste,BUTANTAN/SINOVAC,977,475,502
Rubelita,315650,MG,Sudeste,FIOCRUZ/ASTRAZENECA,925,809,116
Rubelita,315650,MG,Sudeste,PFIZER/BIONTECH,27,27,0
Rubiácea,354440,SP,Sudeste,FIOCRUZ/ASTRAZENECA,817,756,61
Rubiácea,354440,SP,Sudeste,BUTANTAN/SINOVAC,794,457,337
Rubiácea,354440,SP,Sudeste,PFIZER/BIONTECH,105,105,0
Rubiataba,521890,GO,Centro-Oeste,FIOCRUZ/ASTRAZENECA,6820,6049,771
Rubiataba,521890,GO,Centro-Oeste,BUTANTAN/SINOVAC,3178,1707,1471
Rubiataba,521890,GO,Centro-Oeste,PFIZER/BIONTECH,239,239,0
Rubim,315660,MG,Sudeste,BUTANTAN/SINOVAC,2738,1384,1354
Rubim,315660,MG,Sudeste,FIOCRUZ/ASTRAZENECA,2083,1904,179
Rubim,315660,MG,Sudeste,PFIZER/BIONTECH,57,57,0
Rubinéia,354450,SP,Sudeste,BUTANTAN/SINOVAC,1485,792,693
Rubinéia,354450,SP,Sudeste,FIOCRUZ/ASTRAZENECA,1478,1371,107
Rubinéia,354450,SP,Sudeste,PFIZER/BIONTECH,118,118,0
Rurópolis,150619,PA,Norte,FIOCRUZ/ASTRAZENECA,5914,4807,1107
Rurópolis,150619,PA,Norte,BUTANTAN/SINOVAC,1822,946,876
Russas,231180,CE,Nordeste,BUTANTAN/SINOVAC,5690,4581,1109
Russas,231180,CE,Nordeste,FIOCRUZ/ASTRAZENECA,1469,1450,19
Ruy Barbosa,241110,RN,Nordeste,BUTANTAN/SINOVAC,776,401,375
Ruy Barbosa,241110,RN,Nordeste,FIOCRUZ/ASTRAZENECA,721,668,53
Ruy Barbosa,241110,RN,Nordeste,PFIZER/BIONTECH,131,131,0
Ruy Barbosa,292720,BA,Nordeste,FIOCRUZ/ASTRAZENECA,6402,5444,958
Ruy Barbosa,292720,BA,Nordeste,BUTANTAN/SINOVAC,5901,3085,2816
Ruy Barbosa,292720,BA,Nordeste,PFIZER/BIONTECH,433,431,2
Sabará,315670,MG,Sudeste,BUTANTAN/SINOVAC,26313,13850,12463
Sabará,315670,MG,Sudeste,FIOCRUZ/ASTRAZENECA,26081,23567,2514
Sabará,315670,MG,Sudeste,PFIZER/BIONTECH,3444,3443,1
Sabáudia,412270,PR,Sul,FIOCRUZ/ASTRAZENECA,1980,1881,99
Sabáudia,412270,PR,Sul,BUTANTAN/SINOVAC,1524,781,743
Sabáudia,412270,PR,Sul,PFIZER/BIONTECH,25,25,0
Sabino,354460,SP,Sudeste,BUTANTAN/SINOVAC,1776,1020,756
Sabino,354460,SP,Sudeste,FIOCRUZ/ASTRAZENECA,1513,1338,175
Sabino,354460,SP,Sudeste,PFIZER/BIONTECH,71,71,0
Sabinópolis,315680,MG,Sudeste,FIOCRUZ/ASTRAZENECA,4449,4187,262
Sabinópolis,315680,MG,Sudeste,BUTANTAN/SINOVAC,3852,2232,1620
Sabinópolis,315680,MG,Sudeste,PFIZER/BIONTECH,203,203,0
Saboeiro,231190,CE,Nordeste,BUTANTAN/SINOVAC,2759,1511,1248
Saboeiro,231190,CE,Nordeste,FIOCRUZ/ASTRAZENECA,1135,1063,72
Sacramento,315690,MG,Sudeste,BUTANTAN/SINOVAC,5123,2722,2401
Sacramento,315690,MG,Sudeste,FIOCRUZ/ASTRAZENECA,4367,4073,294
Sacramento,315690,MG,Sudeste,PFIZER/BIONTECH,10,10,0
Sagrada Família,431642,RS,Sul,FIOCRUZ/ASTRAZENECA,792,701,91
Sagrada Família,431642,RS,Sul,BUTANTAN/SINOVAC,741,374,367
Sagrada Família,431642,RS,Sul,PFIZER/BIONTECH,105,105,0
Sagres,354470,SP,Sudeste,BUTANTAN/SINOVAC,830,476,354
Sagres,354470,SP,Sudeste,FIOCRUZ/ASTRAZENECA,729,673,56
Sagres,354470,SP,Sudeste,PFIZER/BIONTECH,76,76,0
Sairé,261200,PE,Nordeste,BUTANTAN/SINOVAC,1954,997,957
Sairé,261200,PE,Nordeste,FIOCRUZ/ASTRAZENECA,1937,1754,183
Sairé,261200,PE,Nordeste,PFIZER/BIONTECH,108,108,0
Saldanha Marinho,431643,RS,Sul,BUTANTAN/SINOVAC,1189,602,587
Saldanha Marinho,431643,RS,Sul,FIOCRUZ/ASTRAZENECA,813,712,101
Saldanha Marinho,431643,RS,Sul,PFIZER/BIONTECH,117,117,0
Sales,354480,SP,Sudeste,BUTANTAN/SINOVAC,1773,966,807
Sales,354480,SP,Sudeste,FIOCRUZ/ASTRAZENECA,1755,1611,144
Sales,354480,SP,Sudeste,PFIZER/BIONTECH,154,153,1
Sales Oliveira,354490,SP,Sudeste,FIOCRUZ/ASTRAZENECA,2878,2586,292
Sales Oliveira,354490,SP,Sudeste,BUTANTAN/SINOVAC,2817,1430,1387
Sales Oliveira,354490,SP,Sudeste,PFIZER/BIONTECH,205,205,0
Salesópolis,354500,SP,Sudeste,FIOCRUZ/ASTRAZENECA,4182,3897,285
Salesópolis,354500,SP,Sudeste,BUTANTAN/SINOVAC,3871,2036,1835
Salesópolis,354500,SP,Sudeste,PFIZER/BIONTECH,454,454,0
Salete,421530,SC,Sul,FIOCRUZ/ASTRAZENECA,1765,1641,124
Salete,421530,SC,Sul,BUTANTAN/SINOVAC,1581,870,711
Salete,421530,SC,Sul,PFIZER/BIONTECH,107,107,0
Salgadinho,251300,PB,Nordeste,BUTANTAN/SINOVAC,609,349,260
Salgadinho,251300,PB,Nordeste,FIOCRUZ/ASTRAZENECA,480,439,41
Salgadinho,251300,PB,Nordeste,PFIZER/BIONTECH,42,42,0
Salgadinho,261210,PE,Nordeste,FIOCRUZ/ASTRAZENECA,2304,2103,201
Salgadinho,261210,PE,Nordeste,BUTANTAN/SINOVAC,1750,917,833
Salgadinho,261210,PE,Nordeste,PFIZER/BIONTECH,53,53,0
Salgado,280620,SE,Nordeste,BUTANTAN/SINOVAC,3814,1999,1815
Salgado,280620,SE,Nordeste,FIOCRUZ/ASTRAZENECA,2355,2354,1
Salgado,280620,SE,Nordeste,PFIZER/BIONTECH,263,263,0
Salgado De São Félix,251310,PB,Nordeste,BUTANTAN/SINOVAC,4225,2343,1882
Salgado De São Félix,251310,PB,Nordeste,FIOCRUZ/ASTRAZENECA,2596,2381,215
Salgado De São Félix,251310,PB,Nordeste,PFIZER/BIONTECH,100,100,0
Salgado Filho,412280,PR,Sul,FIOCRUZ/ASTRAZENECA,1008,930,78
Salgado Filho,412280,PR,Sul,BUTANTAN/SINOVAC,915,467,448
Salgado Filho,412280,PR,Sul,PFIZER/BIONTECH,18,18,0
Salgueiro,261220,PE,Nordeste,FIOCRUZ/ASTRAZENECA,20937,18046,2891
Salgueiro,261220,PE,Nordeste,BUTANTAN/SINOVAC,13068,6724,6344
Salgueiro,261220,PE,Nordeste,PFIZER/BIONTECH,1933,1931,2
Salinas,315700,MG,Sudeste,BUTANTAN/SINOVAC,5199,2943,2256
Salinas,315700,MG,Sudeste,FIOCRUZ/ASTRAZENECA,4704,4387,317
Salinas,315700,MG,Sudeste,PFIZER/BIONTECH,152,152,0
Salinas Da Margarida,292730,BA,Nordeste,FIOCRUZ/ASTRAZENECA,4985,4838,147
Salinas Da Margarida,292730,BA,Nordeste,BUTANTAN/SINOVAC,2307,1165,1142
Salinas Da Margarida,292730,BA,Nordeste,PFIZER/BIONTECH,287,287,0
Salinópolis,150620,PA,Norte,FIOCRUZ/ASTRAZENECA,7620,6026,1594
Salinópolis,150620,PA,Norte,BUTANTAN/SINOVAC,4452,2334,2118
Salitre,231195,CE,Nordeste,FIOCRUZ/ASTRAZENECA,3284,3104,180
Salitre,231195,CE,Nordeste,BUTANTAN/SINOVAC,2494,1308,1186
Salitre,231195,CE,Nordeste,PFIZER/BIONTECH,12,12,0
Salmourão,354510,SP,Sudeste,BUTANTAN/SINOVAC,1240,704,536
Salmourão,354510,SP,Sudeste,FIOCRUZ/ASTRAZENECA,1156,1058,98
Salmourão,354510,SP,Sudeste,PFIZER/BIONTECH,70,70,0
Saloá,261230,PE,Nordeste,FIOCRUZ/ASTRAZENECA,3521,3212,309
Saloá,261230,PE,Nordeste,BUTANTAN/SINOVAC,3076,1598,1478
Saloá,261230,PE,Nordeste,PFIZER/BIONTECH,455,455,0
Saltinho,354515,SP,Sudeste,BUTANTAN/SINOVAC,4036,2155,1881
Saltinho,354515,SP,Sudeste,FIOCRUZ/ASTRAZENECA,3251,3043,208
Saltinho,354515,SP,Sudeste,PFIZER/BIONTECH,192,192,0
Saltinho,421535,SC,Sul,FIOCRUZ/ASTRAZENECA,1123,1035,88
Saltinho,421535,SC,Sul,BUTANTAN/SINOVAC,1097,562,535
Salto,354520,SP,Sudeste,BUTANTAN/SINOVAC,22991,12375,10616
Salto,354520,SP,Sudeste,FIOCRUZ/ASTRAZENECA,22585,20846,1739
Salto,354520,SP,Sudeste,PFIZER/BIONTECH,2892,2889,3
Salto Da Divisa,315710,MG,Sudeste,BUTANTAN/SINOVAC,1378,714,664
Salto Da Divisa,315710,MG,Sudeste,FIOCRUZ/ASTRAZENECA,1096,1017,79
Salto Da Divisa,315710,MG,Sudeste,PFIZER/BIONTECH,45,45,0
Salto De Pirapora,354530,SP,Sudeste,FIOCRUZ/ASTRAZENECA,12735,11938,797
Salto De Pirapora,354530,SP,Sudeste,BUTANTAN/SINOVAC,11541,6130,5411
Salto De Pirapora,354530,SP,Sudeste,PFIZER/BIONTECH,768,768,0
Salto Do Céu,510775,MT,Centro-Oeste,FIOCRUZ/ASTRAZENECA,886,832,54
Salto Do Céu,510775,MT,Centro-Oeste,BUTANTAN/SINOVAC,870,451,419
Salto Do Céu,510775,MT,Centro-Oeste,PFIZER/BIONTECH,41,41,0
Salto Do Itararé,412290,PR,Sul,FIOCRUZ/ASTRAZENECA,1560,1502,58
Salto Do Itararé,412290,PR,Sul,BUTANTAN/SINOVAC,1026,664,362
Salto Do Jacuí,431645,RS,Sul,FIOCRUZ/ASTRAZENECA,3244,3068,176
Salto Do Jacuí,431645,RS,Sul,BUTANTAN/SINOVAC,3228,1646,1582
Salto Do Jacuí,431645,RS,Sul,PFIZER/BIONTECH,422,422,0
Salto Do Lontra,412300,PR,Sul,FIOCRUZ/ASTRAZENECA,3490,3278,212
Salto Do Lontra,412300,PR,Sul,BUTANTAN/SINOVAC,2591,1372,1219
Salto Do Lontra,412300,PR,Sul,PFIZER/BIONTECH,153,153,0
Salto Grande,354540,SP,Sudeste,FIOCRUZ/ASTRAZENECA,2526,2362,164
Salto Grande,354540,SP,Sudeste,BUTANTAN/SINOVAC,2060,1214,846
Salto Grande,354540,SP,Sudeste,PFIZER/BIONTECH,92,92,0
Salto Veloso,421540,SC,Sul,FIOCRUZ/ASTRAZENECA,1182,1082,100
Salto Veloso,421540,SC,Sul,BUTANTAN/SINOVAC,1060,551,509
Salto Veloso,421540,SC,Sul,PFIZER/BIONTECH,58,58,0
Salvador,292740,BA,Nordeste,BUTANTAN/SINOVAC,649788,365267,284521
Salvador,292740,BA,Nordeste,FIOCRUZ/ASTRAZENECA,594668,493982,100686
Salvador,292740,BA,Nordeste,PFIZER/BIONTECH,162683,162661,22
Salvador Das Missões,431647,RS,Sul,BUTANTAN/SINOVAC,942,464,478
Salvador Das Missões,431647,RS,Sul,FIOCRUZ/ASTRAZENECA,812,693,119
Salvador Das Missões,431647,RS,Sul,PFIZER/BIONTECH,132,132,0
Salvador Do Sul,431650,RS,Sul,BUTANTAN/SINOVAC,2271,1141,1130
Salvador Do Sul,431650,RS,Sul,FIOCRUZ/ASTRAZENECA,1664,1569,95
Salvador Do Sul,431650,RS,Sul,PFIZER/BIONTECH,251,251,0
Salvaterra,150630,PA,Norte,FIOCRUZ/ASTRAZENECA,5389,5244,145
Salvaterra,150630,PA,Norte,BUTANTAN/SINOVAC,1315,686,629
Sambaíba,210970,MA,Nordeste,FIOCRUZ/ASTRAZENECA,1251,1161,90
Sambaíba,210970,MA,Nordeste,BUTANTAN/SINOVAC,1043,551,492
Sampaio,171880,TO,Norte,BUTANTAN/SINOVAC,692,354,338
Sampaio,171880,TO,Norte,FIOCRUZ/ASTRAZENECA,505,439,66
Sananduva,431660,RS,Sul,FIOCRUZ/ASTRAZENECA,5055,4373,682
Sananduva,431660,RS,Sul,BUTANTAN/SINOVAC,4705,2354,2351
Sananduva,431660,RS,Sul,PFIZER/BIONTECH,612,611,1
Sanclerlândia,521900,GO,Centro-Oeste,FIOCRUZ/ASTRAZENECA,2299,2156,143
Sanclerlândia,521900,GO,Centro-Oeste,BUTANTAN/SINOVAC,1782,970,812
Sandolândia,171884,TO,Norte,BUTANTAN/SINOVAC,903,461,442
Sandolândia,171884,TO,Norte,FIOCRUZ/ASTRAZENECA,594,566,28
Sandovalina,354550,SP,Sudeste,FIOCRUZ/ASTRAZENECA,1006,954,52
Sandovalina,354550,SP,Sudeste,BUTANTAN/SINOVAC,954,493,461
Sandovalina,354550,SP,Sudeste,PFIZER/BIONTECH,116,116,0
Sangão,421545,SC,Sul,FIOCRUZ/ASTRAZENECA,3504,3279,225
Sangão,421545,SC,Sul,BUTANTAN/SINOVAC,2285,1216,1069
Sangão,421545,SC,Sul,PFIZER/BIONTECH,222,222,0
Sanharó,261240,PE,Nordeste,FIOCRUZ/ASTRAZENECA,2942,2666,276
Sanharó,261240,PE,Nordeste,BUTANTAN/SINOVAC,2791,1566,1225
Sanharó,261240,PE,Nordeste,PFIZER/BIONTECH,104,104,0
Sant'Ana Do Livramento,431710,RS,Sul,BUTANTAN/SINOVAC,23299,11803,11496
Sant'Ana Do Livramento,431710,RS,Sul,FIOCRUZ/ASTRAZENECA,21801,19932,1869
Sant'Ana Do Livramento,431710,RS,Sul,PFIZER/BIONTECH,2485,2485,0
Santa Adélia,354560,SP,Sudeste,BUTANTAN/SINOVAC,3714,2015,1699
Santa Adélia,354560,SP,Sudeste,FIOCRUZ/ASTRAZENECA,3400,3107,293
Santa Adélia,354560,SP,Sudeste,PFIZER/BIONTECH,361,361,0
Santa Albertina,354570,SP,Sudeste,BUTANTAN/SINOVAC,2042,1162,880
Santa Albertina,354570,SP,Sudeste,FIOCRUZ/ASTRAZENECA,1896,1714,182
Santa Albertina,354570,SP,Sudeste,PFIZER/BIONTECH,173,158,15
Santa Amélia,412310,PR,Sul,FIOCRUZ/ASTRAZENECA,1212,1143,69
Santa Amélia,412310,PR,Sul,BUTANTAN/SINOVAC,1146,598,548
Santa Bárbara,292750,BA,Nordeste,BUTANTAN/SINOVAC,3489,1878,1611
Santa Bárbara,292750,BA,Nordeste,FIOCRUZ/ASTRAZENECA,3345,2938,407
Santa Bárbara,292750,BA,Nordeste,PFIZER/BIONTECH,832,832,0
Santa Bárbara,315720,MG,Sudeste,FIOCRUZ/ASTRAZENECA,5459,5092,367
Santa Bárbara,315720,MG,Sudeste,BUTANTAN/SINOVAC,4829,2494,2335
Santa Bárbara,315720,MG,Sudeste,PFIZER/BIONTECH,854,854,0
Santa Bárbara D'Oeste,354580,SP,Sudeste,FIOCRUZ/ASTRAZENECA,40246,37576,2670
Santa Bárbara D'Oeste,354580,SP,Sudeste,BUTANTAN/SINOVAC,39438,21855,17583
Santa Bárbara D'Oeste,354580,SP,Sudeste,PFIZER/BIONTECH,2891,2886,5
Santa Bárbara De Goiás,521910,GO,Centro-Oeste,FIOCRUZ/ASTRAZENECA,1595,1486,109
Santa Bárbara De Goiás,521910,GO,Centro-Oeste,BUTANTAN/SINOVAC,1200,614,586
Santa Bárbara Do Leste,315725,MG,Sudeste,BUTANTAN/SINOVAC,2023,1029,994
Santa Bárbara Do Leste,315725,MG,Sudeste,FIOCRUZ/ASTRAZENECA,1878,1736,142
Santa Bárbara Do Leste,315725,MG,Sudeste,PFIZER/BIONTECH,237,237,0
Santa Bárbara Do Monte Verde,315727,MG,Sudeste,BUTANTAN/SINOVAC,234,177,57
Santa Bárbara Do Monte Verde,315727,MG,Sudeste,FIOCRUZ/ASTRAZENECA,145,138,7
Santa Bárbara Do Pará,150635,PA,Norte,BUTANTAN/SINOVAC,3876,2094,1782
Santa Bárbara Do Pará,150635,PA,Norte,FIOCRUZ/ASTRAZENECA,3469,3071,398
Santa Bárbara Do Pará,150635,PA,Norte,PFIZER/BIONTECH,1115,1114,1
Santa Bárbara Do Sul,431670,RS,Sul,BUTANTAN/SINOVAC,2339,1183,1156
Santa Bárbara Do Sul,431670,RS,Sul,FIOCRUZ/ASTRAZENECA,2315,2130,185
Santa Bárbara Do Sul,431670,RS,Sul,PFIZER/BIONTECH,306,305,1
Santa Bárbara Do Tugúrio,315730,MG,Sudeste,BUTANTAN/SINOVAC,988,503,485
Santa Bárbara Do Tugúrio,315730,MG,Sudeste,FIOCRUZ/ASTRAZENECA,922,821,101
Santa Bárbara Do Tugúrio,315730,MG,Sudeste,PFIZER/BIONTECH,12,12,0
Santa Branca,354600,SP,Sudeste,BUTANTAN/SINOVAC,3314,1813,1501
Santa Branca,354600,SP,Sudeste,FIOCRUZ/ASTRAZENECA,3160,2944,216
Santa Branca,354600,SP,Sudeste,PFIZER/BIONTECH,351,351,0
Santa Brígida,292760,BA,Nordeste,FIOCRUZ/ASTRAZENECA,2759,2615,144
Santa Brígida,292760,BA,Nordeste,BUTANTAN/SINOVAC,2338,1246,1092
Santa Brígida,292760,BA,Nordeste,PFIZER/BIONTECH,79,79,0
Santa Carmem,510724,MT,Centro-Oeste,FIOCRUZ/ASTRAZENECA,801,748,53
Santa Carmem,510724,MT,Centro-Oeste,BUTANTAN/SINOVAC,600,299,301
Santa Carmem,510724,MT,Centro-Oeste,PFIZER/BIONTECH,36,36,0
Santa Cecília,251315,PB,Nordeste,BUTANTAN/SINOVAC,1250,743,507
Santa Cecília,251315,PB,Nordeste,FIOCRUZ/ASTRAZENECA,903,838,65
Santa Cecília,251315,PB,Nordeste,PFIZER/BIONTECH,132,132,0
Santa Cecília,421550,SC,Sul,FIOCRUZ/ASTRAZENECA,3367,3125,242
Santa Cecília,421550,SC,Sul,BUTANTAN/SINOVAC,2610,1471,1139
Santa Cecília,421550,SC,Sul,PFIZER/BIONTECH,314,314,0
Santa Cecília Do Pavão,412320,PR,Sul,FIOCRUZ/ASTRAZENECA,1695,1635,60
Santa Cecília Do Pavão,412320,PR,Sul,BUTANTAN/SINOVAC,1031,530,501
Santa Cecília Do Pavão,412320,PR,Sul,PFIZER/BIONTECH,19,19,0
Santa Cecília Do Sul,431673,RS,Sul,BUTANTAN/SINOVAC,597,299,298
Santa Cecília Do Sul,431673,RS,Sul,FIOCRUZ/ASTRAZENECA,480,394,86
Santa Cecília Do Sul,431673,RS,Sul,PFIZER/BIONTECH,80,79,1
Santa Clara D'Oeste,354610,SP,Sudeste,BUTANTAN/SINOVAC,1264,676,588
Santa Clara D'Oeste,354610,SP,Sudeste,FIOCRUZ/ASTRAZENECA,910,837,73
Santa Clara D'Oeste,354610,SP,Sudeste,PFIZER/BIONTECH,70,70,0
Santa Clara Do Sul,431675,RS,Sul,BUTANTAN/SINOVAC,2058,1030,1028
Santa Clara Do Sul,431675,RS,Sul,FIOCRUZ/ASTRAZENECA,1705,1510,195
Santa Clara Do Sul,431675,RS,Sul,PFIZER/BIONTECH,232,232,0
Santa Cruz,241120,RN,Nordeste,BUTANTAN/SINOVAC,7006,3617,3389
Santa Cruz,241120,RN,Nordeste,FIOCRUZ/ASTRAZENECA,6737,5943,794
Santa Cruz,241120,RN,Nordeste,PFIZER/BIONTECH,1060,1060,0
Santa Cruz,251320,PB,Nordeste,BUTANTAN/SINOVAC,2422,1277,1145
Santa Cruz,251320,PB,Nordeste,FIOCRUZ/ASTRAZENECA,1387,1234,153
Santa Cruz,251320,PB,Nordeste,PFIZER/BIONTECH,84,84,0
Santa Cruz,261245,PE,Nordeste,FIOCRUZ/ASTRAZENECA,2868,2617,251
Santa Cruz,261245,PE,Nordeste,BUTANTAN/SINOVAC,2677,1347,1330
Santa Cruz,261245,PE,Nordeste,PFIZER/BIONTECH,412,412,0
Santa Cruz Cabrália,292770,BA,Nordeste,BUTANTAN/SINOVAC,7011,3818,3193
Santa Cruz Cabrália,292770,BA,Nordeste,FIOCRUZ/ASTRAZENECA,2479,2091,388
Santa Cruz Da Baixa Verde,261247,PE,Nordeste,FIOCRUZ/ASTRAZENECA,2647,2411,236
Santa Cruz Da Baixa Verde,261247,PE,Nordeste,BUTANTAN/SINOVAC,2533,1353,1180
Santa Cruz Da Baixa Verde,261247,PE,Nordeste,PFIZER/BIONTECH,420,420,0
Santa Cruz Da Conceição,354620,SP,Sudeste,BUTANTAN/SINOVAC,1539,876,663
Santa Cruz Da Conceição,354620,SP,Sudeste,FIOCRUZ/ASTRAZENECA,1202,1057,145
Santa Cruz Da Conceição,354620,SP,Sudeste,PFIZER/BIONTECH,103,103,0
Santa Cruz Da Esperança,354625,SP,Sudeste,BUTANTAN/SINOVAC,765,421,344
Santa Cruz Da Esperança,354625,SP,Sudeste,FIOCRUZ/ASTRAZENECA,478,426,52
Santa Cruz Da Esperança,354625,SP,Sudeste,PFIZER/BIONTECH,56,56,0
Santa Cruz Da Vitória,292780,BA,Nordeste,BUTANTAN/SINOVAC,1271,667,604
Santa Cruz Da Vitória,292780,BA,Nordeste,FIOCRUZ/ASTRAZENECA,1042,936,106
Santa Cruz Das Palmeiras,354630,SP,Sudeste,BUTANTAN/SINOVAC,6101,3523,2578
Santa Cruz Das Palmeiras,354630,SP,Sudeste,FIOCRUZ/ASTRAZENECA,5799,5391,408
Santa Cruz Das Palmeiras,354630,SP,Sudeste,PFIZER/BIONTECH,816,816,0
Santa Cruz De Goiás,521920,GO,Centro-Oeste,BUTANTAN/SINOVAC,936,534,402
Santa Cruz De Goiás,521920,GO,Centro-Oeste,FIOCRUZ/ASTRAZENECA,919,870,49
Santa Cruz De Minas,315733,MG,Sudeste,FIOCRUZ/ASTRAZENECA,1811,1710,101
Santa Cruz De Minas,315733,MG,Sudeste,BUTANTAN/SINOVAC,1318,674,644
Santa Cruz De Minas,315733,MG,Sudeste,PFIZER/BIONTECH,131,131,0
Santa Cruz De Monte Castelo,412330,PR,Sul,FIOCRUZ/ASTRAZENECA,2513,2357,156
Santa Cruz De Monte Castelo,412330,PR,Sul,BUTANTAN/SINOVAC,1959,1036,923
Santa Cruz De Monte Castelo,412330,PR,Sul,PFIZER/BIONTECH,120,120,0
Santa Cruz De Salinas,315737,MG,Sudeste,BUTANTAN/SINOVAC,1296,635,661
Santa Cruz De Salinas,315737,MG,Sudeste,FIOCRUZ/ASTRAZENECA,683,630,53
Santa Cruz Do Arari,150640,PA,Norte,FIOCRUZ/ASTRAZENECA,854,791,63
Santa Cruz Do Arari,150640,PA,Norte,BUTANTAN/SINOVAC,471,274,197
Santa Cruz Do Capibaribe,261250,PE,Nordeste,FIOCRUZ/ASTRAZENECA,12798,11997,801
Santa Cruz Do Capibaribe,261250,PE,Nordeste,BUTANTAN/SINOVAC,9501,5153,4348
Santa Cruz Do Capibaribe,261250,PE,Nordeste,PFIZER/BIONTECH,811,810,1
Santa Cruz Do Escalvado,315740,MG,Sudeste,FIOCRUZ/ASTRAZENECA,2275,2172,103
Santa Cruz Do Escalvado,315740,MG,Sudeste,BUTANTAN/SINOVAC,1296,657,639
Santa Cruz Do Escalvado,315740,MG,Sudeste,PFIZER/BIONTECH,87,87,0
Santa Cruz Do Piauí,220910,PI,Nordeste,FIOCRUZ/ASTRAZENECA,2053,1393,660
Santa Cruz Do Piauí,220910,PI,Nordeste,BUTANTAN/SINOVAC,1263,633,630
Santa Cruz Do Rio Pardo,354640,SP,Sudeste,BUTANTAN/SINOVAC,12743,7008,5735
Santa Cruz Do Rio Pardo,354640,SP,Sudeste,FIOCRUZ/ASTRAZENECA,12333,11404,929
Santa Cruz Do Rio Pardo,354640,SP,Sudeste,PFIZER/BIONTECH,1234,1234,0
Santa Cruz Do Sul,431680,RS,Sul,BUTANTAN/SINOVAC,36124,18529,17595
Santa Cruz Do Sul,431680,RS,Sul,FIOCRUZ/ASTRAZENECA,35706,32500,3206
Santa Cruz Do Sul,431680,RS,Sul,PFIZER/BIONTECH,4382,4372,10
Santa Cruz Do Xingu,510774,MT,Centro-Oeste,BUTANTAN/SINOVAC,397,205,192
Santa Cruz Do Xingu,510774,MT,Centro-Oeste,FIOCRUZ/ASTRAZENECA,316,304,12
Santa Cruz Dos Milagres,220915,PI,Nordeste,FIOCRUZ/ASTRAZENECA,718,657,61
Santa Cruz Dos Milagres,220915,PI,Nordeste,BUTANTAN/SINOVAC,697,353,344
Santa Cruz Dos Milagres,220915,PI,Nordeste,PFIZER/BIONTECH,95,95,0
Santa Efigênia De Minas,315750,MG,Sudeste,FIOCRUZ/ASTRAZENECA,1229,1104,125
Santa Efigênia De Minas,315750,MG,Sudeste,BUTANTAN/SINOVAC,1095,562,533
Santa Efigênia De Minas,315750,MG,Sudeste,PFIZER/BIONTECH,75,75,0
Santa Ernestina,354650,SP,Sudeste,FIOCRUZ/ASTRAZENECA,1340,1245,95
Santa Ernestina,354650,SP,Sudeste,BUTANTAN/SINOVAC,1148,652,496
Santa Ernestina,354650,SP,Sudeste,PFIZER/BIONTECH,154,154,0
Santa Fé,412340,PR,Sul,FIOCRUZ/ASTRAZENECA,3535,3327,208
Santa Fé,412340,PR,Sul,BUTANTAN/SINOVAC,2682,1381,1301
Santa Fé,412340,PR,Sul,PFIZER/BIONTECH,148,148,0
Santa Fé De Goiás,521925,GO,Centro-Oeste,FIOCRUZ/ASTRAZENECA,1186,1115,71
Santa Fé De Goiás,521925,GO,Centro-Oeste,BUTANTAN/SINOVAC,989,545,444
Santa Fé De Minas,315760,MG,Sudeste,FIOCRUZ/ASTRAZENECA,899,867,32
Santa Fé De Minas,315760,MG,Sudeste,BUTANTAN/SINOVAC,794,413,381
Santa Fé De Minas,315760,MG,Sudeste,PFIZER/BIONTECH,35,35,0
Santa Fé Do Araguaia,171886,TO,Norte,FIOCRUZ/ASTRAZENECA,1897,1653,244
Santa Fé Do Araguaia,171886,TO,Norte,BUTANTAN/SINOVAC,1497,790,707
Santa Fé Do Sul,354660,SP,Sudeste,BUTANTAN/SINOVAC,10534,5747,4787
Santa Fé Do Sul,354660,SP,Sudeste,FIOCRUZ/ASTRAZENECA,9257,8319,938
Santa Fé Do Sul,354660,SP,Sudeste,PFIZER/BIONTECH,241,241,0
Santa Filomena,220920,PI,Nordeste,FIOCRUZ/ASTRAZENECA,1167,1058,109
Santa Filomena,220920,PI,Nordeste,BUTANTAN/SINOVAC,854,451,403
Santa Filomena,220920,PI,Nordeste,PFIZER/BIONTECH,150,150,0
Santa Filomena,261255,PE,Nordeste,FIOCRUZ/ASTRAZENECA,2655,2413,242
Santa Filomena,261255,PE,Nordeste,BUTANTAN/SINOVAC,2547,1301,1246
Santa Filomena,261255,PE,Nordeste,PFIZER/BIONTECH,94,94,0
Santa Filomena Do Maranhão,210975,MA,Nordeste,FIOCRUZ/ASTRAZENECA,1019,949,70
Santa Filomena Do Maranhão,210975,MA,Nordeste,BUTANTAN/SINOVAC,880,470,410
Santa Gertrudes,354670,SP,Sudeste,FIOCRUZ/ASTRAZENECA,5718,5371,347
Santa Gertrudes,354670,SP,Sudeste,BUTANTAN/SINOVAC,3822,2241,1581
Santa Gertrudes,354670,SP,Sudeste,PFIZER/BIONTECH,653,653,0
Santa Helena,210980,MA,Nordeste,FIOCRUZ/ASTRAZENECA,10563,9339,1224
Santa Helena,210980,MA,Nordeste,BUTANTAN/SINOVAC,4795,2446,2349
Santa Helena,251330,PB,Nordeste,BUTANTAN/SINOVAC,1770,929,841
Santa Helena,251330,PB,Nordeste,FIOCRUZ/ASTRAZENECA,999,893,106
Santa Helena,251330,PB,Nordeste,PFIZER/BIONTECH,161,161,0
Santa Helena,412350,PR,Sul,FIOCRUZ/ASTRAZENECA,6823,6441,382
Santa Helena,412350,PR,Sul,BUTANTAN/SINOVAC,6313,3236,3077
Santa Helena,412350,PR,Sul,PFIZER/BIONTECH,329,329,0
Santa Helena,412350,PR,Sul,-,119,42,77
Santa Helena,421555,SC,Sul,FIOCRUZ/ASTRAZENECA,626,569,57
Santa Helena,421555,SC,Sul,BUTANTAN/SINOVAC,600,313,287
Santa Helena,421555,SC,Sul,PFIZER/BIONTECH,77,77,0
Santa Helena De Goiás,521930,GO,Centro-Oeste,FIOCRUZ/ASTRAZENECA,10740,9784,956
Santa Helena De Goiás,521930,GO,Centro-Oeste,BUTANTAN/SINOVAC,7850,4090,3760
Santa Helena De Goiás,521930,GO,Centro-Oeste,PFIZER/BIONTECH,471,471,0
Santa Helena De Minas,315765,MG,Sudeste,BUTANTAN/SINOVAC,2396,1239,1157
Santa Helena De Minas,315765,MG,Sudeste,FIOCRUZ/ASTRAZENECA,925,811,114
Santa Helena De Minas,315765,MG,Sudeste,PFIZER/BIONTECH,2,2,0
Santa Inês,210990,MA,Nordeste,FIOCRUZ/ASTRAZENECA,22438,21469,969
Santa Inês,210990,MA,Nordeste,BUTANTAN/SINOVAC,13210,7077,6133
Santa Inês,210990,MA,Nordeste,PFIZER/BIONTECH,4481,4481,0
Santa Inês,251335,PB,Nordeste,BUTANTAN/SINOVAC,703,364,339
Santa Inês,251335,PB,Nordeste,FIOCRUZ/ASTRAZENECA,658,608,50
Santa Inês,251335,PB,Nordeste,PFIZER/BIONTECH,59,59,0
Santa Inês,292790,BA,Nordeste,FIOCRUZ/ASTRAZENECA,2581,2347,234
Santa Inês,292790,BA,Nordeste,BUTANTAN/SINOVAC,2209,1246,963
Santa Inês,292790,BA,Nordeste,PFIZER/BIONTECH,180,180,0
Santa Inês,412360,PR,Sul,FIOCRUZ/ASTRAZENECA,859,809,50
Santa Inês,412360,PR,Sul,BUTANTAN/SINOVAC,455,242,213
Santa Isabel,354680,SP,Sudeste,FIOCRUZ/ASTRAZENECA,11888,11184,704
Santa Isabel,354680,SP,Sudeste,BUTANTAN/SINOVAC,10698,5964,4734
Santa Isabel,354680,SP,Sudeste,PFIZER/BIONTECH,464,460,4
Santa Isabel,521935,GO,Centro-Oeste,FIOCRUZ/ASTRAZENECA,1454,1392,62
Santa Isabel,521935,GO,Centro-Oeste,BUTANTAN/SINOVAC,829,442,387
Santa Isabel,521935,GO,Centro-Oeste,PFIZER/BIONTECH,12,12,0
Santa Isabel Do Ivaí,412370,PR,Sul,FIOCRUZ/ASTRAZENECA,2374,2192,182
Santa Isabel Do Ivaí,412370,PR,Sul,BUTANTAN/SINOVAC,2213,1155,1058
Santa Isabel Do Ivaí,412370,PR,Sul,PFIZER/BIONTECH,124,124,0
Santa Isabel Do Rio Negro,130360,AM,Norte,BUTANTAN/SINOVAC,4709,2563,2146
Santa Isabel Do Rio Negro,130360,AM,Norte,FIOCRUZ/ASTRAZENECA,1239,837,402
Santa Izabel Do Oeste,412380,PR,Sul,FIOCRUZ/ASTRAZENECA,3622,3402,220
Santa Izabel Do Oeste,412380,PR,Sul,BUTANTAN/SINOVAC,3020,1541,1479
Santa Izabel Do Oeste,412380,PR,Sul,PFIZER/BIONTECH,188,188,0
Santa Izabel Do Pará,150650,PA,Norte,FIOCRUZ/ASTRAZENECA,12286,9566,2720
Santa Izabel Do Pará,150650,PA,Norte,BUTANTAN/SINOVAC,8959,4827,4132
Santa Juliana,315770,MG,Sudeste,FIOCRUZ/ASTRAZENECA,2767,2545,222
Santa Juliana,315770,MG,Sudeste,BUTANTAN/SINOVAC,2047,1071,976
Santa Juliana,315770,MG,Sudeste,PFIZER/BIONTECH,367,367,0
Santa Leopoldina,320450,ES,Sudeste,BUTANTAN/SINOVAC,3436,1868,1568
Santa Leopoldina,320450,ES,Sudeste,FIOCRUZ/ASTRAZENECA,3224,3086,138
Santa Leopoldina,320450,ES,Sudeste,PFIZER/BIONTECH,392,390,2
Santa Lúcia,354690,SP,Sudeste,FIOCRUZ/ASTRAZENECA,1775,1669,106
Santa Lúcia,354690,SP,Sudeste,BUTANTAN/SINOVAC,1265,724,541
Santa Lúcia,354690,SP,Sudeste,PFIZER/BIONTECH,226,226,0
Santa Lúcia,412382,PR,Sul,BUTANTAN/SINOVAC,937,483,454
Santa Lúcia,412382,PR,Sul,FIOCRUZ/ASTRAZENECA,813,754,59
Santa Lúcia,412382,PR,Sul,PFIZER/BIONTECH,6,6,0
Santa Luz,220930,PI,Nordeste,FIOCRUZ/ASTRAZENECA,1016,965,51
Santa Luz,220930,PI,Nordeste,BUTANTAN/SINOVAC,963,539,424
Santa Luzia,211000,MA,Nordeste,FIOCRUZ/ASTRAZENECA,11590,10919,671
Santa Luzia,211000,MA,Nordeste,BUTANTAN/SINOVAC,9485,5140,4345
Santa Luzia,251340,PB,Nordeste,BUTANTAN/SINOVAC,3958,2029,1929
Santa Luzia,251340,PB,Nordeste,FIOCRUZ/ASTRAZENECA,3945,3625,320
Santa Luzia,251340,PB,Nordeste,PFIZER/BIONTECH,475,475,0
Santa Luzia,292805,BA,Nordeste,FIOCRUZ/ASTRAZENECA,2570,2423,147
Santa Luzia,292805,BA,Nordeste,BUTANTAN/SINOVAC,2567,1341,1226
Santa Luzia,292805,BA,Nordeste,PFIZER/BIONTECH,106,106,0
Santa Luzia,315780,MG,Sudeste,FIOCRUZ/ASTRAZENECA,31323,29307,2016
Santa Luzia,315780,MG,Sudeste,BUTANTAN/SINOVAC,29632,15819,13813
Santa Luzia,315780,MG,Sudeste,PFIZER/BIONTECH,2212,2211,1
Santa Luzia D'Oeste,110029,RO,Norte,BUTANTAN/SINOVAC,1722,880,842
Santa Luzia D'Oeste,110029,RO,Norte,FIOCRUZ/ASTRAZENECA,1339,1302,37
Santa Luzia D'Oeste,110029,RO,Norte,PFIZER/BIONTECH,38,38,0
Santa Luzia Do Itanhy,280630,SE,Nordeste,FIOCRUZ/ASTRAZENECA,4029,3927,102
Santa Luzia Do Itanhy,280630,SE,Nordeste,BUTANTAN/SINOVAC,1698,866,832
Santa Luzia Do Itanhy,280630,SE,Nordeste,PFIZER/BIONTECH,131,131,0
Santa Luzia Do Norte,270790,AL,Nordeste,FIOCRUZ/ASTRAZENECA,2693,2455,238
Santa Luzia Do Norte,270790,AL,Nordeste,BUTANTAN/SINOVAC,1348,756,592
Santa Luzia Do Pará,150655,PA,Norte,FIOCRUZ/ASTRAZENECA,4215,3884,331
Santa Luzia Do Pará,150655,PA,Norte,BUTANTAN/SINOVAC,2484,1289,1195
Santa Luzia Do Paruá,211003,MA,Nordeste,FIOCRUZ/ASTRAZENECA,4210,3954,256
Santa Luzia Do Paruá,211003,MA,Nordeste,BUTANTAN/SINOVAC,2894,1476,1418
Santa Margarida,315790,MG,Sudeste,BUTANTAN/SINOVAC,2554,1335,1219
Santa Margarida,315790,MG,Sudeste,FIOCRUZ/ASTRAZENECA,1371,1363,8
Santa Margarida Do Sul,431697,RS,Sul,FIOCRUZ/ASTRAZENECA,790,705,85
Santa Margarida Do Sul,431697,RS,Sul,BUTANTAN/SINOVAC,705,355,350
Santa Margarida Do Sul,431697,RS,Sul,PFIZER/BIONTECH,113,113,0
Santa Maria,240933,RN,Nordeste,BUTANTAN/SINOVAC,955,489,466
Santa Maria,240933,RN,Nordeste,FIOCRUZ/ASTRAZENECA,685,631,54
Santa Maria,240933,RN,Nordeste,PFIZER/BIONTECH,70,70,0
Santa Maria,431690,RS,Sul,FIOCRUZ/ASTRAZENECA,60342,58782,1560
Santa Maria,431690,RS,Sul,BUTANTAN/SINOVAC,59517,32779,26738
Santa Maria,431690,RS,Sul,PFIZER/BIONTECH,2928,2924,4
Santa Maria Da Boa Vista,261260,PE,Nordeste,FIOCRUZ/ASTRAZENECA,9026,8522,504
Santa Maria Da Boa Vista,261260,PE,Nordeste,BUTANTAN/SINOVAC,5394,2772,2622
Santa Maria Da Boa Vista,261260,PE,Nordeste,PFIZER/BIONTECH,828,828,0
Santa Maria Da Serra,354700,SP,Sudeste,BUTANTAN/SINOVAC,1303,649,654
Santa Maria Da Serra,354700,SP,Sudeste,FIOCRUZ/ASTRAZENECA,1294,1169,125
Santa Maria Da Serra,354700,SP,Sudeste,PFIZER/BIONTECH,185,185,0
Santa Maria Da Vitória,292810,BA,Nordeste,BUTANTAN/SINOVAC,4684,3513,1171
Santa Maria Da Vitória,292810,BA,Nordeste,FIOCRUZ/ASTRAZENECA,3092,2879,213
Santa Maria Da Vitória,292810,BA,Nordeste,PFIZER/BIONTECH,83,83,0
Santa Maria Das Barreiras,150658,PA,Norte,FIOCRUZ/ASTRAZENECA,2579,2045,534
Santa Maria Das Barreiras,150658,PA,Norte,BUTANTAN/SINOVAC,2434,1291,1143
Santa Maria De Itabira,315800,MG,Sudeste,FIOCRUZ/ASTRAZENECA,2922,2778,144
Santa Maria De Itabira,315800,MG,Sudeste,BUTANTAN/SINOVAC,2356,1334,1022
Santa Maria De Itabira,315800,MG,Sudeste,PFIZER/BIONTECH,246,246,0
Santa Maria De Jetibá,320455,ES,Sudeste,BUTANTAN/SINOVAC,8554,4353,4201
Santa Maria De Jetibá,320455,ES,Sudeste,FIOCRUZ/ASTRAZENECA,7667,7382,285
Santa Maria De Jetibá,320455,ES,Sudeste,PFIZER/BIONTECH,1648,1646,2
Santa Maria Do Cambucá,261270,PE,Nordeste,BUTANTAN/SINOVAC,2643,1354,1289
Santa Maria Do Cambucá,261270,PE,Nordeste,FIOCRUZ/ASTRAZENECA,1645,1371,274
Santa Maria Do Cambucá,261270,PE,Nordeste,PFIZER/BIONTECH,138,135,3
Santa Maria Do Herval,431695,RS,Sul,BUTANTAN/SINOVAC,2005,1029,976
Santa Maria Do Herval,431695,RS,Sul,FIOCRUZ/ASTRAZENECA,1655,1574,81
Santa Maria Do Herval,431695,RS,Sul,PFIZER/BIONTECH,247,247,0
Santa Maria Do Oeste,412385,PR,Sul,FIOCRUZ/ASTRAZENECA,2618,2516,102
Santa Maria Do Oeste,412385,PR,Sul,BUTANTAN/SINOVAC,2035,1081,954
Santa Maria Do Oeste,412385,PR,Sul,PFIZER/BIONTECH,92,92,0
Santa Maria Do Pará,150660,PA,Norte,FIOCRUZ/ASTRAZENECA,4715,4280,435
Santa Maria Do Pará,150660,PA,Norte,BUTANTAN/SINOVAC,3617,2114,1503
Santa Maria Do Salto,315810,MG,Sudeste,BUTANTAN/SINOVAC,1371,782,589
Santa Maria Do Salto,315810,MG,Sudeste,FIOCRUZ/ASTRAZENECA,674,628,46
Santa Maria Do Salto,315810,MG,Sudeste,PFIZER/BIONTECH,43,43,0
Santa Maria Do Suaçuí,315820,MG,Sudeste,BUTANTAN/SINOVAC,3215,1634,1581
Santa Maria Do Suaçuí,315820,MG,Sudeste,FIOCRUZ/ASTRAZENECA,2518,2244,274
Santa Maria Do Tocantins,171888,TO,Norte,BUTANTAN/SINOVAC,654,329,325
Santa Maria Do Tocantins,171888,TO,Norte,FIOCRUZ/ASTRAZENECA,573,552,21
Santa Maria Madalena,330460,RJ,Sudeste,BUTANTAN/SINOVAC,2619,1345,1274
Santa Maria Madalena,330460,RJ,Sudeste,FIOCRUZ/ASTRAZENECA,2560,2382,178
Santa Mariana,412390,PR,Sul,FIOCRUZ/ASTRAZENECA,3567,3313,254
Santa Mariana,412390,PR,Sul,BUTANTAN/SINOVAC,3500,1815,1685
Santa Mariana,412390,PR,Sul,PFIZER/BIONTECH,117,117,0
Santa Mercedes,354710,SP,Sudeste,FIOCRUZ/ASTRAZENECA,840,754,86
Santa Mercedes,354710,SP,Sudeste,BUTANTAN/SINOVAC,762,396,366
Santa Mercedes,354710,SP,Sudeste,PFIZER/BIONTECH,71,71,0
Santa Mônica,412395,PR,Sul,FIOCRUZ/ASTRAZENECA,804,760,44
Santa Mônica,412395,PR,Sul,BUTANTAN/SINOVAC,586,336,250
Santa Mônica,412395,PR,Sul,PFIZER/BIONTECH,6,6,0
Santa Quitéria,231220,CE,Nordeste,BUTANTAN/SINOVAC,8372,4471,3901
Santa Quitéria,231220,CE,Nordeste,FIOCRUZ/ASTRAZENECA,4505,3962,543
Santa Quitéria,231220,CE,Nordeste,PFIZER/BIONTECH,112,112,0
Santa Quitéria Do Maranhão,211010,MA,Nordeste,FIOCRUZ/ASTRAZENECA,5879,5670,209
Santa Quitéria Do Maranhão,211010,MA,Nordeste,BUTANTAN/SINOVAC,3262,1742,1520
Santa Rita,211020,MA,Nordeste,FIOCRUZ/ASTRAZENECA,16672,12931,3741
Santa Rita,211020,MA,Nordeste,BUTANTAN/SINOVAC,4976,2619,2357
Santa Rita,251370,PB,Nordeste,BUTANTAN/SINOVAC,23902,12945,10957
Santa Rita,251370,PB,Nordeste,FIOCRUZ/ASTRAZENECA,18882,17441,1441
Santa Rita,251370,PB,Nordeste,PFIZER/BIONTECH,1103,1103,0
Santa Rita D'Oeste,354740,SP,Sudeste,BUTANTAN/SINOVAC,959,523,436
Santa Rita D'Oeste,354740,SP,Sudeste,FIOCRUZ/ASTRAZENECA,792,724,68
Santa Rita D'Oeste,354740,SP,Sudeste,PFIZER/BIONTECH,30,30,0
Santa Rita De Caldas,315920,MG,Sudeste,FIOCRUZ/ASTRAZENECA,2289,2119,170
Santa Rita De Caldas,315920,MG,Sudeste,BUTANTAN/SINOVAC,2213,1127,1086
Santa Rita De Caldas,315920,MG,Sudeste,PFIZER/BIONTECH,117,117,0
Santa Rita De Cássia,292840,BA,Nordeste,BUTANTAN/SINOVAC,6550,3610,2940
Santa Rita De Cássia,292840,BA,Nordeste,FIOCRUZ/ASTRAZENECA,4287,3997,290
Santa Rita De Cássia,292840,BA,Nordeste,PFIZER/BIONTECH,32,32,0
Santa Rita De Ibitipoca,315940,MG,Sudeste,FIOCRUZ/ASTRAZENECA,1281,911,370
Santa Rita De Ibitipoca,315940,MG,Sudeste,BUTANTAN/SINOVAC,841,433,408
Santa Rita De Ibitipoca,315940,MG,Sudeste,PFIZER/BIONTECH,52,52,0
Santa Rita De Jacutinga,315930,MG,Sudeste,FIOCRUZ/ASTRAZENECA,1584,1465,119
Santa Rita De Jacutinga,315930,MG,Sudeste,BUTANTAN/SINOVAC,1443,726,717
Santa Rita De Jacutinga,315930,MG,Sudeste,PFIZER/BIONTECH,76,76,0
Santa Rita De Minas,315935,MG,Sudeste,BUTANTAN/SINOVAC,1049,633,416
Santa Rita De Minas,315935,MG,Sudeste,FIOCRUZ/ASTRAZENECA,631,578,53
Santa Rita De Minas,315935,MG,Sudeste,PFIZER/BIONTECH,96,96,0
Santa Rita Do Araguaia,521940,GO,Centro-Oeste,BUTANTAN/SINOVAC,1207,674,533
Santa Rita Do Araguaia,521940,GO,Centro-Oeste,FIOCRUZ/ASTRAZENECA,840,757,83
Santa Rita Do Itueto,315950,MG,Sudeste,BUTANTAN/SINOVAC,1150,584,566
Santa Rita Do Itueto,315950,MG,Sudeste,FIOCRUZ/ASTRAZENECA,1019,928,91
Santa Rita Do Itueto,315950,MG,Sudeste,PFIZER/BIONTECH,41,41,0
Santa Rita Do Novo Destino,521945,GO,Centro-Oeste,FIOCRUZ/ASTRAZENECA,1315,1281,34
Santa Rita Do Novo Destino,521945,GO,Centro-Oeste,BUTANTAN/SINOVAC,537,276,261
Santa Rita Do Novo Destino,521945,GO,Centro-Oeste,PFIZER/BIONTECH,10,10,0
Santa Rita Do Pardo,500755,MS,Centro-Oeste,FIOCRUZ/ASTRAZENECA,1908,1763,145
Santa Rita Do Pardo,500755,MS,Centro-Oeste,BUTANTAN/SINOVAC,1833,990,843
Santa Rita Do Pardo,500755,MS,Centro-Oeste,PFIZER/BIONTECH,192,192,0
Santa Rita Do Passa Quatro,354750,SP,Sudeste,BUTANTAN/SINOVAC,8856,4782,4074
Santa Rita Do Passa Quatro,354750,SP,Sudeste,FIOCRUZ/ASTRAZENECA,7526,6882,644
Santa Rita Do Passa Quatro,354750,SP,Sudeste,PFIZER/BIONTECH,570,570,0
Santa Rita Do Sapucaí,315960,MG,Sudeste,BUTANTAN/SINOVAC,7407,3821,3586
Santa Rita Do Sapucaí,315960,MG,Sudeste,FIOCRUZ/ASTRAZENECA,5850,5704,146
Santa Rita Do Sapucaí,315960,MG,Sudeste,PFIZER/BIONTECH,885,885,0
Santa Rita Do Tocantins,171889,TO,Norte,BUTANTAN/SINOVAC,504,296,208
Santa Rita Do Tocantins,171889,TO,Norte,FIOCRUZ/ASTRAZENECA,460,431,29
Santa Rita Do Trivelato,510776,MT,Centro-Oeste,FIOCRUZ/ASTRAZENECA,904,856,48
Santa Rita Do Trivelato,510776,MT,Centro-Oeste,BUTANTAN/SINOVAC,393,205,188
Santa Rita Do Trivelato,510776,MT,Centro-Oeste,PFIZER/BIONTECH,56,56,0
Santa Rosa,431720,RS,Sul,FIOCRUZ/ASTRAZENECA,18961,17369,1592
Santa Rosa,431720,RS,Sul,BUTANTAN/SINOVAC,18777,9465,9312
Santa Rosa,431720,RS,Sul,PFIZER/BIONTECH,2738,2737,1
Santa Rosa Da Serra,315970,MG,Sudeste,BUTANTAN/SINOVAC,768,395,373
Santa Rosa Da Serra,315970,MG,Sudeste,FIOCRUZ/ASTRAZENECA,753,691,62
Santa Rosa Da Serra,315970,MG,Sudeste,PFIZER/BIONTECH,140,140,0
Santa Rosa De Goiás,521950,GO,Centro-Oeste,FIOCRUZ/ASTRAZENECA,785,725,60
Santa Rosa De Goiás,521950,GO,Centro-Oeste,BUTANTAN/SINOVAC,692,354,338
Santa Rosa De Lima,280650,SE,Nordeste,FIOCRUZ/ASTRAZENECA,431,428,3
Santa Rosa De Lima,280650,SE,Nordeste,BUTANTAN/SINOVAC,431,202,229
Santa Rosa De Lima,280650,SE,Nordeste,PFIZER/BIONTECH,38,38,0
Santa Rosa De Lima,421560,SC,Sul,FIOCRUZ/ASTRAZENECA,712,688,24
Santa Rosa De Lima,421560,SC,Sul,BUTANTAN/SINOVAC,560,331,229
Santa Rosa De Lima,421560,SC,Sul,PFIZER/BIONTECH,57,57,0
Santa Rosa De Viterbo,354760,SP,Sudeste,BUTANTAN/SINOVAC,5922,3139,2783
Santa Rosa De Viterbo,354760,SP,Sudeste,FIOCRUZ/ASTRAZENECA,5810,5356,454
Santa Rosa De Viterbo,354760,SP,Sudeste,PFIZER/BIONTECH,277,277,0
Santa Rosa Do Piauí,220937,PI,Nordeste,FIOCRUZ/ASTRAZENECA,1235,1167,68
Santa Rosa Do Piauí,220937,PI,Nordeste,BUTANTAN/SINOVAC,985,506,479
Santa Rosa Do Purus,120043,AC,Norte,BUTANTAN/SINOVAC,2888,1650,1238
Santa Rosa Do Purus,120043,AC,Norte,FIOCRUZ/ASTRAZENECA,761,702,59
Santa Rosa Do Sul,421565,SC,Sul,FIOCRUZ/ASTRAZENECA,2547,2344,203
Santa Rosa Do Sul,421565,SC,Sul,BUTANTAN/SINOVAC,2008,1076,932
Santa Rosa Do Sul,421565,SC,Sul,PFIZER/BIONTECH,227,227,0
Santa Rosa Do Tocantins,171890,TO,Norte,FIOCRUZ/ASTRAZENECA,965,936,29
Santa Rosa Do Tocantins,171890,TO,Norte,BUTANTAN/SINOVAC,928,517,411
Santa Salete,354765,SP,Sudeste,BUTANTAN/SINOVAC,975,504,471
Santa Salete,354765,SP,Sudeste,FIOCRUZ/ASTRAZENECA,662,564,98
Santa Salete,354765,SP,Sudeste,PFIZER/BIONTECH,77,75,2
Santa Teresa,320460,ES,Sudeste,BUTANTAN/SINOVAC,8264,4203,4061
Santa Teresa,320460,ES,Sudeste,FIOCRUZ/ASTRAZENECA,5567,5265,302
Santa Teresa,320460,ES,Sudeste,PFIZER/BIONTECH,1274,1274,0
Santa Teresinha,251380,PB,Nordeste,BUTANTAN/SINOVAC,1331,672,659
Santa Teresinha,251380,PB,Nordeste,FIOCRUZ/ASTRAZENECA,846,756,90
Santa Teresinha,251380,PB,Nordeste,PFIZER/BIONTECH,70,70,0
Santa Tereza,431725,RS,Sul,BUTANTAN/SINOVAC,726,363,363
Santa Tereza,431725,RS,Sul,FIOCRUZ/ASTRAZENECA,571,462,109
Santa Tereza,431725,RS,Sul,PFIZER/BIONTECH,72,72,0
Santa Tereza De Goiás,521960,GO,Centro-Oeste,FIOCRUZ/ASTRAZENECA,1280,1201,79
Santa Tereza De Goiás,521960,GO,Centro-Oeste,BUTANTAN/SINOVAC,727,373,354
Santa Tereza Do Oeste,412402,PR,Sul,FIOCRUZ/ASTRAZENECA,2485,2362,123
Santa Tereza Do Oeste,412402,PR,Sul,BUTANTAN/SINOVAC,1758,942,816
Santa Tereza Do Oeste,412402,PR,Sul,PFIZER/BIONTECH,113,113,0
Santa Tereza Do Tocantins,171900,TO,Norte,FIOCRUZ/ASTRAZENECA,1073,901,172
Santa Tereza Do Tocantins,171900,TO,Norte,BUTANTAN/SINOVAC,557,311,246
Santa Terezinha,261280,PE,Nordeste,FIOCRUZ/ASTRAZENECA,2278,2072,206
Santa Terezinha,261280,PE,Nordeste,BUTANTAN/SINOVAC,2264,1148,1116
Santa Terezinha,261280,PE,Nordeste,PFIZER/BIONTECH,96,96,0
Santa Terezinha,292850,BA,Nordeste,FIOCRUZ/ASTRAZENECA,2435,2267,168
Santa Terezinha,292850,BA,Nordeste,BUTANTAN/SINOVAC,2213,1141,1072
Santa Terezinha,292850,BA,Nordeste,PFIZER/BIONTECH,320,320,0
Santa Terezinha,421567,SC,Sul,FIOCRUZ/ASTRAZENECA,1570,1472,98
Santa Terezinha,421567,SC,Sul,BUTANTAN/SINOVAC,1369,692,677
Santa Terezinha,421567,SC,Sul,PFIZER/BIONTECH,163,163,0
Santa Terezinha,510777,MT,Centro-Oeste,BUTANTAN/SINOVAC,1894,1025,869
Santa Terezinha,510777,MT,Centro-Oeste,FIOCRUZ/ASTRAZENECA,1236,1152,84
Santa Terezinha,510777,MT,Centro-Oeste,PFIZER/BIONTECH,33,33,0
Santa Terezinha De Goiás,521970,GO,Centro-Oeste,FIOCRUZ/ASTRAZENECA,3107,2828,279
Santa Terezinha De Goiás,521970,GO,Centro-Oeste,BUTANTAN/SINOVAC,1797,965,832
Santa Terezinha De Goiás,521970,GO,Centro-Oeste,PFIZER/BIONTECH,71,71,0
Santa Terezinha De Itaipu,412405,PR,Sul,FIOCRUZ/ASTRAZENECA,5386,5097,289
Santa Terezinha De Itaipu,412405,PR,Sul,BUTANTAN/SINOVAC,4616,2409,2207
Santa Terezinha De Itaipu,412405,PR,Sul,PFIZER/BIONTECH,277,277,0
Santa Terezinha Do Progresso,421568,SC,Sul,BUTANTAN/SINOVAC,1540,806,734
Santa Terezinha Do Progresso,421568,SC,Sul,FIOCRUZ/ASTRAZENECA,1070,973,97
Santa Terezinha Do Progresso,421568,SC,Sul,PFIZER/BIONTECH,34,34,0
Santa Terezinha Do Tocantins,172000,TO,Norte,FIOCRUZ/ASTRAZENECA,572,543,29
Santa Terezinha Do Tocantins,172000,TO,Norte,BUTANTAN/SINOVAC,460,236,224
Santa Vitória,315980,MG,Sudeste,FIOCRUZ/ASTRAZENECA,4556,3922,634
Santa Vitória,315980,MG,Sudeste,BUTANTAN/SINOVAC,4089,2141,1948
Santa Vitória,315980,MG,Sudeste,PFIZER/BIONTECH,118,118,0
Santa Vitória Do Palmar,431730,RS,Sul,FIOCRUZ/ASTRAZENECA,8361,7602,759
Santa Vitória Do Palmar,431730,RS,Sul,BUTANTAN/SINOVAC,7697,4101,3596
Santa Vitória Do Palmar,431730,RS,Sul,PFIZER/BIONTECH,522,522,0
Santaluz,292800,BA,Nordeste,FIOCRUZ/ASTRAZENECA,7765,7019,746
Santaluz,292800,BA,Nordeste,BUTANTAN/SINOVAC,6715,3604,3111
Santaluz,292800,BA,Nordeste,PFIZER/BIONTECH,769,762,7
Santana,160060,AP,Norte,FIOCRUZ/ASTRAZENECA,24423,22149,2274
Santana,160060,AP,Norte,BUTANTAN/SINOVAC,19047,10032,9015
Santana,160060,AP,Norte,PFIZER/BIONTECH,3418,3415,3
Santana,292820,BA,Nordeste,BUTANTAN/SINOVAC,3203,2628,575
Santana,292820,BA,Nordeste,FIOCRUZ/ASTRAZENECA,609,609,0
Santana Da Boa Vista,431700,RS,Sul,BUTANTAN/SINOVAC,3590,1827,1763
Santana Da Boa Vista,431700,RS,Sul,FIOCRUZ/ASTRAZENECA,1959,1768,191
Santana Da Boa Vista,431700,RS,Sul,PFIZER/BIONTECH,95,95,0
Santana Da Ponte Pensa,354720,SP,Sudeste,BUTANTAN/SINOVAC,631,337,294
Santana Da Ponte Pensa,354720,SP,Sudeste,FIOCRUZ/ASTRAZENECA,493,431,62
Santana Da Ponte Pensa,354720,SP,Sudeste,PFIZER/BIONTECH,44,44,0
Santana Da Vargem,315830,MG,Sudeste,FIOCRUZ/ASTRAZENECA,1874,1719,155
Santana Da Vargem,315830,MG,Sudeste,BUTANTAN/SINOVAC,1442,742,700
Santana Da Vargem,315830,MG,Sudeste,PFIZER/BIONTECH,96,96,0
Santana De Cataguases,315840,MG,Sudeste,BUTANTAN/SINOVAC,970,516,454
Santana De Cataguases,315840,MG,Sudeste,FIOCRUZ/ASTRAZENECA,841,759,82
Santana De Cataguases,315840,MG,Sudeste,PFIZER/BIONTECH,16,16,0
Santana De Mangueira,251350,PB,Nordeste,BUTANTAN/SINOVAC,1237,646,591
Santana De Mangueira,251350,PB,Nordeste,FIOCRUZ/ASTRAZENECA,767,702,65
Santana De Mangueira,251350,PB,Nordeste,PFIZER/BIONTECH,72,72,0
Santana De Parnaíba,354730,SP,Sudeste,BUTANTAN/SINOVAC,24585,13789,10796
Santana De Parnaíba,354730,SP,Sudeste,FIOCRUZ/ASTRAZENECA,22191,20132,2059
Santana De Parnaíba,354730,SP,Sudeste,PFIZER/BIONTECH,774,769,5
Santana De Pirapama,315850,MG,Sudeste,FIOCRUZ/ASTRAZENECA,2767,2599,168
Santana De Pirapama,315850,MG,Sudeste,BUTANTAN/SINOVAC,2114,1067,1047
Santana De Pirapama,315850,MG,Sudeste,PFIZER/BIONTECH,46,46,0
Santana Do Acaraú,231200,CE,Nordeste,BUTANTAN/SINOVAC,4104,2112,1992
Santana Do Acaraú,231200,CE,Nordeste,FIOCRUZ/ASTRAZENECA,2025,1600,425
Santana Do Araguaia,150670,PA,Norte,FIOCRUZ/ASTRAZENECA,2765,2614,151
Santana Do Araguaia,150670,PA,Norte,BUTANTAN/SINOVAC,2470,1456,1014
Santana Do Cariri,231210,CE,Nordeste,BUTANTAN/SINOVAC,3206,1696,1510
Santana Do Cariri,231210,CE,Nordeste,FIOCRUZ/ASTRAZENECA,1833,1513,320
Santana Do Deserto,315860,MG,Sudeste,BUTANTAN/SINOVAC,949,495,454
Santana Do Deserto,315860,MG,Sudeste,FIOCRUZ/ASTRAZENECA,656,599,57
Santana Do Deserto,315860,MG,Sudeste,PFIZER/BIONTECH,54,54,0
Santana Do Garambéu,315870,MG,Sudeste,FIOCRUZ/ASTRAZENECA,714,507,207
Santana Do Garambéu,315870,MG,Sudeste,BUTANTAN/SINOVAC,704,356,348
Santana Do Garambéu,315870,MG,Sudeste,PFIZER/BIONTECH,51,51,0
Santana Do Ipanema,270800,AL,Nordeste,BUTANTAN/SINOVAC,7791,4031,3760
Santana Do Ipanema,270800,AL,Nordeste,FIOCRUZ/ASTRAZENECA,7582,6831,751
Santana Do Ipanema,270800,AL,Nordeste,PFIZER/BIONTECH,1330,1329,1
Santana Do Itararé,412400,PR,Sul,FIOCRUZ/ASTRAZENECA,1589,1507,82
Santana Do Itararé,412400,PR,Sul,BUTANTAN/SINOVAC,1199,623,576
Santana Do Jacaré,315880,MG,Sudeste,BUTANTAN/SINOVAC,948,548,400
Santana Do Jacaré,315880,MG,Sudeste,FIOCRUZ/ASTRAZENECA,494,492,2
Santana Do Manhuaçu,315890,MG,Sudeste,BUTANTAN/SINOVAC,1309,696,613
Santana Do Manhuaçu,315890,MG,Sudeste,FIOCRUZ/ASTRAZENECA,671,667,4
Santana Do Manhuaçu,315890,MG,Sudeste,PFIZER/BIONTECH,56,56,0
Santana Do Maranhão,211023,MA,Nordeste,FIOCRUZ/ASTRAZENECA,1937,1678,259
Santana Do Maranhão,211023,MA,Nordeste,BUTANTAN/SINOVAC,1843,950,893
Santana Do Matos,241140,RN,Nordeste,FIOCRUZ/ASTRAZENECA,3214,2962,252
Santana Do Matos,241140,RN,Nordeste,BUTANTAN/SINOVAC,3164,1651,1513
Santana Do Matos,241140,RN,Nordeste,PFIZER/BIONTECH,280,280,0
Santana Do Mundaú,270810,AL,Nordeste,FIOCRUZ/ASTRAZENECA,2774,2509,265
Santana Do Mundaú,270810,AL,Nordeste,BUTANTAN/SINOVAC,1598,805,793
Santana Do Mundaú,270810,AL,Nordeste,PFIZER/BIONTECH,150,150,0
Santana Do Paraíso,315895,MG,Sudeste,FIOCRUZ/ASTRAZENECA,5332,5102,230
Santana Do Paraíso,315895,MG,Sudeste,BUTANTAN/SINOVAC,4455,2266,2189
Santana Do Paraíso,315895,MG,Sudeste,PFIZER/BIONTECH,683,683,0
Santana Do Piauí,220935,PI,Nordeste,BUTANTAN/SINOVAC,825,448,377
Santana Do Piauí,220935,PI,Nordeste,FIOCRUZ/ASTRAZENECA,249,169,80
Santana Do Riacho,315900,MG,Sudeste,BUTANTAN/SINOVAC,1162,588,574
Santana Do Riacho,315900,MG,Sudeste,FIOCRUZ/ASTRAZENECA,766,681,85
Santana Do Riacho,315900,MG,Sudeste,PFIZER/BIONTECH,33,33,0
Santana Do São Francisco,280640,SE,Nordeste,FIOCRUZ/ASTRAZENECA,1104,1046,58
Santana Do São Francisco,280640,SE,Nordeste,BUTANTAN/SINOVAC,1095,579,516
Santana Do São Francisco,280640,SE,Nordeste,PFIZER/BIONTECH,139,139,0
Santana Do Seridó,241142,RN,Nordeste,BUTANTAN/SINOVAC,665,340,325
Santana Do Seridó,241142,RN,Nordeste,FIOCRUZ/ASTRAZENECA,525,495,30
Santana Do Seridó,241142,RN,Nordeste,PFIZER/BIONTECH,85,84,1
Santana Dos Garrotes,251360,PB,Nordeste,BUTANTAN/SINOVAC,2112,1078,1034
Santana Dos Garrotes,251360,PB,Nordeste,FIOCRUZ/ASTRAZENECA,1257,1227,30
Santana Dos Garrotes,251360,PB,Nordeste,PFIZER/BIONTECH,103,103,0
Santana Dos Montes,315910,MG,Sudeste,BUTANTAN/SINOVAC,755,377,378
Santana Dos Montes,315910,MG,Sudeste,FIOCRUZ/ASTRAZENECA,379,212,167
Santanópolis,292830,BA,Nordeste,BUTANTAN/SINOVAC,2240,1169,1071
Santanópolis,292830,BA,Nordeste,FIOCRUZ/ASTRAZENECA,1839,1736,103
Santanópolis,292830,BA,Nordeste,PFIZER/BIONTECH,181,179,2
Santarém,150680,PA,Norte,FIOCRUZ/ASTRAZENECA,69774,50893,18881
Santarém,150680,PA,Norte,BUTANTAN/SINOVAC,21112,12158,8954
Santarém Novo,150690,PA,Norte,FIOCRUZ/ASTRAZENECA,1097,855,242
Santarém Novo,150690,PA,Norte,BUTANTAN/SINOVAC,771,414,357
Santiago,431740,RS,Sul,BUTANTAN/SINOVAC,15315,7856,7459
Santiago,431740,RS,Sul,FIOCRUZ/ASTRAZENECA,14034,12345,1689
Santiago,431740,RS,Sul,PFIZER/BIONTECH,1806,1805,1
Santiago Do Sul,421569,SC,Sul,BUTANTAN/SINOVAC,1053,586,467
Santiago Do Sul,421569,SC,Sul,FIOCRUZ/ASTRAZENECA,682,608,74
Santiago Do Sul,421569,SC,Sul,PFIZER/BIONTECH,58,58,0
Santo Afonso,510726,MT,Centro-Oeste,BUTANTAN/SINOVAC,1304,614,690
Santo Afonso,510726,MT,Centro-Oeste,FIOCRUZ/ASTRAZENECA,748,587,161
Santo Afonso,510726,MT,Centro-Oeste,PFIZER/BIONTECH,84,84,0
Santo Amaro,292860,BA,Nordeste,FIOCRUZ/ASTRAZENECA,9047,8727,320
Santo Amaro,292860,BA,Nordeste,BUTANTAN/SINOVAC,7742,5035,2707
Santo Amaro,292860,BA,Nordeste,PFIZER/BIONTECH,2423,2423,0
Santo Amaro Da Imperatriz,421570,SC,Sul,FIOCRUZ/ASTRAZENECA,6115,5913,202
Santo Amaro Da Imperatriz,421570,SC,Sul,BUTANTAN/SINOVAC,6111,3153,2958
Santo Amaro Da Imperatriz,421570,SC,Sul,PFIZER/BIONTECH,617,617,0
Santo Amaro Das Brotas,280660,SE,Nordeste,BUTANTAN/SINOVAC,237,156,81
Santo Amaro Do Maranhão,211027,MA,Nordeste,FIOCRUZ/ASTRAZENECA,2186,2076,110
Santo Amaro Do Maranhão,211027,MA,Nordeste,BUTANTAN/SINOVAC,1401,726,675
Santo Anastácio,354770,SP,Sudeste,BUTANTAN/SINOVAC,5717,3094,2623
Santo Anastácio,354770,SP,Sudeste,FIOCRUZ/ASTRAZENECA,4665,4154,511
Santo Anastácio,354770,SP,Sudeste,PFIZER/BIONTECH,262,262,0
Santo André,251385,PB,Nordeste,BUTANTAN/SINOVAC,825,417,408
Santo André,251385,PB,Nordeste,FIOCRUZ/ASTRAZENECA,651,586,65
Santo André,251385,PB,Nordeste,PFIZER/BIONTECH,41,41,0
Santo André,354780,SP,Sudeste,BUTANTAN/SINOVAC,166616,93240,73376
Santo André,354780,SP,Sudeste,FIOCRUZ/ASTRAZENECA,95710,82074,13636
Santo André,354780,SP,Sudeste,PFIZER/BIONTECH,14483,14483,0
Santo Ângelo,431750,RS,Sul,BUTANTAN/SINOVAC,20542,10961,9581
Santo Ângelo,431750,RS,Sul,FIOCRUZ/ASTRAZENECA,20409,18809,1600
Santo Ângelo,431750,RS,Sul,PFIZER/BIONTECH,3115,3113,2
Santo Antônio,241150,RN,Nordeste,FIOCRUZ/ASTRAZENECA,4494,4230,264
Santo Antônio,241150,RN,Nordeste,BUTANTAN/SINOVAC,4345,2236,2109
Santo Antônio,241150,RN,Nordeste,PFIZER/BIONTECH,360,360,0
Santo Antônio Da Alegria,354790,SP,Sudeste,BUTANTAN/SINOVAC,1915,1099,816
Santo Antônio Da Alegria,354790,SP,Sudeste,FIOCRUZ/ASTRAZENECA,1871,1726,145
Santo Antônio Da Alegria,354790,SP,Sudeste,PFIZER/BIONTECH,167,167,0
Santo Antônio Da Barra,521971,GO,Centro-Oeste,FIOCRUZ/ASTRAZENECA,1175,1104,71
Santo Antônio Da Barra,521971,GO,Centro-Oeste,BUTANTAN/SINOVAC,908,482,426
Santo Antônio Da Patrulha,431760,RS,Sul,BUTANTAN/SINOVAC,13647,7035,6612
Santo Antônio Da Patrulha,431760,RS,Sul,FIOCRUZ/ASTRAZENECA,10829,9913,916
Santo Antônio Da Patrulha,431760,RS,Sul,PFIZER/BIONTECH,1535,1535,0
Santo Antônio Da Platina,412410,PR,Sul,FIOCRUZ/ASTRAZENECA,9666,8828,838
Santo Antônio Da Platina,412410,PR,Sul,BUTANTAN/SINOVAC,8841,4577,4264
Santo Antônio Da Platina,412410,PR,Sul,PFIZER/BIONTECH,3546,3545,1
Santo Antônio Das Missões,431770,RS,Sul,BUTANTAN/SINOVAC,3595,2064,1531
Santo Antônio Das Missões,431770,RS,Sul,FIOCRUZ/ASTRAZENECA,2260,2110,150
Santo Antônio Das Missões,431770,RS,Sul,PFIZER/BIONTECH,170,170,0
Santo Antônio De Goiás,521973,GO,Centro-Oeste,FIOCRUZ/ASTRAZENECA,1707,1615,92
Santo Antônio De Goiás,521973,GO,Centro-Oeste,BUTANTAN/SINOVAC,1004,532,472
Santo Antônio De Goiás,521973,GO,Centro-Oeste,PFIZER/BIONTECH,74,74,0
Santo Antônio De Jesus,292870,BA,Nordeste,BUTANTAN/SINOVAC,16754,9009,7745
Santo Antônio De Jesus,292870,BA,Nordeste,FIOCRUZ/ASTRAZENECA,11693,10632,1061
Santo Antônio De Jesus,292870,BA,Nordeste,PFIZER/BIONTECH,1345,1345,0
Santo Antônio De Lisboa,220940,PI,Nordeste,FIOCRUZ/ASTRAZENECA,1617,1458,159
Santo Antônio De Lisboa,220940,PI,Nordeste,BUTANTAN/SINOVAC,1381,715,666
Santo Antônio De Lisboa,220940,PI,Nordeste,PFIZER/BIONTECH,123,123,0
Santo Antônio De Pádua,330470,RJ,Sudeste,BUTANTAN/SINOVAC,8414,4931,3483
Santo Antônio De Pádua,330470,RJ,Sudeste,FIOCRUZ/ASTRAZENECA,4505,4166,339
Santo Antônio De Posse,354800,SP,Sudeste,FIOCRUZ/ASTRAZENECA,5074,4757,317
Santo Antônio De Posse,354800,SP,Sudeste,BUTANTAN/SINOVAC,4821,2805,2016
Santo Antônio De Posse,354800,SP,Sudeste,PFIZER/BIONTECH,578,578,0
Santo Antônio Do Amparo,315990,MG,Sudeste,FIOCRUZ/ASTRAZENECA,3779,3503,276
Santo Antônio Do Amparo,315990,MG,Sudeste,BUTANTAN/SINOVAC,3323,1693,1630
Santo Antônio Do Amparo,315990,MG,Sudeste,PFIZER/BIONTECH,369,368,1
Santo Antônio Do Aracanguá,354805,SP,Sudeste,BUTANTAN/SINOVAC,1855,1067,788
Santo Antônio Do Aracanguá,354805,SP,Sudeste,FIOCRUZ/ASTRAZENECA,1734,1596,138
Santo Antônio Do Aracanguá,354805,SP,Sudeste,PFIZER/BIONTECH,267,267,0
Santo Antônio Do Aventureiro,316000,MG,Sudeste,BUTANTAN/SINOVAC,967,499,468
Santo Antônio Do Aventureiro,316000,MG,Sudeste,FIOCRUZ/ASTRAZENECA,946,849,97
Santo Antônio Do Aventureiro,316000,MG,Sudeste,PFIZER/BIONTECH,134,134,0
Santo Antônio Do Caiuá,412420,PR,Sul,FIOCRUZ/ASTRAZENECA,934,859,75
Santo Antônio Do Caiuá,412420,PR,Sul,BUTANTAN/SINOVAC,851,459,392
Santo Antônio Do Caiuá,412420,PR,Sul,PFIZER/BIONTECH,12,12,0
Santo Antônio Do Descoberto,521975,GO,Centro-Oeste,BUTANTAN/SINOVAC,8233,4265,3968
Santo Antônio Do Descoberto,521975,GO,Centro-Oeste,FIOCRUZ/ASTRAZENECA,6607,5871,736
Santo Antônio Do Grama,316010,MG,Sudeste,BUTANTAN/SINOVAC,1199,614,585
Santo Antônio Do Grama,316010,MG,Sudeste,FIOCRUZ/ASTRAZENECA,1148,1034,114
Santo Antônio Do Grama,316010,MG,Sudeste,PFIZER/BIONTECH,116,116,0
Santo Antônio Do Içá,130370,AM,Norte,BUTANTAN/SINOVAC,3848,2832,1016
Santo Antônio Do Içá,130370,AM,Norte,FIOCRUZ/ASTRAZENECA,1396,1317,79
Santo Antônio Do Itambé,316020,MG,Sudeste,FIOCRUZ/ASTRAZENECA,1038,974,64
Santo Antônio Do Itambé,316020,MG,Sudeste,BUTANTAN/SINOVAC,719,373,346
Santo Antônio Do Itambé,316020,MG,Sudeste,PFIZER/BIONTECH,14,14,0
Santo Antônio Do Jacinto,316030,MG,Sudeste,BUTANTAN/SINOVAC,2776,1429,1347
Santo Antônio Do Jacinto,316030,MG,Sudeste,FIOCRUZ/ASTRAZENECA,1787,1542,245
Santo Antônio Do Jacinto,316030,MG,Sudeste,PFIZER/BIONTECH,58,58,0
Santo Antônio Do Jardim,354810,SP,Sudeste,BUTANTAN/SINOVAC,1618,901,717
Santo Antônio Do Jardim,354810,SP,Sudeste,FIOCRUZ/ASTRAZENECA,1491,1344,147
Santo Antônio Do Jardim,354810,SP,Sudeste,PFIZER/BIONTECH,177,177,0
Santo Antônio Do Leste,510779,MT,Centro-Oeste,BUTANTAN/SINOVAC,760,424,336
Santo Antônio Do Leste,510779,MT,Centro-Oeste,FIOCRUZ/ASTRAZENECA,525,508,17
Santo Antônio Do Leverger,510780,MT,Centro-Oeste,FIOCRUZ/ASTRAZENECA,5000,4280,720
Santo Antônio Do Leverger,510780,MT,Centro-Oeste,BUTANTAN/SINOVAC,2641,1367,1274
Santo Antônio Do Leverger,510780,MT,Centro-Oeste,PFIZER/BIONTECH,23,23,0
Santo Antônio Do Monte,316040,MG,Sudeste,FIOCRUZ/ASTRAZENECA,5541,4992,549
Santo Antônio Do Monte,316040,MG,Sudeste,BUTANTAN/SINOVAC,5386,2738,2648
Santo Antônio Do Monte,316040,MG,Sudeste,PFIZER/BIONTECH,152,152,0
Santo Antônio Do Palma,431755,RS,Sul,FIOCRUZ/ASTRAZENECA,656,573,83
Santo Antônio Do Palma,431755,RS,Sul,BUTANTAN/SINOVAC,627,323,304
Santo Antônio Do Palma,431755,RS,Sul,PFIZER/BIONTECH,110,109,1
Santo Antônio Do Paraíso,412430,PR,Sul,FIOCRUZ/ASTRAZENECA,907,861,46
Santo Antônio Do Paraíso,412430,PR,Sul,BUTANTAN/SINOVAC,606,319,287
Santo Antônio Do Paraíso,412430,PR,Sul,PFIZER/BIONTECH,12,12,0
Santo Antônio Do Pinhal,354820,SP,Sudeste,BUTANTAN/SINOVAC,1767,968,799
Santo Antônio Do Pinhal,354820,SP,Sudeste,FIOCRUZ/ASTRAZENECA,1466,1374,92
Santo Antônio Do Pinhal,354820,SP,Sudeste,PFIZER/BIONTECH,78,78,0
Santo Antônio Do Planalto,431775,RS,Sul,BUTANTAN/SINOVAC,711,366,345
Santo Antônio Do Planalto,431775,RS,Sul,FIOCRUZ/ASTRAZENECA,569,515,54
Santo Antônio Do Planalto,431775,RS,Sul,PFIZER/BIONTECH,60,60,0
Santo Antônio Do Retiro,316045,MG,Sudeste,BUTANTAN/SINOVAC,1667,926,741
Santo Antônio Do Retiro,316045,MG,Sudeste,FIOCRUZ/ASTRAZENECA,829,759,70
Santo Antônio Do Retiro,316045,MG,Sudeste,PFIZER/BIONTECH,28,28,0
Santo Antônio Do Rio Abaixo,316050,MG,Sudeste,FIOCRUZ/ASTRAZENECA,505,470,35
Santo Antônio Do Rio Abaixo,316050,MG,Sudeste,BUTANTAN/SINOVAC,487,242,245
Santo Antônio Do Rio Abaixo,316050,MG,Sudeste,PFIZER/BIONTECH,50,50,0
Santo Antônio Do Sudoeste,412440,PR,Sul,FIOCRUZ/ASTRAZENECA,4731,4500,231
Santo Antônio Do Sudoeste,412440,PR,Sul,BUTANTAN/SINOVAC,3872,1985,1887
Santo Antônio Do Sudoeste,412440,PR,Sul,PFIZER/BIONTECH,109,109,0
Santo Antônio Do Tauá,150700,PA,Norte,FIOCRUZ/ASTRAZENECA,8490,7504,986
Santo Antônio Do Tauá,150700,PA,Norte,BUTANTAN/SINOVAC,3521,1976,1545
Santo Antônio Dos Lopes,211030,MA,Nordeste,FIOCRUZ/ASTRAZENECA,3460,3241,219
Santo Antônio Dos Lopes,211030,MA,Nordeste,BUTANTAN/SINOVAC,2505,1373,1132
Santo Antônio Dos Milagres,220945,PI,Nordeste,FIOCRUZ/ASTRAZENECA,608,579,29
Santo Antônio Dos Milagres,220945,PI,Nordeste,BUTANTAN/SINOVAC,559,293,266
Santo Antônio Dos Milagres,220945,PI,Nordeste,PFIZER/BIONTECH,60,60,0
Santo Augusto,431780,RS,Sul,BUTANTAN/SINOVAC,4326,2197,2129
Santo Augusto,431780,RS,Sul,FIOCRUZ/ASTRAZENECA,3714,3355,359
Santo Augusto,431780,RS,Sul,PFIZER/BIONTECH,460,458,2
Santo Cristo,431790,RS,Sul,BUTANTAN/SINOVAC,4485,2251,2234
Santo Cristo,431790,RS,Sul,FIOCRUZ/ASTRAZENECA,3965,3516,449
Santo Cristo,431790,RS,Sul,PFIZER/BIONTECH,534,534,0
Santo Estêvão,292880,BA,Nordeste,FIOCRUZ/ASTRAZENECA,9946,8855,1091
Santo Estêvão,292880,BA,Nordeste,BUTANTAN/SINOVAC,8510,4392,4118
Santo Estêvão,292880,BA,Nordeste,PFIZER/BIONTECH,454,454,0
Santo Expedito,354830,SP,Sudeste,BUTANTAN/SINOVAC,1012,568,444
Santo Expedito,354830,SP,Sudeste,FIOCRUZ/ASTRAZENECA,676,613,63
Santo Expedito,354830,SP,Sudeste,PFIZER/BIONTECH,130,130,0
Santo Expedito Do Sul,431795,RS,Sul,BUTANTAN/SINOVAC,886,457,429
Santo Expedito Do Sul,431795,RS,Sul,FIOCRUZ/ASTRAZENECA,848,740,108
Santo Expedito Do Sul,431795,RS,Sul,PFIZER/BIONTECH,72,72,0
Santo Hipólito,316060,MG,Sudeste,BUTANTAN/SINOVAC,797,407,390
Santo Hipólito,316060,MG,Sudeste,FIOCRUZ/ASTRAZENECA,589,560,29
Santo Hipólito,316060,MG,Sudeste,PFIZER/BIONTECH,40,40,0
Santo Inácio,412450,PR,Sul,FIOCRUZ/ASTRAZENECA,1619,1515,104
Santo Inácio,412450,PR,Sul,BUTANTAN/SINOVAC,1281,658,623
Santo Inácio Do Piauí,220950,PI,Nordeste,FIOCRUZ/ASTRAZENECA,1035,966,69
Santo Inácio Do Piauí,220950,PI,Nordeste,BUTANTAN/SINOVAC,770,382,388
Santópolis Do Aguapeí,354840,SP,Sudeste,BUTANTAN/SINOVAC,1237,657,580
Santópolis Do Aguapeí,354840,SP,Sudeste,FIOCRUZ/ASTRAZENECA,1176,1060,116
Santópolis Do Aguapeí,354840,SP,Sudeste,PFIZER/BIONTECH,124,124,0
Santos,354850,SP,Sudeste,BUTANTAN/SINOVAC,142896,77238,65658
Santos,354850,SP,Sudeste,FIOCRUZ/ASTRAZENECA,122147,109599,12548
Santos,354850,SP,Sudeste,PFIZER/BIONTECH,2673,2671,2
Santos Dumont,316070,MG,Sudeste,BUTANTAN/SINOVAC,8989,4800,4189
Santos Dumont,316070,MG,Sudeste,FIOCRUZ/ASTRAZENECA,4328,3969,359
São Benedito,231230,CE,Nordeste,BUTANTAN/SINOVAC,6861,3503,3358
São Benedito,231230,CE,Nordeste,FIOCRUZ/ASTRAZENECA,4646,3723,923
São Benedito Do Rio Preto,211040,MA,Nordeste,FIOCRUZ/ASTRAZENECA,2864,2633,231
São Benedito Do Rio Preto,211040,MA,Nordeste,BUTANTAN/SINOVAC,2726,1562,1164
São Benedito Do Sul,261290,PE,Nordeste,BUTANTAN/SINOVAC,1756,901,855
São Benedito Do Sul,261290,PE,Nordeste,FIOCRUZ/ASTRAZENECA,1557,1416,141
São Benedito Do Sul,261290,PE,Nordeste,PFIZER/BIONTECH,63,63,0
São Bentinho,251392,PB,Nordeste,BUTANTAN/SINOVAC,1422,745,677
São Bentinho,251392,PB,Nordeste,FIOCRUZ/ASTRAZENECA,446,355,91
São Bento,211050,MA,Nordeste,FIOCRUZ/ASTRAZENECA,9871,8774,1097
São Bento,211050,MA,Nordeste,BUTANTAN/SINOVAC,5397,2917,2480
São Bento,251390,PB,Nordeste,BUTANTAN/SINOVAC,5659,3108,2551
São Bento,251390,PB,Nordeste,FIOCRUZ/ASTRAZENECA,5214,4836,378
São Bento,251390,PB,Nordeste,PFIZER/BIONTECH,207,207,0
São Bento Abade,316080,MG,Sudeste,BUTANTAN/SINOVAC,770,411,359
São Bento Abade,316080,MG,Sudeste,FIOCRUZ/ASTRAZENECA,247,218,29
São Bento Do Norte,241160,RN,Nordeste,BUTANTAN/SINOVAC,1131,605,526
São Bento Do Norte,241160,RN,Nordeste,FIOCRUZ/ASTRAZENECA,782,698,84
São Bento Do Norte,241160,RN,Nordeste,PFIZER/BIONTECH,102,102,0
São Bento Do Sapucaí,354860,SP,Sudeste,BUTANTAN/SINOVAC,3081,1646,1435
São Bento Do Sapucaí,354860,SP,Sudeste,FIOCRUZ/ASTRAZENECA,2592,2339,253
São Bento Do Sapucaí,354860,SP,Sudeste,PFIZER/BIONTECH,252,252,0
São Bento Do Sul,421580,SC,Sul,FIOCRUZ/ASTRAZENECA,16647,15644,1003
São Bento Do Sul,421580,SC,Sul,BUTANTAN/SINOVAC,11769,6387,5382
São Bento Do Sul,421580,SC,Sul,PFIZER/BIONTECH,1132,1132,0
São Bento Do Tocantins,172010,TO,Norte,BUTANTAN/SINOVAC,716,442,274
São Bento Do Tocantins,172010,TO,Norte,FIOCRUZ/ASTRAZENECA,411,388,23
São Bento Do Trairí,241170,RN,Nordeste,BUTANTAN/SINOVAC,962,500,462
São Bento Do Trairí,241170,RN,Nordeste,FIOCRUZ/ASTRAZENECA,868,818,50
São Bento Do Trairí,241170,RN,Nordeste,PFIZER/BIONTECH,179,179,0
São Bento Do Una,261300,PE,Nordeste,FIOCRUZ/ASTRAZENECA,12548,11470,1078
São Bento Do Una,261300,PE,Nordeste,BUTANTAN/SINOVAC,8975,4582,4393
São Bento Do Una,261300,PE,Nordeste,PFIZER/BIONTECH,1081,1080,1
São Bernardino,421575,SC,Sul,FIOCRUZ/ASTRAZENECA,773,711,62
São Bernardino,421575,SC,Sul,BUTANTAN/SINOVAC,704,381,323
São Bernardo,211060,MA,Nordeste,FIOCRUZ/ASTRAZENECA,4892,4570,322
São Bernardo,211060,MA,Nordeste,BUTANTAN/SINOVAC,3756,1948,1808
São Bernardo Do Campo,354870,SP,Sudeste,FIOCRUZ/ASTRAZENECA,196545,184370,12175
São Bernardo Do Campo,354870,SP,Sudeste,BUTANTAN/SINOVAC,178204,101673,76531
São Bernardo Do Campo,354870,SP,Sudeste,PFIZER/BIONTECH,22464,22430,34
São Bonifácio,421590,SC,Sul,FIOCRUZ/ASTRAZENECA,915,842,73
São Bonifácio,421590,SC,Sul,BUTANTAN/SINOVAC,871,487,384
São Bonifácio,421590,SC,Sul,PFIZER/BIONTECH,30,30,0
São Borja,431800,RS,Sul,FIOCRUZ/ASTRAZENECA,16995,15414,1581
São Borja,431800,RS,Sul,BUTANTAN/SINOVAC,16031,8081,7950
São Borja,431800,RS,Sul,PFIZER/BIONTECH,2540,2539,1
São Brás,270820,AL,Nordeste,FIOCRUZ/ASTRAZENECA,1395,1215,180
São Brás,270820,AL,Nordeste,BUTANTAN/SINOVAC,1316,672,644
São Brás Do Suaçuí,316090,MG,Sudeste,BUTANTAN/SINOVAC,764,388,376
São Brás Do Suaçuí,316090,MG,Sudeste,FIOCRUZ/ASTRAZENECA,747,558,189
São Braz Do Piauí,220955,PI,Nordeste,FIOCRUZ/ASTRAZENECA,819,772,47
São Braz Do Piauí,220955,PI,Nordeste,BUTANTAN/SINOVAC,789,416,373
São Braz Do Piauí,220955,PI,Nordeste,PFIZER/BIONTECH,91,91,0
São Caetano De Odivelas,150710,PA,Norte,FIOCRUZ/ASTRAZENECA,3241,2709,532
São Caetano De Odivelas,150710,PA,Norte,BUTANTAN/SINOVAC,2168,1139,1029
São Caetano Do Sul,354880,SP,Sudeste,BUTANTAN/SINOVAC,45088,25689,19399
São Caetano Do Sul,354880,SP,Sudeste,FIOCRUZ/ASTRAZENECA,22271,19498,2773
São Caetano Do Sul,354880,SP,Sudeste,PFIZER/BIONTECH,676,676,0
São Caitano,261310,PE,Nordeste,FIOCRUZ/ASTRAZENECA,8685,8051,634
São Caitano,261310,PE,Nordeste,BUTANTAN/SINOVAC,6077,3294,2783
São Caitano,261310,PE,Nordeste,PFIZER/BIONTECH,336,336,0
São Carlos,354890,SP,Sudeste,BUTANTAN/SINOVAC,60552,32127,28425
São Carlos,354890,SP,Sudeste,FIOCRUZ/ASTRAZENECA,57962,53036,4926
São Carlos,354890,SP,Sudeste,PFIZER/BIONTECH,3083,3079,4
São Carlos,421600,SC,Sul,FIOCRUZ/ASTRAZENECA,2965,2735,230
São Carlos,421600,SC,Sul,BUTANTAN/SINOVAC,2436,1247,1189
São Carlos,421600,SC,Sul,PFIZER/BIONTECH,87,87,0
São Carlos Do Ivaí,412460,PR,Sul,FIOCRUZ/ASTRAZENECA,1585,1472,113
São Carlos Do Ivaí,412460,PR,Sul,BUTANTAN/SINOVAC,1439,734,705
São Cristóvão,280670,SE,Nordeste,FIOCRUZ/ASTRAZENECA,4283,4279,4
São Cristóvão,280670,SE,Nordeste,BUTANTAN/SINOVAC,999,999,0
São Cristóvão,280670,SE,Nordeste,PFIZER/BIONTECH,259,253,6
São Cristóvão Do Sul,421605,SC,Sul,FIOCRUZ/ASTRAZENECA,1674,1595,79
São Cristóvão Do Sul,421605,SC,Sul,BUTANTAN/SINOVAC,1140,608,532
São Cristóvão Do Sul,421605,SC,Sul,PFIZER/BIONTECH,23,23,0
São Desidério,292890,BA,Nordeste,FIOCRUZ/ASTRAZENECA,6806,6100,706
São Desidério,292890,BA,Nordeste,BUTANTAN/SINOVAC,6169,3167,3002
São Desidério,292890,BA,Nordeste,PFIZER/BIONTECH,859,859,0
São Domingos,251396,PB,Nordeste,BUTANTAN/SINOVAC,1025,526,499
São Domingos,251396,PB,Nordeste,FIOCRUZ/ASTRAZENECA,652,590,62
São Domingos,251396,PB,Nordeste,PFIZER/BIONTECH,90,90,0
São Domingos,280680,SE,Nordeste,BUTANTAN/SINOVAC,2574,1309,1265
São Domingos,280680,SE,Nordeste,FIOCRUZ/ASTRAZENECA,1820,1817,3
São Domingos,280680,SE,Nordeste,PFIZER/BIONTECH,138,138,0
São Domingos,292895,BA,Nordeste,FIOCRUZ/ASTRAZENECA,2808,2419,389
São Domingos,292895,BA,Nordeste,BUTANTAN/SINOVAC,2163,1123,1040
São Domingos,292895,BA,Nordeste,PFIZER/BIONTECH,362,357,5
São Domingos,421610,SC,Sul,FIOCRUZ/ASTRAZENECA,2537,2318,219
São Domingos,421610,SC,Sul,BUTANTAN/SINOVAC,2078,1122,956
São Domingos,421610,SC,Sul,PFIZER/BIONTECH,131,131,0
São Domingos,521980,GO,Centro-Oeste,FIOCRUZ/ASTRAZENECA,3200,2999,201
São Domingos,521980,GO,Centro-Oeste,BUTANTAN/SINOVAC,768,405,363
São Domingos Das Dores,316095,MG,Sudeste,FIOCRUZ/ASTRAZENECA,1149,1074,75
São Domingos Das Dores,316095,MG,Sudeste,BUTANTAN/SINOVAC,953,494,459
São Domingos Das Dores,316095,MG,Sudeste,PFIZER/BIONTECH,173,173,0
São Domingos Do Araguaia,150715,PA,Norte,FIOCRUZ/ASTRAZENECA,3381,3089,292
São Domingos Do Araguaia,150715,PA,Norte,BUTANTAN/SINOVAC,1210,637,573
São Domingos Do Azeitão,211065,MA,Nordeste,FIOCRUZ/ASTRAZENECA,1952,1780,172
São Domingos Do Azeitão,211065,MA,Nordeste,BUTANTAN/SINOVAC,1178,616,562
São Domingos Do Capim,150720,PA,Norte,FIOCRUZ/ASTRAZENECA,14114,9749,4365
São Domingos Do Capim,150720,PA,Norte,BUTANTAN/SINOVAC,4031,2101,1930
São Domingos Do Cariri,251394,PB,Nordeste,FIOCRUZ/ASTRAZENECA,640,531,109
São Domingos Do Cariri,251394,PB,Nordeste,BUTANTAN/SINOVAC,625,323,302
São Domingos Do Cariri,251394,PB,Nordeste,PFIZER/BIONTECH,22,22,0
São Domingos Do Maranhão,211070,MA,Nordeste,FIOCRUZ/ASTRAZENECA,6415,6075,340
São Domingos Do Maranhão,211070,MA,Nordeste,BUTANTAN/SINOVAC,5940,3119,2821
São Domingos Do Norte,320465,ES,Sudeste,BUTANTAN/SINOVAC,2316,1218,1098
São Domingos Do Norte,320465,ES,Sudeste,FIOCRUZ/ASTRAZENECA,2210,2118,92
São Domingos Do Norte,320465,ES,Sudeste,PFIZER/BIONTECH,365,365,0
São Domingos Do Prata,316100,MG,Sudeste,BUTANTAN/SINOVAC,5301,2718,2583
São Domingos Do Prata,316100,MG,Sudeste,FIOCRUZ/ASTRAZENECA,4251,3857,394
São Domingos Do Prata,316100,MG,Sudeste,PFIZER/BIONTECH,267,267,0
São Domingos Do Sul,431805,RS,Sul,BUTANTAN/SINOVAC,1211,611,600
São Domingos Do Sul,431805,RS,Sul,FIOCRUZ/ASTRAZENECA,1045,854,191
São Domingos Do Sul,431805,RS,Sul,PFIZER/BIONTECH,102,102,0
São Felipe,292910,BA,Nordeste,BUTANTAN/SINOVAC,3497,1858,1639
São Felipe,292910,BA,Nordeste,FIOCRUZ/ASTRAZENECA,2907,2809,98
São Felipe,292910,BA,Nordeste,PFIZER/BIONTECH,422,422,0
São Felipe D'Oeste,110148,RO,Norte,BUTANTAN/SINOVAC,1461,759,702
São Felipe D'Oeste,110148,RO,Norte,FIOCRUZ/ASTRAZENECA,1300,1241,59
São Felipe D'Oeste,110148,RO,Norte,PFIZER/BIONTECH,290,290,0
São Félix,292900,BA,Nordeste,FIOCRUZ/ASTRAZENECA,3255,3018,237
São Félix,292900,BA,Nordeste,BUTANTAN/SINOVAC,2289,1223,1066
São Félix,292900,BA,Nordeste,PFIZER/BIONTECH,184,184,0
São Félix De Balsas,211080,MA,Nordeste,BUTANTAN/SINOVAC,1491,912,579
São Félix De Balsas,211080,MA,Nordeste,FIOCRUZ/ASTRAZENECA,1250,1150,100
São Félix De Minas,316105,MG,Sudeste,FIOCRUZ/ASTRAZENECA,820,744,76
São Félix De Minas,316105,MG,Sudeste,BUTANTAN/SINOVAC,739,370,369
São Félix De Minas,316105,MG,Sudeste,PFIZER/BIONTECH,35,35,0
São Félix Do Araguaia,510785,MT,Centro-Oeste,BUTANTAN/SINOVAC,6180,3817,2363
São Félix Do Araguaia,510785,MT,Centro-Oeste,FIOCRUZ/ASTRAZENECA,1514,1408,106
São Félix Do Coribe,292905,BA,Nordeste,FIOCRUZ/ASTRAZENECA,3137,2889,248
São Félix Do Coribe,292905,BA,Nordeste,BUTANTAN/SINOVAC,2558,1319,1239
São Félix Do Coribe,292905,BA,Nordeste,PFIZER/BIONTECH,350,350,0
São Félix Do Piauí,220960,PI,Nordeste,FIOCRUZ/ASTRAZENECA,963,850,113
São Félix Do Piauí,220960,PI,Nordeste,BUTANTAN/SINOVAC,943,489,454
São Félix Do Piauí,220960,PI,Nordeste,PFIZER/BIONTECH,64,64,0
São Félix Do Tocantins,172015,TO,Norte,FIOCRUZ/ASTRAZENECA,497,477,20
São Félix Do Tocantins,172015,TO,Norte,BUTANTAN/SINOVAC,393,229,164
São Félix Do Xingu,150730,PA,Norte,BUTANTAN/SINOVAC,4998,2933,2065
São Félix Do Xingu,150730,PA,Norte,FIOCRUZ/ASTRAZENECA,3406,3136,270
São Félix Do Xingu,150730,PA,Norte,PFIZER/BIONTECH,8,6,2
São Fernando,241180,RN,Nordeste,BUTANTAN/SINOVAC,876,487,389
São Fernando,241180,RN,Nordeste,FIOCRUZ/ASTRAZENECA,693,649,44
São Fernando,241180,RN,Nordeste,PFIZER/BIONTECH,158,158,0
São Fidélis,330480,RJ,Sudeste,FIOCRUZ/ASTRAZENECA,4093,3879,214
São Fidélis,330480,RJ,Sudeste,BUTANTAN/SINOVAC,3406,2558,848
São Fidélis,330480,RJ,Sudeste,PFIZER/BIONTECH,211,211,0
São Francisco,251398,PB,Nordeste,BUTANTAN/SINOVAC,1512,775,737
São Francisco,251398,PB,Nordeste,FIOCRUZ/ASTRAZENECA,951,872,79
São Francisco,251398,PB,Nordeste,PFIZER/BIONTECH,118,118,0
São Francisco,280690,SE,Nordeste,BUTANTAN/SINOVAC,754,387,367
São Francisco,280690,SE,Nordeste,FIOCRUZ/ASTRAZENECA,682,643,39
São Francisco,280690,SE,Nordeste,PFIZER/BIONTECH,29,29,0
São Francisco,316110,MG,Sudeste,BUTANTAN/SINOVAC,8531,5228,3303
São Francisco,316110,MG,Sudeste,FIOCRUZ/ASTRAZENECA,3613,3524,89
São Francisco,316110,MG,Sudeste,PFIZER/BIONTECH,33,33,0
São Francisco,354900,SP,Sudeste,BUTANTAN/SINOVAC,1055,587,468
São Francisco,354900,SP,Sudeste,FIOCRUZ/ASTRAZENECA,817,741,76
São Francisco,354900,SP,Sudeste,PFIZER/BIONTECH,71,71,0
São Francisco De Assis,431810,RS,Sul,FIOCRUZ/ASTRAZENECA,5505,4756,749
São Francisco De Assis,431810,RS,Sul,BUTANTAN/SINOVAC,5362,2714,2648
São Francisco De Assis,431810,RS,Sul,PFIZER/BIONTECH,631,631,0
São Francisco De Assis Do Piauí,220965,PI,Nordeste,FIOCRUZ/ASTRAZENECA,1364,1281,83
São Francisco De Assis Do Piauí,220965,PI,Nordeste,BUTANTAN/SINOVAC,743,376,367
São Francisco De Assis Do Piauí,220965,PI,Nordeste,PFIZER/BIONTECH,155,155,0
São Francisco De Goiás,521990,GO,Centro-Oeste,FIOCRUZ/ASTRAZENECA,1771,1694,77
São Francisco De Goiás,521990,GO,Centro-Oeste,BUTANTAN/SINOVAC,1204,621,583
São Francisco De Goiás,521990,GO,Centro-Oeste,PFIZER/BIONTECH,75,75,0
São Francisco De Itabapoana,330475,RJ,Sudeste,FIOCRUZ/ASTRAZENECA,8233,7788,445
São Francisco De Itabapoana,330475,RJ,Sudeste,BUTANTAN/SINOVAC,8058,4205,3853
São Francisco De Itabapoana,330475,RJ,Sudeste,PFIZER/BIONTECH,639,639,0
São Francisco De Paula,316120,MG,Sudeste,BUTANTAN/SINOVAC,1855,993,862
São Francisco De Paula,316120,MG,Sudeste,FIOCRUZ/ASTRAZENECA,1655,1547,108
São Francisco De Paula,316120,MG,Sudeste,PFIZER/BIONTECH,57,57,0
São Francisco De Paula,431820,RS,Sul,FIOCRUZ/ASTRAZENECA,5405,5071,334
São Francisco De Paula,431820,RS,Sul,BUTANTAN/SINOVAC,5257,2789,2468
São Francisco De Paula,431820,RS,Sul,PFIZER/BIONTECH,729,727,2
São Francisco De Sales,316130,MG,Sudeste,BUTANTAN/SINOVAC,699,542,157
São Francisco De Sales,316130,MG,Sudeste,FIOCRUZ/ASTRAZENECA,100,99,1
São Francisco Do Brejão,211085,MA,Nordeste,FIOCRUZ/ASTRAZENECA,1730,1638,92
São Francisco Do Brejão,211085,MA,Nordeste,BUTANTAN/SINOVAC,1618,814,804
São Francisco Do Conde,292920,BA,Nordeste,FIOCRUZ/ASTRAZENECA,5910,5358,552
São Francisco Do Conde,292920,BA,Nordeste,BUTANTAN/SINOVAC,5733,3034,2699
São Francisco Do Conde,292920,BA,Nordeste,PFIZER/BIONTECH,1663,1661,2
São Francisco Do Glória,316140,MG,Sudeste,BUTANTAN/SINOVAC,1285,663,622
São Francisco Do Glória,316140,MG,Sudeste,FIOCRUZ/ASTRAZENECA,1283,1100,183
São Francisco Do Glória,316140,MG,Sudeste,PFIZER/BIONTECH,163,163,0
São Francisco Do Guaporé,110149,RO,Norte,BUTANTAN/SINOVAC,3186,1731,1455
São Francisco Do Guaporé,110149,RO,Norte,FIOCRUZ/ASTRAZENECA,2442,2344,98
São Francisco Do Guaporé,110149,RO,Norte,PFIZER/BIONTECH,342,342,0
São Francisco Do Maranhão,211090,MA,Nordeste,BUTANTAN/SINOVAC,2152,1149,1003
São Francisco Do Maranhão,211090,MA,Nordeste,FIOCRUZ/ASTRAZENECA,2070,1928,142
São Francisco Do Oeste,241190,RN,Nordeste,FIOCRUZ/ASTRAZENECA,2478,2370,108
São Francisco Do Oeste,241190,RN,Nordeste,BUTANTAN/SINOVAC,2228,1143,1085
São Francisco Do Oeste,241190,RN,Nordeste,PFIZER/BIONTECH,479,479,0
São Francisco Do Pará,150740,PA,Norte,FIOCRUZ/ASTRAZENECA,2987,2452,535
São Francisco Do Pará,150740,PA,Norte,BUTANTAN/SINOVAC,2491,1398,1093
São Francisco Do Piauí,220970,PI,Nordeste,BUTANTAN/SINOVAC,1647,1010,637
São Francisco Do Piauí,220970,PI,Nordeste,FIOCRUZ/ASTRAZENECA,1232,1147,85
São Francisco Do Sul,421620,SC,Sul,FIOCRUZ/ASTRAZENECA,10596,9083,1513
São Francisco Do Sul,421620,SC,Sul,BUTANTAN/SINOVAC,1264,325,939
São Gabriel,292925,BA,Nordeste,FIOCRUZ/ASTRAZENECA,4961,4768,193
São Gabriel,292925,BA,Nordeste,BUTANTAN/SINOVAC,3540,1826,1714
São Gabriel,292925,BA,Nordeste,PFIZER/BIONTECH,28,28,0
São Gabriel,431830,RS,Sul,BUTANTAN/SINOVAC,16557,8406,8151
São Gabriel,431830,RS,Sul,FIOCRUZ/ASTRAZENECA,16506,14835,1671
São Gabriel,431830,RS,Sul,PFIZER/BIONTECH,2983,2982,1
São Gabriel Da Cachoeira,130380,AM,Norte,BUTANTAN/SINOVAC,23443,13396,10047
São Gabriel Da Cachoeira,130380,AM,Norte,FIOCRUZ/ASTRAZENECA,2726,2634,92
São Gabriel Da Palha,320470,ES,Sudeste,BUTANTAN/SINOVAC,7707,4142,3565
São Gabriel Da Palha,320470,ES,Sudeste,FIOCRUZ/ASTRAZENECA,7631,7311,320
São Gabriel Da Palha,320470,ES,Sudeste,PFIZER/BIONTECH,994,994,0
São Gabriel Do Oeste,500769,MS,Centro-Oeste,FIOCRUZ/ASTRAZENECA,6353,5547,806
São Gabriel Do Oeste,500769,MS,Centro-Oeste,BUTANTAN/SINOVAC,4763,2511,2252
São Gabriel Do Oeste,500769,MS,Centro-Oeste,PFIZER/BIONTECH,631,630,1
São Geraldo,316150,MG,Sudeste,BUTANTAN/SINOVAC,2590,1296,1294
São Geraldo,316150,MG,Sudeste,FIOCRUZ/ASTRAZENECA,1787,1587,200
São Geraldo Da Piedade,316160,MG,Sudeste,FIOCRUZ/ASTRAZENECA,979,893,86
São Geraldo Da Piedade,316160,MG,Sudeste,BUTANTAN/SINOVAC,965,490,475
São Geraldo Da Piedade,316160,MG,Sudeste,PFIZER/BIONTECH,48,48,0
São Geraldo Do Araguaia,150745,PA,Norte,FIOCRUZ/ASTRAZENECA,3673,3284,389
São Geraldo Do Araguaia,150745,PA,Norte,BUTANTAN/SINOVAC,1558,859,699
São Geraldo Do Baixio,316165,MG,Sudeste,BUTANTAN/SINOVAC,717,405,312
São Geraldo Do Baixio,316165,MG,Sudeste,FIOCRUZ/ASTRAZENECA,588,503,85
São Geraldo Do Baixio,316165,MG,Sudeste,PFIZER/BIONTECH,56,56,0
São Gonçalo,330490,RJ,Sudeste,BUTANTAN/SINOVAC,197528,115088,82440
São Gonçalo,330490,RJ,Sudeste,FIOCRUZ/ASTRAZENECA,83170,71695,11475
São Gonçalo,330490,RJ,Sudeste,PFIZER/BIONTECH,5772,5729,43
São Gonçalo Do Abaeté,316170,MG,Sudeste,FIOCRUZ/ASTRAZENECA,1652,1556,96
São Gonçalo Do Abaeté,316170,MG,Sudeste,BUTANTAN/SINOVAC,1414,741,673
São Gonçalo Do Abaeté,316170,MG,Sudeste,PFIZER/BIONTECH,178,178,0
São Gonçalo Do Amarante,231240,CE,Nordeste,BUTANTAN/SINOVAC,7284,3800,3484
São Gonçalo Do Amarante,231240,CE,Nordeste,FIOCRUZ/ASTRAZENECA,3866,3343,523
São Gonçalo Do Amarante,241200,RN,Nordeste,FIOCRUZ/ASTRAZENECA,20103,19160,943
São Gonçalo Do Amarante,241200,RN,Nordeste,BUTANTAN/SINOVAC,14571,7852,6719
São Gonçalo Do Amarante,241200,RN,Nordeste,PFIZER/BIONTECH,5271,5267,4
São Gonçalo Do Gurguéia,220975,PI,Nordeste,BUTANTAN/SINOVAC,431,213,218
São Gonçalo Do Gurguéia,220975,PI,Nordeste,FIOCRUZ/ASTRAZENECA,385,368,17
São Gonçalo Do Pará,316180,MG,Sudeste,FIOCRUZ/ASTRAZENECA,2273,2088,185
São Gonçalo Do Pará,316180,MG,Sudeste,BUTANTAN/SINOVAC,2158,1164,994
São Gonçalo Do Pará,316180,MG,Sudeste,PFIZER/BIONTECH,382,380,2
São Gonçalo Do Piauí,220980,PI,Nordeste,BUTANTAN/SINOVAC,1383,719,664
São Gonçalo Do Piauí,220980,PI,Nordeste,FIOCRUZ/ASTRAZENECA,730,684,46
São Gonçalo Do Rio Abaixo,316190,MG,Sudeste,FIOCRUZ/ASTRAZENECA,3111,2834,277
São Gonçalo Do Rio Abaixo,316190,MG,Sudeste,BUTANTAN/SINOVAC,2401,1224,1177
São Gonçalo Do Rio Abaixo,316190,MG,Sudeste,PFIZER/BIONTECH,96,96,0
São Gonçalo Do Rio Preto,312550,MG,Sudeste,FIOCRUZ/ASTRAZENECA,944,858,86
São Gonçalo Do Rio Preto,312550,MG,Sudeste,BUTANTAN/SINOVAC,907,475,432
São Gonçalo Do Rio Preto,312550,MG,Sudeste,PFIZER/BIONTECH,86,86,0
São Gonçalo Do Sapucaí,316200,MG,Sudeste,FIOCRUZ/ASTRAZENECA,4980,4521,459
São Gonçalo Do Sapucaí,316200,MG,Sudeste,BUTANTAN/SINOVAC,4450,2250,2200
São Gonçalo Do Sapucaí,316200,MG,Sudeste,PFIZER/BIONTECH,299,299,0
São Gonçalo Dos Campos,292930,BA,Nordeste,BUTANTAN/SINOVAC,5871,3183,2688
São Gonçalo Dos Campos,292930,BA,Nordeste,FIOCRUZ/ASTRAZENECA,5047,4651,396
São Gonçalo Dos Campos,292930,BA,Nordeste,PFIZER/BIONTECH,196,196,0
São Gotardo,316210,MG,Sudeste,BUTANTAN/SINOVAC,5838,2999,2839
São Gotardo,316210,MG,Sudeste,FIOCRUZ/ASTRAZENECA,4576,4125,451
São Gotardo,316210,MG,Sudeste,PFIZER/BIONTECH,488,488,0
São Jerônimo,431840,RS,Sul,BUTANTAN/SINOVAC,6485,3384,3101
São Jerônimo,431840,RS,Sul,FIOCRUZ/ASTRAZENECA,5918,5419,499
São Jerônimo,431840,RS,Sul,PFIZER/BIONTECH,633,633,0
São Jerônimo Da Serra,412470,PR,Sul,BUTANTAN/SINOVAC,3681,1925,1756
São Jerônimo Da Serra,412470,PR,Sul,FIOCRUZ/ASTRAZENECA,2798,2671,127
São Jerônimo Da Serra,412470,PR,Sul,PFIZER/BIONTECH,1,0,1
São João,261320,PE,Nordeste,FIOCRUZ/ASTRAZENECA,4348,3993,355
São João,261320,PE,Nordeste,BUTANTAN/SINOVAC,3402,1781,1621
São João,261320,PE,Nordeste,PFIZER/BIONTECH,392,392,0
São João,412480,PR,Sul,FIOCRUZ/ASTRAZENECA,3243,2932,311
São João,412480,PR,Sul,BUTANTAN/SINOVAC,2543,1279,1264
São João,412480,PR,Sul,PFIZER/BIONTECH,29,29,0
São João Batista,211100,MA,Nordeste,FIOCRUZ/ASTRAZENECA,5790,5334,456
São João Batista,211100,MA,Nordeste,BUTANTAN/SINOVAC,3251,1653,1598
São João Batista,421630,SC,Sul,BUTANTAN/SINOVAC,4785,2460,2325
São João Batista,421630,SC,Sul,FIOCRUZ/ASTRAZENECA,3057,2919,138
São João Batista Do Glória,316220,MG,Sudeste,BUTANTAN/SINOVAC,1908,976,932
São João Batista Do Glória,316220,MG,Sudeste,FIOCRUZ/ASTRAZENECA,1767,1639,128
São João Batista Do Glória,316220,MG,Sudeste,PFIZER/BIONTECH,101,101,0
São João D'Aliança,522000,GO,Centro-Oeste,FIOCRUZ/ASTRAZENECA,2898,2717,181
São João D'Aliança,522000,GO,Centro-Oeste,BUTANTAN/SINOVAC,1394,783,611
São João D'Aliança,522000,GO,Centro-Oeste,PFIZER/BIONTECH,157,157,0
São João Da Baliza,140050,RR,Norte,BUTANTAN/SINOVAC,1292,667,625
São João Da Baliza,140050,RR,Norte,FIOCRUZ/ASTRAZENECA,659,636,23
São João Da Barra,330500,RJ,Sudeste,BUTANTAN/SINOVAC,9514,4894,4620
São João Da Barra,330500,RJ,Sudeste,FIOCRUZ/ASTRAZENECA,8799,8109,690
São João Da Barra,330500,RJ,Sudeste,PFIZER/BIONTECH,736,735,1
São João Da Boa Vista,354910,SP,Sudeste,BUTANTAN/SINOVAC,26999,15239,11760
São João Da Boa Vista,354910,SP,Sudeste,FIOCRUZ/ASTRAZENECA,24784,22332,2452
São João Da Boa Vista,354910,SP,Sudeste,PFIZER/BIONTECH,2555,2554,1
São João Da Canabrava,220985,PI,Nordeste,BUTANTAN/SINOVAC,1006,526,480
São João Da Canabrava,220985,PI,Nordeste,FIOCRUZ/ASTRAZENECA,842,773,69
São João Da Fronteira,220987,PI,Nordeste,BUTANTAN/SINOVAC,1194,626,568
São João Da Fronteira,220987,PI,Nordeste,FIOCRUZ/ASTRAZENECA,652,629,23
São João Da Lagoa,316225,MG,Sudeste,BUTANTAN/SINOVAC,933,470,463
São João Da Lagoa,316225,MG,Sudeste,FIOCRUZ/ASTRAZENECA,789,736,53
São João Da Mata,316230,MG,Sudeste,FIOCRUZ/ASTRAZENECA,653,605,48
São João Da Mata,316230,MG,Sudeste,BUTANTAN/SINOVAC,635,324,311
São João Da Mata,316230,MG,Sudeste,PFIZER/BIONTECH,28,28,0
São João Da Paraúna,522005,GO,Centro-Oeste,FIOCRUZ/ASTRAZENECA,944,882,62
São João Da Paraúna,522005,GO,Centro-Oeste,BUTANTAN/SINOVAC,514,265,249
São João Da Ponta,150746,PA,Norte,BUTANTAN/SINOVAC,799,487,312
São João Da Ponta,150746,PA,Norte,FIOCRUZ/ASTRAZENECA,596,488,108
São João Da Ponte,316240,MG,Sudeste,FIOCRUZ/ASTRAZENECA,6531,6263,268
São João Da Ponte,316240,MG,Sudeste,BUTANTAN/SINOVAC,4149,2132,2017
São João Da Ponte,316240,MG,Sudeste,PFIZER/BIONTECH,22,22,0
São João Da Serra,220990,PI,Nordeste,BUTANTAN/SINOVAC,1456,738,718
São João Da Serra,220990,PI,Nordeste,FIOCRUZ/ASTRAZENECA,1055,1030,25
São João Da Serra,220990,PI,Nordeste,PFIZER/BIONTECH,155,155,0
São João Da Urtiga,431842,RS,Sul,BUTANTAN/SINOVAC,1842,936,906
São João Da Urtiga,431842,RS,Sul,FIOCRUZ/ASTRAZENECA,1469,1219,250
São João Da Urtiga,431842,RS,Sul,PFIZER/BIONTECH,162,162,0
São João Da Varjota,220995,PI,Nordeste,FIOCRUZ/ASTRAZENECA,1805,1544,261
São João Da Varjota,220995,PI,Nordeste,BUTANTAN/SINOVAC,894,456,438
São João Da Varjota,220995,PI,Nordeste,PFIZER/BIONTECH,42,42,0
São João Das Duas Pontes,354920,SP,Sudeste,BUTANTAN/SINOVAC,716,374,342
São João Das Duas Pontes,354920,SP,Sudeste,FIOCRUZ/ASTRAZENECA,652,576,76
São João Das Duas Pontes,354920,SP,Sudeste,PFIZER/BIONTECH,17,17,0
São João Das Missões,316245,MG,Sudeste,BUTANTAN/SINOVAC,13009,7345,5664
São João Das Missões,316245,MG,Sudeste,FIOCRUZ/ASTRAZENECA,662,581,81
São João Das Missões,316245,MG,Sudeste,PFIZER/BIONTECH,37,37,0
São João De Iracema,354925,SP,Sudeste,BUTANTAN/SINOVAC,624,346,278
São João De Iracema,354925,SP,Sudeste,FIOCRUZ/ASTRAZENECA,436,392,44
São João De Iracema,354925,SP,Sudeste,PFIZER/BIONTECH,47,47,0
São João De Meriti,330510,RJ,Sudeste,BUTANTAN/SINOVAC,93746,47233,46513
São João De Meriti,330510,RJ,Sudeste,FIOCRUZ/ASTRAZENECA,61783,52209,9574
São João De Meriti,330510,RJ,Sudeste,PFIZER/BIONTECH,7018,6955,63
São João De Pirabas,150747,PA,Norte,FIOCRUZ/ASTRAZENECA,4683,3810,873
São João De Pirabas,150747,PA,Norte,BUTANTAN/SINOVAC,2888,1694,1194
São João Del Rei,316250,MG,Sudeste,BUTANTAN/SINOVAC,22082,11359,10723
São João Del Rei,316250,MG,Sudeste,FIOCRUZ/ASTRAZENECA,19811,17893,1918
São João Del Rei,316250,MG,Sudeste,PFIZER/BIONTECH,682,681,1
São João Do Araguaia,150750,PA,Norte,FIOCRUZ/ASTRAZENECA,1655,1546,109
São João Do Araguaia,150750,PA,Norte,BUTANTAN/SINOVAC,580,305,275
São João Do Arraial,220997,PI,Nordeste,BUTANTAN/SINOVAC,1218,619,599
São João Do Arraial,220997,PI,Nordeste,FIOCRUZ/ASTRAZENECA,1079,1008,71
São João Do Caiuá,412490,PR,Sul,FIOCRUZ/ASTRAZENECA,1996,1852,144
São João Do Caiuá,412490,PR,Sul,BUTANTAN/SINOVAC,1389,715,674
São João Do Caiuá,412490,PR,Sul,PFIZER/BIONTECH,29,29,0
São João Do Cariri,251400,PB,Nordeste,BUTANTAN/SINOVAC,1445,808,637
São João Do Cariri,251400,PB,Nordeste,FIOCRUZ/ASTRAZENECA,770,683,87
São João Do Cariri,251400,PB,Nordeste,PFIZER/BIONTECH,52,52,0
São João Do Carú,211102,MA,Nordeste,FIOCRUZ/ASTRAZENECA,2168,1922,246
São João Do Carú,211102,MA,Nordeste,BUTANTAN/SINOVAC,1802,1049,753
São João Do Itaperiú,421635,SC,Sul,FIOCRUZ/ASTRAZENECA,1118,1001,117
São João Do Itaperiú,421635,SC,Sul,BUTANTAN/SINOVAC,583,289,294
São João Do Itaperiú,421635,SC,Sul,PFIZER/BIONTECH,34,34,0
São João Do Ivaí,412500,PR,Sul,BUTANTAN/SINOVAC,2745,1400,1345
São João Do Ivaí,412500,PR,Sul,FIOCRUZ/ASTRAZENECA,2698,2500,198
São João Do Jaguaribe,231250,CE,Nordeste,BUTANTAN/SINOVAC,2375,1333,1042
São João Do Jaguaribe,231250,CE,Nordeste,FIOCRUZ/ASTRAZENECA,1070,833,237
São João Do Manhuaçu,316255,MG,Sudeste,BUTANTAN/SINOVAC,1593,834,759
São João Do Manhuaçu,316255,MG,Sudeste,FIOCRUZ/ASTRAZENECA,1470,1326,144
São João Do Manhuaçu,316255,MG,Sudeste,PFIZER/BIONTECH,2,2,0
São João Do Manteninha,316257,MG,Sudeste,BUTANTAN/SINOVAC,1192,627,565
São João Do Manteninha,316257,MG,Sudeste,FIOCRUZ/ASTRAZENECA,1087,997,90
São João Do Manteninha,316257,MG,Sudeste,PFIZER/BIONTECH,59,59,0
São João Do Oeste,421625,SC,Sul,BUTANTAN/SINOVAC,1838,932,906
São João Do Oeste,421625,SC,Sul,FIOCRUZ/ASTRAZENECA,1555,1417,138
São João Do Oeste,421625,SC,Sul,PFIZER/BIONTECH,156,156,0
São João Do Oriente,316260,MG,Sudeste,BUTANTAN/SINOVAC,1778,898,880
São João Do Oriente,316260,MG,Sudeste,FIOCRUZ/ASTRAZENECA,1497,1316,181
São João Do Oriente,316260,MG,Sudeste,PFIZER/BIONTECH,56,56,0
São João Do Pacuí,316265,MG,Sudeste,BUTANTAN/SINOVAC,939,488,451
São João Do Pacuí,316265,MG,Sudeste,FIOCRUZ/ASTRAZENECA,752,673,79
São João Do Pacuí,316265,MG,Sudeste,PFIZER/BIONTECH,38,38,0
São João Do Paraíso,211105,MA,Nordeste,FIOCRUZ/ASTRAZENECA,2076,1944,132
São João Do Paraíso,211105,MA,Nordeste,BUTANTAN/SINOVAC,1790,923,867
São João Do Paraíso,316270,MG,Sudeste,BUTANTAN/SINOVAC,4249,2156,2093
São João Do Paraíso,316270,MG,Sudeste,FIOCRUZ/ASTRAZENECA,4248,3924,324
São João Do Paraíso,316270,MG,Sudeste,PFIZER/BIONTECH,705,705,0
São João Do Pau D'Alho,354930,SP,Sudeste,BUTANTAN/SINOVAC,770,404,366
São João Do Pau D'Alho,354930,SP,Sudeste,FIOCRUZ/ASTRAZENECA,691,605,86
São João Do Pau D'Alho,354930,SP,Sudeste,PFIZER/BIONTECH,74,74,0
São João Do Piauí,221000,PI,Nordeste,FIOCRUZ/ASTRAZENECA,7038,5541,1497
São João Do Piauí,221000,PI,Nordeste,BUTANTAN/SINOVAC,3255,1649,1606
São João Do Piauí,221000,PI,Nordeste,PFIZER/BIONTECH,448,448,0
São João Do Polêsine,431843,RS,Sul,BUTANTAN/SINOVAC,1213,611,602
São João Do Polêsine,431843,RS,Sul,FIOCRUZ/ASTRAZENECA,941,766,175
São João Do Polêsine,431843,RS,Sul,PFIZER/BIONTECH,106,106,0
São João Do Rio Do Peixe,250070,PB,Nordeste,BUTANTAN/SINOVAC,4759,2412,2347
São João Do Rio Do Peixe,250070,PB,Nordeste,FIOCRUZ/ASTRAZENECA,3583,3223,360
São João Do Rio Do Peixe,250070,PB,Nordeste,PFIZER/BIONTECH,353,353,0
São João Do Sabugi,241210,RN,Nordeste,BUTANTAN/SINOVAC,2288,1137,1151
São João Do Sabugi,241210,RN,Nordeste,FIOCRUZ/ASTRAZENECA,1805,1695,110
São João Do Sabugi,241210,RN,Nordeste,PFIZER/BIONTECH,59,59,0
São João Do Soter,211107,MA,Nordeste,FIOCRUZ/ASTRAZENECA,4587,4395,192
São João Do Soter,211107,MA,Nordeste,BUTANTAN/SINOVAC,2762,1482,1280
São João Do Sul,421640,SC,Sul,FIOCRUZ/ASTRAZENECA,1693,1631,62
São João Do Sul,421640,SC,Sul,BUTANTAN/SINOVAC,1099,690,409
São João Do Sul,421640,SC,Sul,PFIZER/BIONTECH,199,199,0
São João Do Tigre,251410,PB,Nordeste,BUTANTAN/SINOVAC,1178,606,572
São João Do Tigre,251410,PB,Nordeste,FIOCRUZ/ASTRAZENECA,1153,1083,70
São João Do Tigre,251410,PB,Nordeste,PFIZER/BIONTECH,90,90,0
São João Do Triunfo,412510,PR,Sul,FIOCRUZ/ASTRAZENECA,3053,2921,132
São João Do Triunfo,412510,PR,Sul,BUTANTAN/SINOVAC,2506,1309,1197
São João Do Triunfo,412510,PR,Sul,PFIZER/BIONTECH,152,152,0
São João Dos Patos,211110,MA,Nordeste,FIOCRUZ/ASTRAZENECA,10403,9859,544
São João Dos Patos,211110,MA,Nordeste,BUTANTAN/SINOVAC,4880,2517,2363
São João Dos Patos,211110,MA,Nordeste,PFIZER/BIONTECH,1779,1779,0
São João Evangelista,316280,MG,Sudeste,BUTANTAN/SINOVAC,3555,1834,1721
São João Evangelista,316280,MG,Sudeste,FIOCRUZ/ASTRAZENECA,2960,2751,209
São João Evangelista,316280,MG,Sudeste,PFIZER/BIONTECH,31,31,0
São João Nepomuceno,316290,MG,Sudeste,FIOCRUZ/ASTRAZENECA,6404,5952,452
São João Nepomuceno,316290,MG,Sudeste,BUTANTAN/SINOVAC,6031,3103,2928
São João Nepomuceno,316290,MG,Sudeste,PFIZER/BIONTECH,762,762,0
São Joaquim,421650,SC,Sul,FIOCRUZ/ASTRAZENECA,7429,6850,579
São Joaquim,421650,SC,Sul,BUTANTAN/SINOVAC,4865,2687,2178
São Joaquim,421650,SC,Sul,PFIZER/BIONTECH,372,372,0
São Joaquim Da Barra,354940,SP,Sudeste,BUTANTAN/SINOVAC,13594,6901,6693
São Joaquim Da Barra,354940,SP,Sudeste,FIOCRUZ/ASTRAZENECA,11661,10367,1294
São Joaquim Da Barra,354940,SP,Sudeste,PFIZER/BIONTECH,918,912,6
São Joaquim De Bicas,316292,MG,Sudeste,FIOCRUZ/ASTRAZENECA,5231,4874,357
São Joaquim De Bicas,316292,MG,Sudeste,BUTANTAN/SINOVAC,4319,2242,2077
São Joaquim De Bicas,316292,MG,Sudeste,PFIZER/BIONTECH,866,865,1
São Joaquim Do Monte,261330,PE,Nordeste,FIOCRUZ/ASTRAZENECA,3999,3641,358
São Joaquim Do Monte,261330,PE,Nordeste,BUTANTAN/SINOVAC,3825,2011,1814
São Joaquim Do Monte,261330,PE,Nordeste,PFIZER/BIONTECH,412,411,1
São Jorge,431844,RS,Sul,FIOCRUZ/ASTRAZENECA,903,751,152
São Jorge,431844,RS,Sul,BUTANTAN/SINOVAC,880,440,440
São Jorge,431844,RS,Sul,PFIZER/BIONTECH,120,120,0
São Jorge D'Oeste,412520,PR,Sul,FIOCRUZ/ASTRAZENECA,2673,2503,170
São Jorge D'Oeste,412520,PR,Sul,BUTANTAN/SINOVAC,2076,1075,1001
São Jorge D'Oeste,412520,PR,Sul,PFIZER/BIONTECH,138,138,0
São Jorge Do Ivaí,412530,PR,Sul,FIOCRUZ/ASTRAZENECA,2097,1995,102
São Jorge Do Ivaí,412530,PR,Sul,BUTANTAN/SINOVAC,1614,826,788
São Jorge Do Ivaí,412530,PR,Sul,PFIZER/BIONTECH,24,24,0
São Jorge Do Patrocínio,412535,PR,Sul,BUTANTAN/SINOVAC,1781,926,855
São Jorge Do Patrocínio,412535,PR,Sul,FIOCRUZ/ASTRAZENECA,1595,1457,138
São Jorge Do Patrocínio,412535,PR,Sul,PFIZER/BIONTECH,30,30,0
São José,421660,SC,Sul,BUTANTAN/SINOVAC,49575,27652,21923
São José,421660,SC,Sul,FIOCRUZ/ASTRAZENECA,16548,15207,1341
São José,421660,SC,Sul,PFIZER/BIONTECH,6626,6610,16
São José Da Barra,316294,MG,Sudeste,BUTANTAN/SINOVAC,1290,673,617
São José Da Barra,316294,MG,Sudeste,FIOCRUZ/ASTRAZENECA,1156,1087,69
São José Da Bela Vista,354950,SP,Sudeste,BUTANTAN/SINOVAC,2160,1170,990
São José Da Bela Vista,354950,SP,Sudeste,FIOCRUZ/ASTRAZENECA,1721,1573,148
São José Da Bela Vista,354950,SP,Sudeste,PFIZER/BIONTECH,200,200,0
São José Da Boa Vista,412540,PR,Sul,FIOCRUZ/ASTRAZENECA,1686,1585,101
São José Da Boa Vista,412540,PR,Sul,BUTANTAN/SINOVAC,1485,769,716
São José Da Boa Vista,412540,PR,Sul,PFIZER/BIONTECH,30,30,0
São José Da Coroa Grande,261340,PE,Nordeste,BUTANTAN/SINOVAC,4434,2537,1897
São José Da Coroa Grande,261340,PE,Nordeste,FIOCRUZ/ASTRAZENECA,4055,3829,226
São José Da Coroa Grande,261340,PE,Nordeste,PFIZER/BIONTECH,98,93,5
São José Da Lagoa Tapada,251420,PB,Nordeste,BUTANTAN/SINOVAC,2572,1325,1247
São José Da Lagoa Tapada,251420,PB,Nordeste,FIOCRUZ/ASTRAZENECA,1416,1295,121
São José Da Lagoa Tapada,251420,PB,Nordeste,PFIZER/BIONTECH,58,58,0
São José Da Laje,270830,AL,Nordeste,FIOCRUZ/ASTRAZENECA,4098,3782,316
São José Da Laje,270830,AL,Nordeste,BUTANTAN/SINOVAC,3540,1946,1594
São José Da Laje,270830,AL,Nordeste,PFIZER/BIONTECH,99,99,0
São José Da Lapa,316295,MG,Sudeste,BUTANTAN/SINOVAC,1177,676,501
São José Da Lapa,316295,MG,Sudeste,FIOCRUZ/ASTRAZENECA,479,378,101
São José Da Safira,316300,MG,Sudeste,BUTANTAN/SINOVAC,743,378,365
São José Da Safira,316300,MG,Sudeste,FIOCRUZ/ASTRAZENECA,646,581,65
São José Da Safira,316300,MG,Sudeste,PFIZER/BIONTECH,143,143,0
São José Da Tapera,270840,AL,Nordeste,FIOCRUZ/ASTRAZENECA,6345,5757,588
São José Da Tapera,270840,AL,Nordeste,BUTANTAN/SINOVAC,4023,2074,1949
São José Da Varginha,316310,MG,Sudeste,BUTANTAN/SINOVAC,1199,609,590
São José Da Varginha,316310,MG,Sudeste,FIOCRUZ/ASTRAZENECA,973,857,116
São José Da Varginha,316310,MG,Sudeste,PFIZER/BIONTECH,15,15,0
São José Da Vitória,292935,BA,Nordeste,BUTANTAN/SINOVAC,1385,751,634
São José Da Vitória,292935,BA,Nordeste,FIOCRUZ/ASTRAZENECA,1072,1037,35
São José Da Vitória,292935,BA,Nordeste,PFIZER/BIONTECH,109,109,0
São José Das Missões,431845,RS,Sul,BUTANTAN/SINOVAC,786,393,393
São José Das Missões,431845,RS,Sul,FIOCRUZ/ASTRAZENECA,756,694,62
São José Das Missões,431845,RS,Sul,PFIZER/BIONTECH,126,125,1
São José Das Palmeiras,412545,PR,Sul,FIOCRUZ/ASTRAZENECA,919,860,59
São José Das Palmeiras,412545,PR,Sul,BUTANTAN/SINOVAC,876,459,417
São José Das Palmeiras,412545,PR,Sul,PFIZER/BIONTECH,17,17,0
São José De Caiana,251430,PB,Nordeste,BUTANTAN/SINOVAC,1229,627,602
São José De Caiana,251430,PB,Nordeste,FIOCRUZ/ASTRAZENECA,964,890,74
São José De Caiana,251430,PB,Nordeste,PFIZER/BIONTECH,126,126,0
São José De Espinharas,251440,PB,Nordeste,BUTANTAN/SINOVAC,1160,584,576
São José De Espinharas,251440,PB,Nordeste,FIOCRUZ/ASTRAZENECA,855,776,79
São José De Espinharas,251440,PB,Nordeste,PFIZER/BIONTECH,162,162,0
São José De Mipibu,241220,RN,Nordeste,FIOCRUZ/ASTRAZENECA,6521,5749,772
São José De Mipibu,241220,RN,Nordeste,BUTANTAN/SINOVAC,6108,3055,3053
São José De Mipibu,241220,RN,Nordeste,PFIZER/BIONTECH,510,510,0
São José De Piranhas,251450,PB,Nordeste,BUTANTAN/SINOVAC,4652,2374,2278
São José De Piranhas,251450,PB,Nordeste,FIOCRUZ/ASTRAZENECA,3418,3103,315
São José De Piranhas,251450,PB,Nordeste,PFIZER/BIONTECH,576,576,0
São José De Princesa,251455,PB,Nordeste,BUTANTAN/SINOVAC,1074,540,534
São José De Princesa,251455,PB,Nordeste,FIOCRUZ/ASTRAZENECA,748,687,61
São José De Princesa,251455,PB,Nordeste,PFIZER/BIONTECH,104,104,0
São José De Ribamar,211120,MA,Nordeste,FIOCRUZ/ASTRAZENECA,63158,61987,1171
São José De Ribamar,211120,MA,Nordeste,BUTANTAN/SINOVAC,16391,8989,7402
São José De Ribamar,211120,MA,Nordeste,PFIZER/BIONTECH,1235,1234,1
São José De Ubá,330513,RJ,Sudeste,BUTANTAN/SINOVAC,2011,1086,925
São José De Ubá,330513,RJ,Sudeste,FIOCRUZ/ASTRAZENECA,944,882,62
São José Do Alegre,316320,MG,Sudeste,FIOCRUZ/ASTRAZENECA,966,926,40
São José Do Alegre,316320,MG,Sudeste,BUTANTAN/SINOVAC,817,421,396
São José Do Alegre,316320,MG,Sudeste,PFIZER/BIONTECH,111,111,0
São José Do Barreiro,354960,SP,Sudeste,FIOCRUZ/ASTRAZENECA,885,803,82
São José Do Barreiro,354960,SP,Sudeste,BUTANTAN/SINOVAC,875,410,465
São José Do Barreiro,354960,SP,Sudeste,PFIZER/BIONTECH,3,3,0
São José Do Belmonte,261350,PE,Nordeste,FIOCRUZ/ASTRAZENECA,7377,6787,590
São José Do Belmonte,261350,PE,Nordeste,BUTANTAN/SINOVAC,6068,3211,2857
São José Do Belmonte,261350,PE,Nordeste,PFIZER/BIONTECH,975,975,0
São José Do Bonfim,251460,PB,Nordeste,BUTANTAN/SINOVAC,699,356,343
São José Do Bonfim,251460,PB,Nordeste,FIOCRUZ/ASTRAZENECA,541,482,59
São José Do Bonfim,251460,PB,Nordeste,PFIZER/BIONTECH,48,48,0
São José Do Brejo Do Cruz,251465,PB,Nordeste,BUTANTAN/SINOVAC,756,398,358
São José Do Brejo Do Cruz,251465,PB,Nordeste,FIOCRUZ/ASTRAZENECA,430,383,47
São José Do Brejo Do Cruz,251465,PB,Nordeste,PFIZER/BIONTECH,60,60,0
São José Do Calçado,320480,ES,Sudeste,BUTANTAN/SINOVAC,3914,2142,1772
São José Do Calçado,320480,ES,Sudeste,FIOCRUZ/ASTRAZENECA,2526,2369,157
São José Do Calçado,320480,ES,Sudeste,PFIZER/BIONTECH,387,385,2
São José Do Campestre,241230,RN,Nordeste,BUTANTAN/SINOVAC,2959,1447,1512
São José Do Campestre,241230,RN,Nordeste,FIOCRUZ/ASTRAZENECA,1870,1723,147
São José Do Campestre,241230,RN,Nordeste,PFIZER/BIONTECH,117,117,0
São José Do Cedro,421670,SC,Sul,FIOCRUZ/ASTRAZENECA,3939,3630,309
São José Do Cedro,421670,SC,Sul,BUTANTAN/SINOVAC,3595,1938,1657
São José Do Cedro,421670,SC,Sul,PFIZER/BIONTECH,363,363,0
São José Do Cerrito,421680,SC,Sul,FIOCRUZ/ASTRAZENECA,2538,2387,151
São José Do Cerrito,421680,SC,Sul,BUTANTAN/SINOVAC,2197,1145,1052
São José Do Cerrito,421680,SC,Sul,PFIZER/BIONTECH,126,126,0
São José Do Divino,221005,PI,Nordeste,BUTANTAN/SINOVAC,923,500,423
São José Do Divino,221005,PI,Nordeste,FIOCRUZ/ASTRAZENECA,649,625,24
São José Do Divino,221005,PI,Nordeste,PFIZER/BIONTECH,65,65,0
São José Do Divino,316330,MG,Sudeste,BUTANTAN/SINOVAC,891,446,445
São José Do Divino,316330,MG,Sudeste,FIOCRUZ/ASTRAZENECA,657,566,91
São José Do Divino,316330,MG,Sudeste,PFIZER/BIONTECH,162,162,0
São José Do Egito,261360,PE,Nordeste,FIOCRUZ/ASTRAZENECA,12246,10364,1882
São José Do Egito,261360,PE,Nordeste,BUTANTAN/SINOVAC,6777,3440,3337
São José Do Egito,261360,PE,Nordeste,PFIZER/BIONTECH,495,495,0
São José Do Goiabal,316340,MG,Sudeste,FIOCRUZ/ASTRAZENECA,1608,1492,116
São José Do Goiabal,316340,MG,Sudeste,BUTANTAN/SINOVAC,1515,777,738
São José Do Goiabal,316340,MG,Sudeste,PFIZER/BIONTECH,64,64,0
São José Do Herval,431846,RS,Sul,FIOCRUZ/ASTRAZENECA,555,516,39
São José Do Herval,431846,RS,Sul,BUTANTAN/SINOVAC,518,257,261
São José Do Herval,431846,RS,Sul,PFIZER/BIONTECH,84,84,0
São José Do Hortêncio,431848,RS,Sul,BUTANTAN/SINOVAC,1358,681,677
São José Do Hortêncio,431848,RS,Sul,FIOCRUZ/ASTRAZENECA,1119,1034,85
São José Do Hortêncio,431848,RS,Sul,PFIZER/BIONTECH,175,174,1
São José Do Inhacorá,431849,RS,Sul,BUTANTAN/SINOVAC,982,501,481
São José Do Inhacorá,431849,RS,Sul,FIOCRUZ/ASTRAZENECA,782,697,85
São José Do Inhacorá,431849,RS,Sul,PFIZER/BIONTECH,88,88,0
São José Do Jacuípe,292937,BA,Nordeste,BUTANTAN/SINOVAC,2514,1298,1216
São José Do Jacuípe,292937,BA,Nordeste,FIOCRUZ/ASTRAZENECA,2270,2091,179
São José Do Jacuípe,292937,BA,Nordeste,PFIZER/BIONTECH,134,132,2
São José Do Jacuri,316350,MG,Sudeste,BUTANTAN/SINOVAC,1438,736,702
São José Do Jacuri,316350,MG,Sudeste,FIOCRUZ/ASTRAZENECA,1396,1247,149
São José Do Jacuri,316350,MG,Sudeste,PFIZER/BIONTECH,83,83,0
São José Do Mantimento,316360,MG,Sudeste,BUTANTAN/SINOVAC,621,325,296
São José Do Mantimento,316360,MG,Sudeste,FIOCRUZ/ASTRAZENECA,413,411,2
São José Do Mantimento,316360,MG,Sudeste,PFIZER/BIONTECH,15,15,0
São José Do Norte,431850,RS,Sul,FIOCRUZ/ASTRAZENECA,7406,6847,559
São José Do Norte,431850,RS,Sul,BUTANTAN/SINOVAC,6927,3523,3404
São José Do Norte,431850,RS,Sul,PFIZER/BIONTECH,1129,1125,4
São José Do Ouro,431860,RS,Sul,FIOCRUZ/ASTRAZENECA,2272,1965,307
São José Do Ouro,431860,RS,Sul,BUTANTAN/SINOVAC,2133,1080,1053
São José Do Ouro,431860,RS,Sul,PFIZER/BIONTECH,231,231,0
São José Do Peixe,221010,PI,Nordeste,BUTANTAN/SINOVAC,656,340,316
São José Do Peixe,221010,PI,Nordeste,FIOCRUZ/ASTRAZENECA,428,428,0
São José Do Piauí,221020,PI,Nordeste,FIOCRUZ/ASTRAZENECA,1804,1694,110
São José Do Piauí,221020,PI,Nordeste,BUTANTAN/SINOVAC,1420,729,691
São José Do Povo,510729,MT,Centro-Oeste,BUTANTAN/SINOVAC,1190,618,572
São José Do Povo,510729,MT,Centro-Oeste,FIOCRUZ/ASTRAZENECA,1008,935,73
São José Do Povo,510729,MT,Centro-Oeste,PFIZER/BIONTECH,1,1,0
São José Do Rio Claro,510730,MT,Centro-Oeste,BUTANTAN/SINOVAC,3284,1798,1486
São José Do Rio Claro,510730,MT,Centro-Oeste,FIOCRUZ/ASTRAZENECA,2623,2284,339
São José Do Rio Claro,510730,MT,Centro-Oeste,PFIZER/BIONTECH,36,36,0
São José Do Rio Pardo,354970,SP,Sudeste,BUTANTAN/SINOVAC,14056,7872,6184
São José Do Rio Pardo,354970,SP,Sudeste,FIOCRUZ/ASTRAZENECA,12569,11807,762
São José Do Rio Pardo,354970,SP,Sudeste,PFIZER/BIONTECH,536,535,1
São José Do Rio Preto,354980,SP,Sudeste,BUTANTAN/SINOVAC,124740,71489,53251
São José Do Rio Preto,354980,SP,Sudeste,FIOCRUZ/ASTRAZENECA,118741,110039,8702
São José Do Rio Preto,354980,SP,Sudeste,PFIZER/BIONTECH,10763,10751,12
São José Do Sabugi,251470,PB,Nordeste,BUTANTAN/SINOVAC,1013,513,500
São José Do Sabugi,251470,PB,Nordeste,FIOCRUZ/ASTRAZENECA,764,697,67
São José Do Sabugi,251470,PB,Nordeste,PFIZER/BIONTECH,43,43,0
São José Do Seridó,241240,RN,Nordeste,FIOCRUZ/ASTRAZENECA,1171,1100,71
São José Do Seridó,241240,RN,Nordeste,BUTANTAN/SINOVAC,1086,610,476
São José Do Seridó,241240,RN,Nordeste,PFIZER/BIONTECH,252,252,0
São José Do Sul,431861,RS,Sul,BUTANTAN/SINOVAC,931,469,462
São José Do Sul,431861,RS,Sul,FIOCRUZ/ASTRAZENECA,572,516,56
São José Do Sul,431861,RS,Sul,PFIZER/BIONTECH,102,102,0
São José Do Vale Do Rio Preto,330515,RJ,Sudeste,BUTANTAN/SINOVAC,4964,2588,2376
São José Do Vale Do Rio Preto,330515,RJ,Sudeste,FIOCRUZ/ASTRAZENECA,3499,3109,390
São José Do Vale Do Rio Preto,330515,RJ,Sudeste,PFIZER/BIONTECH,638,638,0
São José Do Xingu,510735,MT,Centro-Oeste,BUTANTAN/SINOVAC,797,422,375
São José Do Xingu,510735,MT,Centro-Oeste,FIOCRUZ/ASTRAZENECA,759,698,61
São José Do Xingu,510735,MT,Centro-Oeste,PFIZER/BIONTECH,108,108,0
São José Dos Ausentes,431862,RS,Sul,FIOCRUZ/ASTRAZENECA,1070,960,110
São José Dos Ausentes,431862,RS,Sul,BUTANTAN/SINOVAC,645,327,318
São José Dos Ausentes,431862,RS,Sul,PFIZER/BIONTECH,100,100,0
São José Dos Basílios,211125,MA,Nordeste,FIOCRUZ/ASTRAZENECA,1773,1656,117
São José Dos Basílios,211125,MA,Nordeste,BUTANTAN/SINOVAC,1483,769,714
São José Dos Campos,354990,SP,Sudeste,FIOCRUZ/ASTRAZENECA,214575,203256,11319
São José Dos Campos,354990,SP,Sudeste,BUTANTAN/SINOVAC,185689,105378,80311
São José Dos Campos,354990,SP,Sudeste,PFIZER/BIONTECH,14010,14010,0
São José Dos Cordeiros,251480,PB,Nordeste,BUTANTAN/SINOVAC,1050,537,513
São José Dos Cordeiros,251480,PB,Nordeste,FIOCRUZ/ASTRAZENECA,1031,947,84
São José Dos Cordeiros,251480,PB,Nordeste,PFIZER/BIONTECH,89,89,0
São José Dos Pinhais,412550,PR,Sul,FIOCRUZ/ASTRAZENECA,60313,55838,4475
São José Dos Pinhais,412550,PR,Sul,BUTANTAN/SINOVAC,58570,31319,27251
São José Dos Pinhais,412550,PR,Sul,PFIZER/BIONTECH,11027,11025,2
São José Dos Quatro Marcos,510710,MT,Centro-Oeste,FIOCRUZ/ASTRAZENECA,3711,3449,262
São José Dos Quatro Marcos,510710,MT,Centro-Oeste,BUTANTAN/SINOVAC,3493,1817,1676
São José Dos Quatro Marcos,510710,MT,Centro-Oeste,PFIZER/BIONTECH,232,232,0
São José Dos Ramos,251445,PB,Nordeste,BUTANTAN/SINOVAC,1157,584,573
São José Dos Ramos,251445,PB,Nordeste,FIOCRUZ/ASTRAZENECA,1044,941,103
São Julião,221030,PI,Nordeste,FIOCRUZ/ASTRAZENECA,1706,1429,277
São Julião,221030,PI,Nordeste,BUTANTAN/SINOVAC,1357,705,652
São Leopoldo,431870,RS,Sul,BUTANTAN/SINOVAC,49583,24981,24602
São Leopoldo,431870,RS,Sul,FIOCRUZ/ASTRAZENECA,48893,45796,3097
São Leopoldo,431870,RS,Sul,PFIZER/BIONTECH,2278,2277,1
São Lourenço,316370,MG,Sudeste,BUTANTAN/SINOVAC,11501,5830,5671
São Lourenço,316370,MG,Sudeste,FIOCRUZ/ASTRAZENECA,9666,8811,855
São Lourenço,316370,MG,Sudeste,PFIZER/BIONTECH,901,889,12
São Lourenço Da Mata,261370,PE,Nordeste,BUTANTAN/SINOVAC,14275,7554,6721
São Lourenço Da Mata,261370,PE,Nordeste,FIOCRUZ/ASTRAZENECA,11282,10391,891
São Lourenço Da Mata,261370,PE,Nordeste,PFIZER/BIONTECH,410,410,0
São Lourenço Da Serra,354995,SP,Sudeste,FIOCRUZ/ASTRAZENECA,3864,3697,167
São Lourenço Da Serra,354995,SP,Sudeste,BUTANTAN/SINOVAC,3203,1964,1239
São Lourenço Da Serra,354995,SP,Sudeste,PFIZER/BIONTECH,376,376,0
São Lourenço Do Oeste,421690,SC,Sul,BUTANTAN/SINOVAC,3492,1867,1625
São Lourenço Do Oeste,421690,SC,Sul,FIOCRUZ/ASTRAZENECA,2576,2218,358
São Lourenço Do Piauí,221035,PI,Nordeste,FIOCRUZ/ASTRAZENECA,1822,1492,330
São Lourenço Do Piauí,221035,PI,Nordeste,BUTANTAN/SINOVAC,1058,543,515
São Lourenço Do Piauí,221035,PI,Nordeste,PFIZER/BIONTECH,90,90,0
São Lourenço Do Sul,431880,RS,Sul,FIOCRUZ/ASTRAZENECA,12918,11487,1431
São Lourenço Do Sul,431880,RS,Sul,BUTANTAN/SINOVAC,11849,5989,5860
São Lourenço Do Sul,431880,RS,Sul,PFIZER/BIONTECH,1114,1114,0
São Ludgero,421700,SC,Sul,FIOCRUZ/ASTRAZENECA,3925,3668,257
São Ludgero,421700,SC,Sul,BUTANTAN/SINOVAC,1722,966,756
São Ludgero,421700,SC,Sul,PFIZER/BIONTECH,372,372,0
São Luís,211130,MA,Nordeste,FIOCRUZ/ASTRAZENECA,406858,381253,25605
São Luís,211130,MA,Nordeste,BUTANTAN/SINOVAC,198068,101756,96312
São Luís,211130,MA,Nordeste,PFIZER/BIONTECH,82929,82872,57
São Luís De Montes Belos,522010,GO,Centro-Oeste,FIOCRUZ/ASTRAZENECA,7208,6539,669
São Luís De Montes Belos,522010,GO,Centro-Oeste,BUTANTAN/SINOVAC,6533,3357,3176
São Luís De Montes Belos,522010,GO,Centro-Oeste,PFIZER/BIONTECH,1660,1659,1
São Luís Do Curu,231260,CE,Nordeste,BUTANTAN/SINOVAC,1731,1121,610
São Luís Do Curu,231260,CE,Nordeste,FIOCRUZ/ASTRAZENECA,265,259,6
São Luis Do Piauí,221037,PI,Nordeste,BUTANTAN/SINOVAC,534,273,261
São Luis Do Piauí,221037,PI,Nordeste,FIOCRUZ/ASTRAZENECA,472,444,28
São Luís Do Quitunde,270850,AL,Nordeste,FIOCRUZ/ASTRAZENECA,5175,4864,311
São Luís Do Quitunde,270850,AL,Nordeste,BUTANTAN/SINOVAC,3581,1862,1719
São Luís Gonzaga Do Maranhão,211140,MA,Nordeste,FIOCRUZ/ASTRAZENECA,3946,3764,182
São Luís Gonzaga Do Maranhão,211140,MA,Nordeste,BUTANTAN/SINOVAC,2430,1263,1167
São Luiz,140060,RR,Norte,BUTANTAN/SINOVAC,1202,668,534
São Luiz,140060,RR,Norte,FIOCRUZ/ASTRAZENECA,346,322,24
São Luiz Do Norte,522015,GO,Centro-Oeste,FIOCRUZ/ASTRAZENECA,1399,1359,40
São Luiz Do Norte,522015,GO,Centro-Oeste,BUTANTAN/SINOVAC,820,427,393
São Luiz Do Norte,522015,GO,Centro-Oeste,PFIZER/BIONTECH,72,72,0
São Luiz Do Paraitinga,355000,SP,Sudeste,BUTANTAN/SINOVAC,2810,1531,1279
São Luiz Do Paraitinga,355000,SP,Sudeste,FIOCRUZ/ASTRAZENECA,2753,2510,243
São Luiz Do Paraitinga,355000,SP,Sudeste,PFIZER/BIONTECH,418,418,0
São Luiz Gonzaga,431890,RS,Sul,BUTANTAN/SINOVAC,10159,5144,5015
São Luiz Gonzaga,431890,RS,Sul,FIOCRUZ/ASTRAZENECA,9231,8398,833
São Luiz Gonzaga,431890,RS,Sul,PFIZER/BIONTECH,1475,1475,0
São Mamede,251490,PB,Nordeste,BUTANTAN/SINOVAC,2263,1201,1062
São Mamede,251490,PB,Nordeste,FIOCRUZ/ASTRAZENECA,1607,1472,135
São Mamede,251490,PB,Nordeste,PFIZER/BIONTECH,299,299,0
São Manoel Do Paraná,412555,PR,Sul,FIOCRUZ/ASTRAZENECA,805,764,41
São Manoel Do Paraná,412555,PR,Sul,BUTANTAN/SINOVAC,643,341,302
São Manoel Do Paraná,412555,PR,Sul,PFIZER/BIONTECH,11,11,0
São Manuel,355010,SP,Sudeste,FIOCRUZ/ASTRAZENECA,9985,9067,918
São Manuel,355010,SP,Sudeste,BUTANTAN/SINOVAC,9493,5175,4318
São Manuel,355010,SP,Sudeste,PFIZER/BIONTECH,190,190,0
São Marcos,431900,RS,Sul,BUTANTAN/SINOVAC,5207,2627,2580
São Marcos,431900,RS,Sul,FIOCRUZ/ASTRAZENECA,4969,4375,594
São Marcos,431900,RS,Sul,PFIZER/BIONTECH,337,337,0
São Martinho,421710,SC,Sul,FIOCRUZ/ASTRAZENECA,1235,1032,203
São Martinho,421710,SC,Sul,BUTANTAN/SINOVAC,901,475,426
São Martinho,421710,SC,Sul,PFIZER/BIONTECH,35,35,0
São Martinho,431910,RS,Sul,BUTANTAN/SINOVAC,2021,1004,1017
São Martinho,431910,RS,Sul,FIOCRUZ/ASTRAZENECA,1709,1488,221
São Martinho,431910,RS,Sul,PFIZER/BIONTECH,225,224,1
São Martinho Da Serra,431912,RS,Sul,BUTANTAN/SINOVAC,1001,593,408
São Martinho Da Serra,431912,RS,Sul,FIOCRUZ/ASTRAZENECA,822,770,52
São Martinho Da Serra,431912,RS,Sul,PFIZER/BIONTECH,55,55,0
São Mateus,320490,ES,Sudeste,FIOCRUZ/ASTRAZENECA,37700,34999,2701
São Mateus,320490,ES,Sudeste,BUTANTAN/SINOVAC,25594,13936,11658
São Mateus,320490,ES,Sudeste,PFIZER/BIONTECH,2334,2331,3
São Mateus Do Maranhão,211150,MA,Nordeste,FIOCRUZ/ASTRAZENECA,6970,6501,469
São Mateus Do Maranhão,211150,MA,Nordeste,BUTANTAN/SINOVAC,5695,2938,2757
São Mateus Do Sul,412560,PR,Sul,FIOCRUZ/ASTRAZENECA,10131,9601,530
São Mateus Do Sul,412560,PR,Sul,BUTANTAN/SINOVAC,7475,3799,3676
São Mateus Do Sul,412560,PR,Sul,PFIZER/BIONTECH,2334,2334,0
São Miguel,241250,RN,Nordeste,FIOCRUZ/ASTRAZENECA,5806,5399,407
São Miguel,241250,RN,Nordeste,BUTANTAN/SINOVAC,4983,2579,2404
São Miguel,241250,RN,Nordeste,PFIZER/BIONTECH,304,302,2
São Miguel Arcanjo,355020,SP,Sudeste,FIOCRUZ/ASTRAZENECA,6652,6204,448
São Miguel Arcanjo,355020,SP,Sudeste,BUTANTAN/SINOVAC,6215,3316,2899
São Miguel Arcanjo,355020,SP,Sudeste,PFIZER/BIONTECH,447,447,0
São Miguel Da Baixa Grande,221038,PI,Nordeste,FIOCRUZ/ASTRAZENECA,577,533,44
São Miguel Da Baixa Grande,221038,PI,Nordeste,BUTANTAN/SINOVAC,567,301,266
São Miguel Da Baixa Grande,221038,PI,Nordeste,PFIZER/BIONTECH,59,59,0
São Miguel Da Boa Vista,421715,SC,Sul,BUTANTAN/SINOVAC,1193,605,588
São Miguel Da Boa Vista,421715,SC,Sul,FIOCRUZ/ASTRAZENECA,842,766,76
São Miguel Da Boa Vista,421715,SC,Sul,PFIZER/BIONTECH,31,31,0
São Miguel Das Matas,292940,BA,Nordeste,BUTANTAN/SINOVAC,2004,1036,968
São Miguel Das Matas,292940,BA,Nordeste,FIOCRUZ/ASTRAZENECA,1666,1547,119
São Miguel Das Matas,292940,BA,Nordeste,PFIZER/BIONTECH,200,200,0
São Miguel Das Missões,431915,RS,Sul,BUTANTAN/SINOVAC,2545,1301,1244
São Miguel Das Missões,431915,RS,Sul,FIOCRUZ/ASTRAZENECA,1988,1830,158
São Miguel Das Missões,431915,RS,Sul,PFIZER/BIONTECH,282,282,0
São Miguel De Taipu,251500,PB,Nordeste,BUTANTAN/SINOVAC,1344,690,654
São Miguel De Taipu,251500,PB,Nordeste,FIOCRUZ/ASTRAZENECA,1063,983,80
São Miguel De Taipu,251500,PB,Nordeste,PFIZER/BIONTECH,62,62,0
São Miguel Do Aleixo,280700,SE,Nordeste,BUTANTAN/SINOVAC,975,535,440
São Miguel Do Aleixo,280700,SE,Nordeste,FIOCRUZ/ASTRAZENECA,647,647,0
São Miguel Do Aleixo,280700,SE,Nordeste,PFIZER/BIONTECH,65,65,0
São Miguel Do Anta,316380,MG,Sudeste,BUTANTAN/SINOVAC,1723,853,870
São Miguel Do Anta,316380,MG,Sudeste,FIOCRUZ/ASTRAZENECA,1571,1415,156
São Miguel Do Anta,316380,MG,Sudeste,PFIZER/BIONTECH,211,211,0
São Miguel Do Araguaia,522020,GO,Centro-Oeste,FIOCRUZ/ASTRAZENECA,5964,5543,421
São Miguel Do Araguaia,522020,GO,Centro-Oeste,BUTANTAN/SINOVAC,3565,2015,1550
São Miguel Do Fidalgo,221039,PI,Nordeste,BUTANTAN/SINOVAC,517,306,211
São Miguel Do Fidalgo,221039,PI,Nordeste,FIOCRUZ/ASTRAZENECA,432,411,21
São Miguel Do Gostoso,241255,RN,Nordeste,BUTANTAN/SINOVAC,1775,901,874
São Miguel Do Gostoso,241255,RN,Nordeste,FIOCRUZ/ASTRAZENECA,1248,1187,61
São Miguel Do Gostoso,241255,RN,Nordeste,PFIZER/BIONTECH,182,182,0
São Miguel Do Guamá,150760,PA,Norte,FIOCRUZ/ASTRAZENECA,14022,13060,962
São Miguel Do Guamá,150760,PA,Norte,BUTANTAN/SINOVAC,12329,6580,5749
São Miguel Do Guaporé,110032,RO,Norte,BUTANTAN/SINOVAC,2914,1463,1451
São Miguel Do Guaporé,110032,RO,Norte,FIOCRUZ/ASTRAZENECA,2363,2282,81
São Miguel Do Guaporé,110032,RO,Norte,PFIZER/BIONTECH,48,48,0
São Miguel Do Iguaçu,412570,PR,Sul,BUTANTAN/SINOVAC,6769,3461,3308
São Miguel Do Iguaçu,412570,PR,Sul,FIOCRUZ/ASTRAZENECA,5918,5632,286
São Miguel Do Iguaçu,412570,PR,Sul,PFIZER/BIONTECH,432,432,0
São Miguel Do Oeste,421720,SC,Sul,FIOCRUZ/ASTRAZENECA,13262,11649,1613
São Miguel Do Oeste,421720,SC,Sul,BUTANTAN/SINOVAC,8619,4503,4116
São Miguel Do Oeste,421720,SC,Sul,PFIZER/BIONTECH,760,760,0
São Miguel Do Passa Quatro,522026,GO,Centro-Oeste,FIOCRUZ/ASTRAZENECA,1090,1010,80
São Miguel Do Passa Quatro,522026,GO,Centro-Oeste,BUTANTAN/SINOVAC,1024,548,476
São Miguel Do Tapuio,221040,PI,Nordeste,BUTANTAN/SINOVAC,2625,1534,1091
São Miguel Do Tapuio,221040,PI,Nordeste,FIOCRUZ/ASTRAZENECA,2104,1964,140
São Miguel Do Tocantins,172020,TO,Norte,BUTANTAN/SINOVAC,1755,888,867
São Miguel Do Tocantins,172020,TO,Norte,FIOCRUZ/ASTRAZENECA,1203,1133,70
São Miguel Dos Campos,270860,AL,Nordeste,FIOCRUZ/ASTRAZENECA,9323,8887,436
São Miguel Dos Campos,270860,AL,Nordeste,BUTANTAN/SINOVAC,7568,3891,3677
São Miguel Dos Campos,270860,AL,Nordeste,PFIZER/BIONTECH,3756,3756,0
São Miguel Dos Milagres,270870,AL,Nordeste,FIOCRUZ/ASTRAZENECA,1168,1013,155
São Miguel Dos Milagres,270870,AL,Nordeste,BUTANTAN/SINOVAC,1139,635,504
São Nicolau,431920,RS,Sul,BUTANTAN/SINOVAC,1683,838,845
São Nicolau,431920,RS,Sul,FIOCRUZ/ASTRAZENECA,1389,1206,183
São Nicolau,431920,RS,Sul,PFIZER/BIONTECH,202,202,0
São Patrício,522028,GO,Centro-Oeste,FIOCRUZ/ASTRAZENECA,843,766,77
São Patrício,522028,GO,Centro-Oeste,BUTANTAN/SINOVAC,680,406,274
São Patrício,522028,GO,Centro-Oeste,PFIZER/BIONTECH,31,29,2
São Paulo,355030,SP,Sudeste,BUTANTAN/SINOVAC,2947071,1727941,1219130
São Paulo,355030,SP,Sudeste,FIOCRUZ/ASTRAZENECA,2283143,2027397,255746
São Paulo,355030,SP,Sudeste,PFIZER/BIONTECH,923133,921604,1529
São Paulo Das Missões,431930,RS,Sul,BUTANTAN/SINOVAC,2115,1064,1051
São Paulo Das Missões,431930,RS,Sul,FIOCRUZ/ASTRAZENECA,1802,1662,140
São Paulo Das Missões,431930,RS,Sul,PFIZER/BIONTECH,172,172,0
São Paulo De Olivença,130390,AM,Norte,BUTANTAN/SINOVAC,8419,6804,1615
São Paulo De Olivença,130390,AM,Norte,FIOCRUZ/ASTRAZENECA,3567,2959,608
São Paulo Do Potengi,241260,RN,Nordeste,BUTANTAN/SINOVAC,2726,1633,1093
São Paulo Do Potengi,241260,RN,Nordeste,FIOCRUZ/ASTRAZENECA,1937,1707,230
São Paulo Do Potengi,241260,RN,Nordeste,PFIZER/BIONTECH,121,121,0
São Pedro,241270,RN,Nordeste,BUTANTAN/SINOVAC,1412,739,673
São Pedro,241270,RN,Nordeste,FIOCRUZ/ASTRAZENECA,1098,1045,53
São Pedro,241270,RN,Nordeste,PFIZER/BIONTECH,168,168,0
São Pedro,355040,SP,Sudeste,BUTANTAN/SINOVAC,9071,5047,4024
São Pedro,355040,SP,Sudeste,FIOCRUZ/ASTRAZENECA,8697,8004,693
São Pedro,355040,SP,Sudeste,PFIZER/BIONTECH,442,441,1
São Pedro Da Água Branca,211153,MA,Nordeste,BUTANTAN/SINOVAC,1403,718,685
São Pedro Da Água Branca,211153,MA,Nordeste,FIOCRUZ/ASTRAZENECA,1378,1311,67
São Pedro Da Aldeia,330520,RJ,Sudeste,BUTANTAN/SINOVAC,16768,9326,7442
São Pedro Da Aldeia,330520,RJ,Sudeste,FIOCRUZ/ASTRAZENECA,11980,10866,1114
São Pedro Da Cipa,510740,MT,Centro-Oeste,BUTANTAN/SINOVAC,672,343,329
São Pedro Da Cipa,510740,MT,Centro-Oeste,FIOCRUZ/ASTRAZENECA,574,540,34
São Pedro Da Cipa,510740,MT,Centro-Oeste,PFIZER/BIONTECH,120,120,0
São Pedro Da Serra,431935,RS,Sul,BUTANTAN/SINOVAC,880,463,417
São Pedro Da Serra,431935,RS,Sul,FIOCRUZ/ASTRAZENECA,780,756,24
São Pedro Da Serra,431935,RS,Sul,PFIZER/BIONTECH,147,147,0
São Pedro Da União,316390,MG,Sudeste,FIOCRUZ/ASTRAZENECA,1499,1396,103
São Pedro Da União,316390,MG,Sudeste,BUTANTAN/SINOVAC,1334,670,664
São Pedro Da União,316390,MG,Sudeste,PFIZER/BIONTECH,83,83,0
São Pedro Das Missões,431936,RS,Sul,BUTANTAN/SINOVAC,596,304,292
São Pedro Das Missões,431936,RS,Sul,FIOCRUZ/ASTRAZENECA,576,502,74
São Pedro Das Missões,431936,RS,Sul,PFIZER/BIONTECH,96,96,0
São Pedro De Alcântara,421725,SC,Sul,BUTANTAN/SINOVAC,1686,978,708
São Pedro De Alcântara,421725,SC,Sul,FIOCRUZ/ASTRAZENECA,1371,1258,113
São Pedro Do Butiá,431937,RS,Sul,FIOCRUZ/ASTRAZENECA,866,794,72
São Pedro Do Butiá,431937,RS,Sul,BUTANTAN/SINOVAC,834,413,421
São Pedro Do Butiá,431937,RS,Sul,PFIZER/BIONTECH,127,126,1
São Pedro Do Iguaçu,412575,PR,Sul,BUTANTAN/SINOVAC,1832,944,888
São Pedro Do Iguaçu,412575,PR,Sul,FIOCRUZ/ASTRAZENECA,1100,1062,38
São Pedro Do Ivaí,412580,PR,Sul,FIOCRUZ/ASTRAZENECA,2482,2292,190
São Pedro Do Ivaí,412580,PR,Sul,BUTANTAN/SINOVAC,2183,1110,1073
São Pedro Do Ivaí,412580,PR,Sul,PFIZER/BIONTECH,106,106,0
São Pedro Do Paraná,412590,PR,Sul,FIOCRUZ/ASTRAZENECA,908,852,56
São Pedro Do Paraná,412590,PR,Sul,BUTANTAN/SINOVAC,701,385,316
São Pedro Do Paraná,412590,PR,Sul,PFIZER/BIONTECH,18,18,0
São Pedro Do Piauí,221050,PI,Nordeste,FIOCRUZ/ASTRAZENECA,2621,2504,117
São Pedro Do Piauí,221050,PI,Nordeste,BUTANTAN/SINOVAC,2593,1400,1193
São Pedro Do Piauí,221050,PI,Nordeste,PFIZER/BIONTECH,321,321,0
São Pedro Do Suaçuí,316410,MG,Sudeste,BUTANTAN/SINOVAC,1426,745,681
São Pedro Do Suaçuí,316410,MG,Sudeste,FIOCRUZ/ASTRAZENECA,1144,1028,116
São Pedro Do Suaçuí,316410,MG,Sudeste,PFIZER/BIONTECH,56,56,0
São Pedro Do Sul,431940,RS,Sul,BUTANTAN/SINOVAC,5312,2722,2590
São Pedro Do Sul,431940,RS,Sul,FIOCRUZ/ASTRAZENECA,5043,4286,757
São Pedro Do Sul,431940,RS,Sul,PFIZER/BIONTECH,585,582,3
São Pedro Do Turvo,355050,SP,Sudeste,BUTANTAN/SINOVAC,2618,1293,1325
São Pedro Do Turvo,355050,SP,Sudeste,FIOCRUZ/ASTRAZENECA,2392,2214,178
São Pedro Do Turvo,355050,SP,Sudeste,PFIZER/BIONTECH,263,263,0
São Pedro Dos Crentes,211157,MA,Nordeste,FIOCRUZ/ASTRAZENECA,931,855,76
São Pedro Dos Crentes,211157,MA,Nordeste,BUTANTAN/SINOVAC,779,432,347
São Pedro Dos Ferros,316400,MG,Sudeste,BUTANTAN/SINOVAC,2216,1218,998
São Pedro Dos Ferros,316400,MG,Sudeste,FIOCRUZ/ASTRAZENECA,1984,1843,141
São Pedro Dos Ferros,316400,MG,Sudeste,PFIZER/BIONTECH,134,133,1
São Rafael,241280,RN,Nordeste,BUTANTAN/SINOVAC,2487,1298,1189
São Rafael,241280,RN,Nordeste,FIOCRUZ/ASTRAZENECA,2143,2014,129
São Rafael,241280,RN,Nordeste,PFIZER/BIONTECH,245,245,0
São Raimundo Das Mangabeiras,211160,MA,Nordeste,FIOCRUZ/ASTRAZENECA,3499,3264,235
São Raimundo Das Mangabeiras,211160,MA,Nordeste,BUTANTAN/SINOVAC,3050,1636,1414
São Raimundo Do Doca Bezerra,211163,MA,Nordeste,FIOCRUZ/ASTRAZENECA,899,838,61
São Raimundo Do Doca Bezerra,211163,MA,Nordeste,BUTANTAN/SINOVAC,629,343,286
São Raimundo Nonato,221060,PI,Nordeste,FIOCRUZ/ASTRAZENECA,8395,8164,231
São Raimundo Nonato,221060,PI,Nordeste,BUTANTAN/SINOVAC,4978,2540,2438
São Raimundo Nonato,221060,PI,Nordeste,PFIZER/BIONTECH,249,249,0
São Roberto,211167,MA,Nordeste,FIOCRUZ/ASTRAZENECA,779,732,47
São Roberto,211167,MA,Nordeste,BUTANTAN/SINOVAC,677,396,281
São Romão,316420,MG,Sudeste,FIOCRUZ/ASTRAZENECA,1985,1865,120
São Romão,316420,MG,Sudeste,BUTANTAN/SINOVAC,1404,728,676
São Romão,316420,MG,Sudeste,PFIZER/BIONTECH,243,243,0
São Roque,355060,SP,Sudeste,BUTANTAN/SINOVAC,18695,10324,8371
São Roque,355060,SP,Sudeste,FIOCRUZ/ASTRAZENECA,18243,16515,1728
São Roque,355060,SP,Sudeste,PFIZER/BIONTECH,294,294,0
São Roque De Minas,316430,MG,Sudeste,BUTANTAN/SINOVAC,1655,845,810
São Roque De Minas,316430,MG,Sudeste,FIOCRUZ/ASTRAZENECA,1333,1205,128
São Roque De Minas,316430,MG,Sudeste,PFIZER/BIONTECH,150,150,0
São Roque Do Canaã,320495,ES,Sudeste,BUTANTAN/SINOVAC,3547,1785,1762
São Roque Do Canaã,320495,ES,Sudeste,FIOCRUZ/ASTRAZENECA,2989,2852,137
São Roque Do Canaã,320495,ES,Sudeste,PFIZER/BIONTECH,511,511,0
São Salvador Do Tocantins,172025,TO,Norte,FIOCRUZ/ASTRAZENECA,792,759,33
São Salvador Do Tocantins,172025,TO,Norte,BUTANTAN/SINOVAC,510,275,235
São Sebastião,270880,AL,Nordeste,FIOCRUZ/ASTRAZENECA,7143,6627,516
São Sebastião,270880,AL,Nordeste,BUTANTAN/SINOVAC,6326,3198,3128
São Sebastião,355070,SP,Sudeste,FIOCRUZ/ASTRAZENECA,19454,18364,1090
São Sebastião,355070,SP,Sudeste,BUTANTAN/SINOVAC,15416,9517,5899
São Sebastião,355070,SP,Sudeste,PFIZER/BIONTECH,1597,1581,16
São Sebastião Da Amoreira,412600,PR,Sul,FIOCRUZ/ASTRAZENECA,2915,2806,109
São Sebastião Da Amoreira,412600,PR,Sul,BUTANTAN/SINOVAC,1909,981,928
São Sebastião Da Amoreira,412600,PR,Sul,PFIZER/BIONTECH,76,76,0
São Sebastião Da Bela Vista,316440,MG,Sudeste,FIOCRUZ/ASTRAZENECA,1263,1192,71
São Sebastião Da Bela Vista,316440,MG,Sudeste,BUTANTAN/SINOVAC,1128,567,561
São Sebastião Da Bela Vista,316440,MG,Sudeste,PFIZER/BIONTECH,78,78,0
São Sebastião Da Boa Vista,150770,PA,Norte,FIOCRUZ/ASTRAZENECA,2931,2808,123
São Sebastião Da Boa Vista,150770,PA,Norte,BUTANTAN/SINOVAC,1392,754,638
São Sebastião Da Grama,355080,SP,Sudeste,BUTANTAN/SINOVAC,3109,1639,1470
São Sebastião Da Grama,355080,SP,Sudeste,FIOCRUZ/ASTRAZENECA,3087,2791,296
São Sebastião Da Grama,355080,SP,Sudeste,PFIZER/BIONTECH,128,128,0
São Sebastião Da Vargem Alegre,316443,MG,Sudeste,BUTANTAN/SINOVAC,1083,610,473
São Sebastião Da Vargem Alegre,316443,MG,Sudeste,FIOCRUZ/ASTRAZENECA,812,750,62
São Sebastião Da Vargem Alegre,316443,MG,Sudeste,PFIZER/BIONTECH,61,61,0
São Sebastião De Lagoa De Roça,251510,PB,Nordeste,BUTANTAN/SINOVAC,2757,1495,1262
São Sebastião De Lagoa De Roça,251510,PB,Nordeste,FIOCRUZ/ASTRAZENECA,1142,1014,128
São Sebastião Do Alto,330530,RJ,Sudeste,FIOCRUZ/ASTRAZENECA,1275,1265,10
São Sebastião Do Alto,330530,RJ,Sudeste,BUTANTAN/SINOVAC,955,593,362
São Sebastião Do Anta,316447,MG,Sudeste,FIOCRUZ/ASTRAZENECA,1229,1098,131
São Sebastião Do Anta,316447,MG,Sudeste,BUTANTAN/SINOVAC,1092,584,508
São Sebastião Do Anta,316447,MG,Sudeste,PFIZER/BIONTECH,95,95,0
São Sebastião Do Caí,431950,RS,Sul,BUTANTAN/SINOVAC,6064,3061,3003
São Sebastião Do Caí,431950,RS,Sul,FIOCRUZ/ASTRAZENECA,5997,5555,442
São Sebastião Do Caí,431950,RS,Sul,PFIZER/BIONTECH,646,646,0
São Sebastião Do Maranhão,316450,MG,Sudeste,BUTANTAN/SINOVAC,1920,989,931
São Sebastião Do Maranhão,316450,MG,Sudeste,FIOCRUZ/ASTRAZENECA,1485,1392,93
São Sebastião Do Maranhão,316450,MG,Sudeste,PFIZER/BIONTECH,88,88,0
São Sebastião Do Oeste,316460,MG,Sudeste,BUTANTAN/SINOVAC,1510,781,729
São Sebastião Do Oeste,316460,MG,Sudeste,FIOCRUZ/ASTRAZENECA,1414,1319,95
São Sebastião Do Oeste,316460,MG,Sudeste,PFIZER/BIONTECH,81,81,0
São Sebastião Do Paraíso,316470,MG,Sudeste,BUTANTAN/SINOVAC,15746,7921,7825
São Sebastião Do Paraíso,316470,MG,Sudeste,FIOCRUZ/ASTRAZENECA,12485,11538,947
São Sebastião Do Paraíso,316470,MG,Sudeste,PFIZER/BIONTECH,804,804,0
São Sebastião Do Passé,292950,BA,Nordeste,BUTANTAN/SINOVAC,7521,3929,3592
São Sebastião Do Passé,292950,BA,Nordeste,FIOCRUZ/ASTRAZENECA,6577,6012,565
São Sebastião Do Passé,292950,BA,Nordeste,PFIZER/BIONTECH,1666,1661,5
São Sebastião Do Rio Preto,316480,MG,Sudeste,BUTANTAN/SINOVAC,643,353,290
São Sebastião Do Rio Preto,316480,MG,Sudeste,FIOCRUZ/ASTRAZENECA,619,559,60
São Sebastião Do Rio Preto,316480,MG,Sudeste,PFIZER/BIONTECH,47,47,0
São Sebastião Do Rio Verde,316490,MG,Sudeste,BUTANTAN/SINOVAC,581,301,280
São Sebastião Do Rio Verde,316490,MG,Sudeste,FIOCRUZ/ASTRAZENECA,362,359,3
São Sebastião Do Tocantins,172030,TO,Norte,BUTANTAN/SINOVAC,763,417,346
São Sebastião Do Tocantins,172030,TO,Norte,FIOCRUZ/ASTRAZENECA,583,544,39
São Sebastião Do Uatumã,130395,AM,Norte,FIOCRUZ/ASTRAZENECA,1958,1748,210
São Sebastião Do Uatumã,130395,AM,Norte,BUTANTAN/SINOVAC,1394,768,626
São Sebastião Do Umbuzeiro,251520,PB,Nordeste,BUTANTAN/SINOVAC,1238,650,588
São Sebastião Do Umbuzeiro,251520,PB,Nordeste,FIOCRUZ/ASTRAZENECA,701,602,99
São Sebastião Do Umbuzeiro,251520,PB,Nordeste,PFIZER/BIONTECH,22,22,0
São Sepé,431960,RS,Sul,BUTANTAN/SINOVAC,6629,3502,3127
São Sepé,431960,RS,Sul,FIOCRUZ/ASTRAZENECA,6532,5830,702
São Sepé,431960,RS,Sul,PFIZER/BIONTECH,454,449,5
São Simão,355090,SP,Sudeste,BUTANTAN/SINOVAC,3917,2188,1729
São Simão,355090,SP,Sudeste,FIOCRUZ/ASTRAZENECA,3653,3320,333
São Simão,355090,SP,Sudeste,PFIZER/BIONTECH,364,364,0
São Simão,522040,GO,Centro-Oeste,FIOCRUZ/ASTRAZENECA,4386,4127,259
São Simão,522040,GO,Centro-Oeste,BUTANTAN/SINOVAC,3101,1570,1531
São Thomé Das Letras,316520,MG,Sudeste,FIOCRUZ/ASTRAZENECA,1691,1580,111
São Thomé Das Letras,316520,MG,Sudeste,BUTANTAN/SINOVAC,1015,537,478
São Thomé Das Letras,316520,MG,Sudeste,PFIZER/BIONTECH,100,100,0
São Tiago,316500,MG,Sudeste,BUTANTAN/SINOVAC,2320,1169,1151
São Tiago,316500,MG,Sudeste,FIOCRUZ/ASTRAZENECA,1851,1605,246
São Tiago,316500,MG,Sudeste,PFIZER/BIONTECH,77,77,0
São Tomás De Aquino,316510,MG,Sudeste,BUTANTAN/SINOVAC,1839,931,908
São Tomás De Aquino,316510,MG,Sudeste,FIOCRUZ/ASTRAZENECA,1459,1419,40
São Tomás De Aquino,316510,MG,Sudeste,PFIZER/BIONTECH,29,29,0
São Tomé,241290,RN,Nordeste,FIOCRUZ/ASTRAZENECA,2874,2449,425
São Tomé,241290,RN,Nordeste,BUTANTAN/SINOVAC,2655,1375,1280
São Tomé,241290,RN,Nordeste,PFIZER/BIONTECH,279,279,0
São Tomé,412610,PR,Sul,FIOCRUZ/ASTRAZENECA,1627,1535,92
São Tomé,412610,PR,Sul,BUTANTAN/SINOVAC,1158,607,551
São Tomé,412610,PR,Sul,PFIZER/BIONTECH,30,30,0
São Valentim,431970,RS,Sul,BUTANTAN/SINOVAC,1439,727,712
São Valentim,431970,RS,Sul,FIOCRUZ/ASTRAZENECA,1091,954,137
São Valentim,431970,RS,Sul,PFIZER/BIONTECH,87,86,1
São Valentim Do Sul,431971,RS,Sul,BUTANTAN/SINOVAC,820,429,391
São Valentim Do Sul,431971,RS,Sul,FIOCRUZ/ASTRAZENECA,690,602,88
São Valentim Do Sul,431971,RS,Sul,PFIZER/BIONTECH,99,99,0
São Valério,172049,TO,Norte,BUTANTAN/SINOVAC,926,470,456
São Valério,172049,TO,Norte,FIOCRUZ/ASTRAZENECA,809,777,32
São Valério Do Sul,431973,RS,Sul,BUTANTAN/SINOVAC,2194,1120,1074
São Valério Do Sul,431973,RS,Sul,FIOCRUZ/ASTRAZENECA,355,316,39
São Valério Do Sul,431973,RS,Sul,PFIZER/BIONTECH,70,70,0
São Vendelino,431975,RS,Sul,FIOCRUZ/ASTRAZENECA,652,563,89
São Vendelino,431975,RS,Sul,BUTANTAN/SINOVAC,526,264,262
São Vendelino,431975,RS,Sul,PFIZER/BIONTECH,106,106,0
São Vicente,241300,RN,Nordeste,BUTANTAN/SINOVAC,1506,798,708
São Vicente,241300,RN,Nordeste,FIOCRUZ/ASTRAZENECA,1363,1274,89
São Vicente,241300,RN,Nordeste,PFIZER/BIONTECH,173,173,0
São Vicente,355100,SP,Sudeste,BUTANTAN/SINOVAC,73458,43883,29575
São Vicente,355100,SP,Sudeste,FIOCRUZ/ASTRAZENECA,66463,63005,3458
São Vicente,355100,SP,Sudeste,PFIZER/BIONTECH,2112,2109,3
São Vicente De Minas,316530,MG,Sudeste,BUTANTAN/SINOVAC,1679,849,830
São Vicente De Minas,316530,MG,Sudeste,FIOCRUZ/ASTRAZENECA,1539,1393,146
São Vicente De Minas,316530,MG,Sudeste,PFIZER/BIONTECH,138,138,0
São Vicente Do Sul,431980,RS,Sul,FIOCRUZ/ASTRAZENECA,2647,2306,341
São Vicente Do Sul,431980,RS,Sul,BUTANTAN/SINOVAC,2240,1131,1109
São Vicente Do Sul,431980,RS,Sul,PFIZER/BIONTECH,341,341,0
São Vicente Ferrer,211170,MA,Nordeste,FIOCRUZ/ASTRAZENECA,6623,6302,321
São Vicente Ferrer,211170,MA,Nordeste,BUTANTAN/SINOVAC,2641,1412,1229
São Vicente Férrer,261380,PE,Nordeste,FIOCRUZ/ASTRAZENECA,4796,4465,331
São Vicente Férrer,261380,PE,Nordeste,BUTANTAN/SINOVAC,3433,1797,1636
São Vicente Férrer,261380,PE,Nordeste,PFIZER/BIONTECH,318,318,0
Sapé,251530,PB,Nordeste,BUTANTAN/SINOVAC,14522,8303,6219
Sapé,251530,PB,Nordeste,FIOCRUZ/ASTRAZENECA,7467,6953,514
Sapé,251530,PB,Nordeste,PFIZER/BIONTECH,550,550,0
Sapeaçu,292960,BA,Nordeste,FIOCRUZ/ASTRAZENECA,4381,3990,391
Sapeaçu,292960,BA,Nordeste,BUTANTAN/SINOVAC,3483,1807,1676
Sapeaçu,292960,BA,Nordeste,PFIZER/BIONTECH,775,775,0
Sapezal,510787,MT,Centro-Oeste,FIOCRUZ/ASTRAZENECA,2483,2242,241
Sapezal,510787,MT,Centro-Oeste,BUTANTAN/SINOVAC,1499,798,701
Sapezal,510787,MT,Centro-Oeste,PFIZER/BIONTECH,229,229,0
Sapiranga,431990,RS,Sul,FIOCRUZ/ASTRAZENECA,18881,17814,1067
Sapiranga,431990,RS,Sul,BUTANTAN/SINOVAC,14558,7343,7215
Sapiranga,431990,RS,Sul,PFIZER/BIONTECH,2269,2266,3
Sapopema,412620,PR,Sul,FIOCRUZ/ASTRAZENECA,1797,1696,101
Sapopema,412620,PR,Sul,BUTANTAN/SINOVAC,1511,779,732
Sapopema,412620,PR,Sul,PFIZER/BIONTECH,23,23,0
Sapucaí-Mirim,316540,MG,Sudeste,BUTANTAN/SINOVAC,1265,653,612
Sapucaí-Mirim,316540,MG,Sudeste,FIOCRUZ/ASTRAZENECA,1211,1132,79
Sapucaí-Mirim,316540,MG,Sudeste,PFIZER/BIONTECH,64,64,0
Sapucaia,150775,PA,Norte,FIOCRUZ/ASTRAZENECA,953,816,137
Sapucaia,150775,PA,Norte,BUTANTAN/SINOVAC,806,442,364
Sapucaia,330540,RJ,Sudeste,BUTANTAN/SINOVAC,4340,2281,2059
Sapucaia,330540,RJ,Sudeste,FIOCRUZ/ASTRAZENECA,3979,3646,333
Sapucaia Do Sul,432000,RS,Sul,FIOCRUZ/ASTRAZENECA,33115,31428,1687
Sapucaia Do Sul,432000,RS,Sul,BUTANTAN/SINOVAC,32506,16575,15931
Sapucaia Do Sul,432000,RS,Sul,PFIZER/BIONTECH,1217,1217,0
Saquarema,330550,RJ,Sudeste,BUTANTAN/SINOVAC,20162,10768,9394
Saquarema,330550,RJ,Sudeste,FIOCRUZ/ASTRAZENECA,17074,15977,1097
Sarandi,412625,PR,Sul,FIOCRUZ/ASTRAZENECA,20185,19279,906
Sarandi,412625,PR,Sul,BUTANTAN/SINOVAC,14740,7741,6999
Sarandi,412625,PR,Sul,PFIZER/BIONTECH,1058,1058,0
Sarandi,432010,RS,Sul,BUTANTAN/SINOVAC,5599,2914,2685
Sarandi,432010,RS,Sul,FIOCRUZ/ASTRAZENECA,5255,4836,419
Sarandi,432010,RS,Sul,PFIZER/BIONTECH,220,220,0
Sarapuí,355110,SP,Sudeste,FIOCRUZ/ASTRAZENECA,2219,2084,135
Sarapuí,355110,SP,Sudeste,BUTANTAN/SINOVAC,2065,1142,923
Sarapuí,355110,SP,Sudeste,PFIZER/BIONTECH,123,123,0
Sardoá,316550,MG,Sudeste,BUTANTAN/SINOVAC,1222,626,596
Sardoá,316550,MG,Sudeste,FIOCRUZ/ASTRAZENECA,988,838,150
Sardoá,316550,MG,Sudeste,PFIZER/BIONTECH,108,107,1
Sarutaiá,355120,SP,Sudeste,BUTANTAN/SINOVAC,996,511,485
Sarutaiá,355120,SP,Sudeste,FIOCRUZ/ASTRAZENECA,910,821,89
Sarutaiá,355120,SP,Sudeste,PFIZER/BIONTECH,121,121,0
Sarzedo,316553,MG,Sudeste,BUTANTAN/SINOVAC,4798,2600,2198
Sarzedo,316553,MG,Sudeste,FIOCRUZ/ASTRAZENECA,4010,3567,443
Sarzedo,316553,MG,Sudeste,PFIZER/BIONTECH,5,5,0
Sátiro Dias,292970,BA,Nordeste,FIOCRUZ/ASTRAZENECA,3230,3087,143
Sátiro Dias,292970,BA,Nordeste,BUTANTAN/SINOVAC,2526,1659,867
Sátiro Dias,292970,BA,Nordeste,PFIZER/BIONTECH,155,155,0
Satuba,270890,AL,Nordeste,FIOCRUZ/ASTRAZENECA,2370,2159,211
Satuba,270890,AL,Nordeste,BUTANTAN/SINOVAC,1875,987,888
Satubinha,211172,MA,Nordeste,FIOCRUZ/ASTRAZENECA,1656,1466,190
Satubinha,211172,MA,Nordeste,BUTANTAN/SINOVAC,1381,785,596
Saubara,292975,BA,Nordeste,BUTANTAN/SINOVAC,2340,1297,1043
Saubara,292975,BA,Nordeste,FIOCRUZ/ASTRAZENECA,2248,2177,71
Saubara,292975,BA,Nordeste,PFIZER/BIONTECH,580,580,0
Saudade Do Iguaçu,412627,PR,Sul,FIOCRUZ/ASTRAZENECA,1488,1404,84
Saudade Do Iguaçu,412627,PR,Sul,BUTANTAN/SINOVAC,1368,721,647
Saudade Do Iguaçu,412627,PR,Sul,PFIZER/BIONTECH,22,22,0
Saudades,421730,SC,Sul,FIOCRUZ/ASTRAZENECA,2318,2065,253
Saudades,421730,SC,Sul,BUTANTAN/SINOVAC,2027,1063,964
Saudades,421730,SC,Sul,PFIZER/BIONTECH,226,226,0
Saúde,292980,BA,Nordeste,BUTANTAN/SINOVAC,2236,1236,1000
Saúde,292980,BA,Nordeste,FIOCRUZ/ASTRAZENECA,2109,2016,93
Saúde,292980,BA,Nordeste,PFIZER/BIONTECH,46,46,0
Schroeder,421740,SC,Sul,FIOCRUZ/ASTRAZENECA,3328,3137,191
Schroeder,421740,SC,Sul,BUTANTAN/SINOVAC,2512,1377,1135
Schroeder,421740,SC,Sul,PFIZER/BIONTECH,378,378,0
Seabra,292990,BA,Nordeste,FIOCRUZ/ASTRAZENECA,9136,7881,1255
Seabra,292990,BA,Nordeste,BUTANTAN/SINOVAC,9041,4801,4240
Seabra,292990,BA,Nordeste,PFIZER/BIONTECH,626,626,0
Seara,421750,SC,Sul,FIOCRUZ/ASTRAZENECA,3619,3402,217
Seara,421750,SC,Sul,BUTANTAN/SINOVAC,3550,1872,1678
Seara,421750,SC,Sul,PFIZER/BIONTECH,453,453,0
Sebastianópolis Do Sul,355130,SP,Sudeste,BUTANTAN/SINOVAC,983,557,426
Sebastianópolis Do Sul,355130,SP,Sudeste,FIOCRUZ/ASTRAZENECA,910,808,102
Sebastianópolis Do Sul,355130,SP,Sudeste,PFIZER/BIONTECH,88,87,1
Sebastião Barros,221062,PI,Nordeste,BUTANTAN/SINOVAC,752,391,361
Sebastião Barros,221062,PI,Nordeste,FIOCRUZ/ASTRAZENECA,345,314,31
Sebastião Laranjeiras,293000,BA,Nordeste,BUTANTAN/SINOVAC,2210,1113,1097
Sebastião Laranjeiras,293000,BA,Nordeste,FIOCRUZ/ASTRAZENECA,2127,1952,175
Sebastião Laranjeiras,293000,BA,Nordeste,PFIZER/BIONTECH,208,208,0
Sebastião Leal,221063,PI,Nordeste,FIOCRUZ/ASTRAZENECA,853,772,81
Sebastião Leal,221063,PI,Nordeste,BUTANTAN/SINOVAC,751,420,331
Sebastião Leal,221063,PI,Nordeste,PFIZER/BIONTECH,101,101,0
Seberi,432020,RS,Sul,BUTANTAN/SINOVAC,3271,1715,1556
Seberi,432020,RS,Sul,FIOCRUZ/ASTRAZENECA,1883,1789,94
Seberi,432020,RS,Sul,PFIZER/BIONTECH,139,136,3
Sede Nova,432023,RS,Sul,FIOCRUZ/ASTRAZENECA,827,734,93
Sede Nova,432023,RS,Sul,BUTANTAN/SINOVAC,756,385,371
Sede Nova,432023,RS,Sul,PFIZER/BIONTECH,119,119,0
Segredo,432026,RS,Sul,FIOCRUZ/ASTRAZENECA,1794,1675,119
Segredo,432026,RS,Sul,BUTANTAN/SINOVAC,1599,803,796
Segredo,432026,RS,Sul,PFIZER/BIONTECH,273,273,0
Selbach,432030,RS,Sul,BUTANTAN/SINOVAC,1813,921,892
Selbach,432030,RS,Sul,FIOCRUZ/ASTRAZENECA,1561,1381,180
Selbach,432030,RS,Sul,PFIZER/BIONTECH,210,210,0
Selvíria,500780,MS,Centro-Oeste,BUTANTAN/SINOVAC,1938,1033,905
Selvíria,500780,MS,Centro-Oeste,FIOCRUZ/ASTRAZENECA,1683,1501,182
Selvíria,500780,MS,Centro-Oeste,PFIZER/BIONTECH,247,247,0
Sem-Peixe,316556,MG,Sudeste,BUTANTAN/SINOVAC,1136,594,542
Sem-Peixe,316556,MG,Sudeste,FIOCRUZ/ASTRAZENECA,1004,903,101
Sem-Peixe,316556,MG,Sudeste,PFIZER/BIONTECH,59,58,1
Sena Madureira,120050,AC,Norte,FIOCRUZ/ASTRAZENECA,9453,8299,1154
Sena Madureira,120050,AC,Norte,BUTANTAN/SINOVAC,3737,2007,1730
Sena Madureira,120050,AC,Norte,PFIZER/BIONTECH,597,597,0
Senador Alexandre Costa,211174,MA,Nordeste,FIOCRUZ/ASTRAZENECA,2187,2021,166
Senador Alexandre Costa,211174,MA,Nordeste,BUTANTAN/SINOVAC,1661,830,831
Senador Amaral,316557,MG,Sudeste,FIOCRUZ/ASTRAZENECA,1105,1037,68
Senador Amaral,316557,MG,Sudeste,BUTANTAN/SINOVAC,889,454,435
Senador Amaral,316557,MG,Sudeste,PFIZER/BIONTECH,46,46,0
Senador Canedo,522045,GO,Centro-Oeste,FIOCRUZ/ASTRAZENECA,18278,16824,1454
Senador Canedo,522045,GO,Centro-Oeste,BUTANTAN/SINOVAC,14303,7375,6928
Senador Canedo,522045,GO,Centro-Oeste,PFIZER/BIONTECH,1587,1586,1
Senador Cortes,316560,MG,Sudeste,FIOCRUZ/ASTRAZENECA,538,499,39
Senador Cortes,316560,MG,Sudeste,BUTANTAN/SINOVAC,494,252,242
Senador Cortes,316560,MG,Sudeste,PFIZER/BIONTECH,66,66,0
Senador Elói De Souza,241310,RN,Nordeste,BUTANTAN/SINOVAC,540,307,233
Senador Elói De Souza,241310,RN,Nordeste,FIOCRUZ/ASTRAZENECA,361,344,17
Senador Elói De Souza,241310,RN,Nordeste,PFIZER/BIONTECH,23,23,0
Senador Firmino,316570,MG,Sudeste,FIOCRUZ/ASTRAZENECA,2341,2136,205
Senador Firmino,316570,MG,Sudeste,BUTANTAN/SINOVAC,2134,1103,1031
Senador Firmino,316570,MG,Sudeste,PFIZER/BIONTECH,104,104,0
Senador Georgino Avelino,241320,RN,Nordeste,BUTANTAN/SINOVAC,699,356,343
Senador Georgino Avelino,241320,RN,Nordeste,FIOCRUZ/ASTRAZENECA,693,656,37
Senador Georgino Avelino,241320,RN,Nordeste,PFIZER/BIONTECH,160,160,0
Senador Guiomard,120045,AC,Norte,FIOCRUZ/ASTRAZENECA,4756,4380,376
Senador Guiomard,120045,AC,Norte,BUTANTAN/SINOVAC,2335,1262,1073
Senador José Bento,316580,MG,Sudeste,BUTANTAN/SINOVAC,584,304,280
Senador José Bento,316580,MG,Sudeste,FIOCRUZ/ASTRAZENECA,493,456,37
Senador José Bento,316580,MG,Sudeste,PFIZER/BIONTECH,33,33,0
Senador José Porfírio,150780,PA,Norte,FIOCRUZ/ASTRAZENECA,5214,5010,204
Senador José Porfírio,150780,PA,Norte,BUTANTAN/SINOVAC,1191,642,549
Senador La Rocque,211176,MA,Nordeste,FIOCRUZ/ASTRAZENECA,3131,2942,189
Senador La Rocque,211176,MA,Nordeste,BUTANTAN/SINOVAC,2374,1281,1093
Senador Modestino Gonçalves,316590,MG,Sudeste,BUTANTAN/SINOVAC,1070,544,526
Senador Modestino Gonçalves,316590,MG,Sudeste,FIOCRUZ/ASTRAZENECA,1017,941,76
Senador Modestino Gonçalves,316590,MG,Sudeste,PFIZER/BIONTECH,48,48,0
Senador Pompeu,231270,CE,Nordeste,BUTANTAN/SINOVAC,6395,3526,2869
Senador Pompeu,231270,CE,Nordeste,FIOCRUZ/ASTRAZENECA,3527,2935,592
Senador Rui Palmeira,270895,AL,Nordeste,FIOCRUZ/ASTRAZENECA,2317,2138,179
Senador Rui Palmeira,270895,AL,Nordeste,BUTANTAN/SINOVAC,1624,840,784
Senador Sá,231280,CE,Nordeste,BUTANTAN/SINOVAC,1208,628,580
Senador Sá,231280,CE,Nordeste,FIOCRUZ/ASTRAZENECA,499,382,117
Senador Salgado Filho,432032,RS,Sul,FIOCRUZ/ASTRAZENECA,851,751,100
Senador Salgado Filho,432032,RS,Sul,BUTANTAN/SINOVAC,789,402,387
Senador Salgado Filho,432032,RS,Sul,PFIZER/BIONTECH,123,123,0
Sengés,412630,PR,Sul,FIOCRUZ/ASTRAZENECA,3748,3568,180
Sengés,412630,PR,Sul,BUTANTAN/SINOVAC,2558,1339,1219
Sengés,412630,PR,Sul,PFIZER/BIONTECH,211,211,0
Senhor Do Bonfim,293010,BA,Nordeste,FIOCRUZ/ASTRAZENECA,34619,31684,2935
Senhor Do Bonfim,293010,BA,Nordeste,BUTANTAN/SINOVAC,13727,7069,6658
Senhor Do Bonfim,293010,BA,Nordeste,PFIZER/BIONTECH,190,189,1
Senhora De Oliveira,316600,MG,Sudeste,BUTANTAN/SINOVAC,1324,660,664
Senhora De Oliveira,316600,MG,Sudeste,FIOCRUZ/ASTRAZENECA,1068,912,156
Senhora De Oliveira,316600,MG,Sudeste,PFIZER/BIONTECH,21,21,0
Senhora Do Porto,316610,MG,Sudeste,BUTANTAN/SINOVAC,749,442,307
Senhora Do Porto,316610,MG,Sudeste,FIOCRUZ/ASTRAZENECA,336,273,63
Senhora Do Porto,316610,MG,Sudeste,PFIZER/BIONTECH,2,2,0
Senhora Dos Remédios,316620,MG,Sudeste,BUTANTAN/SINOVAC,2060,1109,951
Senhora Dos Remédios,316620,MG,Sudeste,FIOCRUZ/ASTRAZENECA,1971,1623,348
Senhora Dos Remédios,316620,MG,Sudeste,PFIZER/BIONTECH,141,141,0
Sentinela Do Sul,432035,RS,Sul,BUTANTAN/SINOVAC,1701,863,838
Sentinela Do Sul,432035,RS,Sul,FIOCRUZ/ASTRAZENECA,1565,1438,127
Sentinela Do Sul,432035,RS,Sul,PFIZER/BIONTECH,99,99,0
Sento Sé,293020,BA,Nordeste,FIOCRUZ/ASTRAZENECA,7542,6773,769
Sento Sé,293020,BA,Nordeste,BUTANTAN/SINOVAC,5466,2900,2566
Sento Sé,293020,BA,Nordeste,PFIZER/BIONTECH,159,159,0
Serafina Corrêa,432040,RS,Sul,FIOCRUZ/ASTRAZENECA,4723,4208,515
Serafina Corrêa,432040,RS,Sul,BUTANTAN/SINOVAC,3594,1807,1787
Serafina Corrêa,432040,RS,Sul,PFIZER/BIONTECH,569,568,1
Sericita,316630,MG,Sudeste,FIOCRUZ/ASTRAZENECA,1418,1329,89
Sericita,316630,MG,Sudeste,BUTANTAN/SINOVAC,1404,708,696
Sericita,316630,MG,Sudeste,PFIZER/BIONTECH,60,60,0
Seridó,251540,PB,Nordeste,BUTANTAN/SINOVAC,1842,956,886
Seridó,251540,PB,Nordeste,FIOCRUZ/ASTRAZENECA,1399,1270,129
Seridó,251540,PB,Nordeste,PFIZER/BIONTECH,130,130,0
Seringueiras,110150,RO,Norte,BUTANTAN/SINOVAC,1676,925,751
Seringueiras,110150,RO,Norte,FIOCRUZ/ASTRAZENECA,1348,1293,55
Seringueiras,110150,RO,Norte,PFIZER/BIONTECH,32,32,0
Sério,432045,RS,Sul,BUTANTAN/SINOVAC,665,334,331
Sério,432045,RS,Sul,FIOCRUZ/ASTRAZENECA,609,543,66
Sério,432045,RS,Sul,PFIZER/BIONTECH,88,88,0
Seritinga,316640,MG,Sudeste,BUTANTAN/SINOVAC,580,294,286
Seritinga,316640,MG,Sudeste,FIOCRUZ/ASTRAZENECA,485,438,47
Seritinga,316640,MG,Sudeste,PFIZER/BIONTECH,55,55,0
Seropédica,330555,RJ,Sudeste,BUTANTAN/SINOVAC,17311,9470,7841
Seropédica,330555,RJ,Sudeste,FIOCRUZ/ASTRAZENECA,8535,7247,1288
Seropédica,330555,RJ,Sudeste,PFIZER/BIONTECH,1471,1446,25
Serra,320500,ES,Sudeste,FIOCRUZ/ASTRAZENECA,102602,94589,8013
Serra,320500,ES,Sudeste,BUTANTAN/SINOVAC,95986,47971,48015
Serra,320500,ES,Sudeste,PFIZER/BIONTECH,8695,8685,10
Serra Alta,421755,SC,Sul,FIOCRUZ/ASTRAZENECA,1067,959,108
Serra Alta,421755,SC,Sul,BUTANTAN/SINOVAC,841,449,392
Serra Azul,355140,SP,Sudeste,FIOCRUZ/ASTRAZENECA,2899,2728,171
Serra Azul,355140,SP,Sudeste,BUTANTAN/SINOVAC,2762,1463,1299
Serra Azul,355140,SP,Sudeste,PFIZER/BIONTECH,212,212,0
Serra Azul De Minas,316650,MG,Sudeste,BUTANTAN/SINOVAC,78,52,26
Serra Azul De Minas,316650,MG,Sudeste,FIOCRUZ/ASTRAZENECA,45,45,0
Serra Branca,251550,PB,Nordeste,BUTANTAN/SINOVAC,3398,1912,1486
Serra Branca,251550,PB,Nordeste,FIOCRUZ/ASTRAZENECA,3262,3037,225
Serra Branca,251550,PB,Nordeste,PFIZER/BIONTECH,35,35,0
Serra Caiada,241030,RN,Nordeste,FIOCRUZ/ASTRAZENECA,1640,1550,90
Serra Caiada,241030,RN,Nordeste,BUTANTAN/SINOVAC,1388,690,698
Serra Caiada,241030,RN,Nordeste,PFIZER/BIONTECH,169,169,0
Serra Da Raiz,251560,PB,Nordeste,BUTANTAN/SINOVAC,917,471,446
Serra Da Raiz,251560,PB,Nordeste,FIOCRUZ/ASTRAZENECA,727,654,73
Serra Da Raiz,251560,PB,Nordeste,PFIZER/BIONTECH,18,18,0
Serra Da Saudade,316660,MG,Sudeste,BUTANTAN/SINOVAC,318,164,154
Serra Da Saudade,316660,MG,Sudeste,FIOCRUZ/ASTRAZENECA,264,218,46
Serra Da Saudade,316660,MG,Sudeste,PFIZER/BIONTECH,23,23,0
Serra De São Bento,241330,RN,Nordeste,BUTANTAN/SINOVAC,1656,985,671
Serra De São Bento,241330,RN,Nordeste,FIOCRUZ/ASTRAZENECA,883,822,61
Serra De São Bento,241330,RN,Nordeste,PFIZER/BIONTECH,120,120,0
Serra Do Mel,241335,RN,Nordeste,FIOCRUZ/ASTRAZENECA,1899,1809,90
Serra Do Mel,241335,RN,Nordeste,BUTANTAN/SINOVAC,1758,883,875
Serra Do Mel,241335,RN,Nordeste,PFIZER/BIONTECH,317,316,1
Serra Do Navio,160005,AP,Norte,FIOCRUZ/ASTRAZENECA,774,764,10
Serra Do Navio,160005,AP,Norte,BUTANTAN/SINOVAC,741,376,365
Serra Do Ramalho,293015,BA,Nordeste,BUTANTAN/SINOVAC,4672,2999,1673
Serra Do Ramalho,293015,BA,Nordeste,FIOCRUZ/ASTRAZENECA,2603,2520,83
Serra Do Ramalho,293015,BA,Nordeste,PFIZER/BIONTECH,324,324,0
Serra Do Salitre,316680,MG,Sudeste,FIOCRUZ/ASTRAZENECA,4261,3333,928
Serra Do Salitre,316680,MG,Sudeste,BUTANTAN/SINOVAC,1925,975,950
Serra Do Salitre,316680,MG,Sudeste,PFIZER/BIONTECH,184,184,0
Serra Dos Aimorés,316670,MG,Sudeste,BUTANTAN/SINOVAC,1909,985,924
Serra Dos Aimorés,316670,MG,Sudeste,FIOCRUZ/ASTRAZENECA,1394,1254,140
Serra Dos Aimorés,316670,MG,Sudeste,PFIZER/BIONTECH,251,251,0
Serra Dourada,293030,BA,Nordeste,BUTANTAN/SINOVAC,3822,2051,1771
Serra Dourada,293030,BA,Nordeste,FIOCRUZ/ASTRAZENECA,3520,3297,223
Serra Dourada,293030,BA,Nordeste,PFIZER/BIONTECH,197,197,0
Serra Grande,251570,PB,Nordeste,BUTANTAN/SINOVAC,726,368,358
Serra Grande,251570,PB,Nordeste,FIOCRUZ/ASTRAZENECA,446,397,49
Serra Grande,251570,PB,Nordeste,PFIZER/BIONTECH,17,17,0
Serra Negra,355160,SP,Sudeste,BUTANTAN/SINOVAC,8126,4367,3759
Serra Negra,355160,SP,Sudeste,FIOCRUZ/ASTRAZENECA,7475,6736,739
Serra Negra,355160,SP,Sudeste,PFIZER/BIONTECH,711,711,0
Serra Negra Do Norte,241340,RN,Nordeste,FIOCRUZ/ASTRAZENECA,1832,1740,92
Serra Negra Do Norte,241340,RN,Nordeste,BUTANTAN/SINOVAC,1485,752,733
Serra Negra Do Norte,241340,RN,Nordeste,PFIZER/BIONTECH,128,128,0
Serra Nova Dourada,510788,MT,Centro-Oeste,FIOCRUZ/ASTRAZENECA,409,367,42
Serra Nova Dourada,510788,MT,Centro-Oeste,BUTANTAN/SINOVAC,369,201,168
Serra Nova Dourada,510788,MT,Centro-Oeste,PFIZER/BIONTECH,36,36,0
Serra Preta,293040,BA,Nordeste,BUTANTAN/SINOVAC,4138,2157,1981
Serra Preta,293040,BA,Nordeste,FIOCRUZ/ASTRAZENECA,3238,2690,548
Serra Preta,293040,BA,Nordeste,PFIZER/BIONTECH,584,584,0
Serra Redonda,251580,PB,Nordeste,FIOCRUZ/ASTRAZENECA,2043,1868,175
Serra Redonda,251580,PB,Nordeste,BUTANTAN/SINOVAC,1878,956,922
Serra Redonda,251580,PB,Nordeste,PFIZER/BIONTECH,125,125,0
Serra Talhada,261390,PE,Nordeste,FIOCRUZ/ASTRAZENECA,19262,17838,1424
Serra Talhada,261390,PE,Nordeste,BUTANTAN/SINOVAC,17723,9220,8503
Serra Talhada,261390,PE,Nordeste,PFIZER/BIONTECH,2774,2774,0
Serrana,355150,SP,Sudeste,BUTANTAN/SINOVAC,6387,3945,2442
Serrana,355150,SP,Sudeste,FIOCRUZ/ASTRAZENECA,664,403,261
Serrana,355150,SP,Sudeste,PFIZER/BIONTECH,54,54,0
Serrania,316690,MG,Sudeste,FIOCRUZ/ASTRAZENECA,1878,1669,209
Serrania,316690,MG,Sudeste,BUTANTAN/SINOVAC,1712,884,828
Serrania,316690,MG,Sudeste,PFIZER/BIONTECH,105,105,0
Serrano Do Maranhão,211178,MA,Nordeste,FIOCRUZ/ASTRAZENECA,4700,4566,134
Serrano Do Maranhão,211178,MA,Nordeste,BUTANTAN/SINOVAC,1334,682,652
Serranópolis,522050,GO,Centro-Oeste,FIOCRUZ/ASTRAZENECA,1718,1603,115
Serranópolis,522050,GO,Centro-Oeste,BUTANTAN/SINOVAC,1287,658,629
Serranópolis De Minas,316695,MG,Sudeste,FIOCRUZ/ASTRAZENECA,1129,1049,80
Serranópolis De Minas,316695,MG,Sudeste,BUTANTAN/SINOVAC,981,497,484
Serranópolis Do Iguaçu,412635,PR,Sul,BUTANTAN/SINOVAC,1334,702,632
Serranópolis Do Iguaçu,412635,PR,Sul,FIOCRUZ/ASTRAZENECA,1240,1156,84
Serranópolis Do Iguaçu,412635,PR,Sul,PFIZER/BIONTECH,23,23,0
Serranos,316700,MG,Sudeste,BUTANTAN/SINOVAC,558,281,277
Serranos,316700,MG,Sudeste,FIOCRUZ/ASTRAZENECA,437,398,39
Serranos,316700,MG,Sudeste,PFIZER/BIONTECH,71,71,0
Serraria,251590,PB,Nordeste,BUTANTAN/SINOVAC,1345,679,666
Serraria,251590,PB,Nordeste,FIOCRUZ/ASTRAZENECA,950,852,98
Serraria,251590,PB,Nordeste,PFIZER/BIONTECH,123,123,0
Serrinha,241350,RN,Nordeste,BUTANTAN/SINOVAC,685,371,314
Serrinha,241350,RN,Nordeste,FIOCRUZ/ASTRAZENECA,319,283,36
Serrinha,241350,RN,Nordeste,PFIZER/BIONTECH,19,19,0
Serrinha,293050,BA,Nordeste,FIOCRUZ/ASTRAZENECA,15012,13682,1330
Serrinha,293050,BA,Nordeste,BUTANTAN/SINOVAC,13254,6687,6567
Serrinha,293050,BA,Nordeste,PFIZER/BIONTECH,1205,1203,2
Serrinha Dos Pintos,241355,RN,Nordeste,BUTANTAN/SINOVAC,1744,1008,736
Serrinha Dos Pintos,241355,RN,Nordeste,FIOCRUZ/ASTRAZENECA,1627,1576,51
Serrinha Dos Pintos,241355,RN,Nordeste,PFIZER/BIONTECH,153,153,0
Serrita,261400,PE,Nordeste,FIOCRUZ/ASTRAZENECA,3527,3158,369
Serrita,261400,PE,Nordeste,BUTANTAN/SINOVAC,3250,1713,1537
Serrita,261400,PE,Nordeste,PFIZER/BIONTECH,528,528,0
Serro,316710,MG,Sudeste,FIOCRUZ/ASTRAZENECA,5814,4919,895
Serro,316710,MG,Sudeste,BUTANTAN/SINOVAC,4133,2132,2001
Serro,316710,MG,Sudeste,PFIZER/BIONTECH,151,151,0
Serrolândia,293060,BA,Nordeste,BUTANTAN/SINOVAC,2791,1543,1248
Serrolândia,293060,BA,Nordeste,FIOCRUZ/ASTRAZENECA,2734,2351,383
Serrolândia,293060,BA,Nordeste,PFIZER/BIONTECH,311,309,2
Sertaneja,412640,PR,Sul,FIOCRUZ/ASTRAZENECA,2212,2096,116
Sertaneja,412640,PR,Sul,BUTANTAN/SINOVAC,1609,825,784
Sertaneja,412640,PR,Sul,PFIZER/BIONTECH,23,23,0
Sertânia,261410,PE,Nordeste,FIOCRUZ/ASTRAZENECA,7101,6442,659
Sertânia,261410,PE,Nordeste,BUTANTAN/SINOVAC,5046,2597,2449
Sertânia,261410,PE,Nordeste,PFIZER/BIONTECH,887,887,0
Sertanópolis,412650,PR,Sul,FIOCRUZ/ASTRAZENECA,4403,4072,331
Sertanópolis,412650,PR,Sul,BUTANTAN/SINOVAC,3795,1923,1872
Sertanópolis,412650,PR,Sul,PFIZER/BIONTECH,192,192,0
Sertão,432050,RS,Sul,FIOCRUZ/ASTRAZENECA,2203,1846,357
Sertão,432050,RS,Sul,BUTANTAN/SINOVAC,1796,906,890
Sertão,432050,RS,Sul,PFIZER/BIONTECH,218,218,0
Sertão Santana,432055,RS,Sul,BUTANTAN/SINOVAC,2080,1060,1020
Sertão Santana,432055,RS,Sul,FIOCRUZ/ASTRAZENECA,1710,1589,121
Sertão Santana,432055,RS,Sul,PFIZER/BIONTECH,228,228,0
Sertãozinho,251593,PB,Nordeste,BUTANTAN/SINOVAC,1489,758,731
Sertãozinho,251593,PB,Nordeste,FIOCRUZ/ASTRAZENECA,832,736,96
Sertãozinho,251593,PB,Nordeste,PFIZER/BIONTECH,24,24,0
Sertãozinho,355170,SP,Sudeste,FIOCRUZ/ASTRAZENECA,24944,23253,1691
Sertãozinho,355170,SP,Sudeste,BUTANTAN/SINOVAC,20881,11425,9456
Sertãozinho,355170,SP,Sudeste,PFIZER/BIONTECH,1223,1221,2
Sete Barras,355180,SP,Sudeste,BUTANTAN/SINOVAC,4321,2300,2021
Sete Barras,355180,SP,Sudeste,FIOCRUZ/ASTRAZENECA,4154,3856,298
Sete Barras,355180,SP,Sudeste,PFIZER/BIONTECH,399,394,5
Sete De Setembro,432057,RS,Sul,BUTANTAN/SINOVAC,728,363,365
Sete De Setembro,432057,RS,Sul,FIOCRUZ/ASTRAZENECA,550,471,79
Sete De Setembro,432057,RS,Sul,PFIZER/BIONTECH,96,96,0
Sete Lagoas,316720,MG,Sudeste,BUTANTAN/SINOVAC,41450,23815,17635
Sete Lagoas,316720,MG,Sudeste,FIOCRUZ/ASTRAZENECA,25511,23743,1768
Sete Lagoas,316720,MG,Sudeste,PFIZER/BIONTECH,1,1,0
Sete Quedas,500770,MS,Centro-Oeste,FIOCRUZ/ASTRAZENECA,3368,2854,514
Sete Quedas,500770,MS,Centro-Oeste,BUTANTAN/SINOVAC,2488,1342,1146
Sete Quedas,500770,MS,Centro-Oeste,PFIZER/BIONTECH,391,390,1
Setubinha,316555,MG,Sudeste,BUTANTAN/SINOVAC,2074,1042,1032
Setubinha,316555,MG,Sudeste,FIOCRUZ/ASTRAZENECA,1004,887,117
Setubinha,316555,MG,Sudeste,PFIZER/BIONTECH,56,56,0
Severiano De Almeida,432060,RS,Sul,BUTANTAN/SINOVAC,1541,780,761
Severiano De Almeida,432060,RS,Sul,FIOCRUZ/ASTRAZENECA,1335,1182,153
Severiano De Almeida,432060,RS,Sul,PFIZER/BIONTECH,164,164,0
Severiano Melo,241360,RN,Nordeste,FIOCRUZ/ASTRAZENECA,1525,1507,18
Severiano Melo,241360,RN,Nordeste,BUTANTAN/SINOVAC,437,226,211
Severiano Melo,241360,RN,Nordeste,PFIZER/BIONTECH,72,72,0
Severínia,355190,SP,Sudeste,FIOCRUZ/ASTRAZENECA,5886,5488,398
Severínia,355190,SP,Sudeste,BUTANTAN/SINOVAC,5481,3156,2325
Severínia,355190,SP,Sudeste,PFIZER/BIONTECH,203,202,1
Siderópolis,421760,SC,Sul,BUTANTAN/SINOVAC,2920,1581,1339
Siderópolis,421760,SC,Sul,FIOCRUZ/ASTRAZENECA,2889,2624,265
Siderópolis,421760,SC,Sul,PFIZER/BIONTECH,251,251,0
Sidrolândia,500790,MS,Centro-Oeste,BUTANTAN/SINOVAC,10647,5649,4998
Sidrolândia,500790,MS,Centro-Oeste,FIOCRUZ/ASTRAZENECA,6531,5925,606
Sidrolândia,500790,MS,Centro-Oeste,PFIZER/BIONTECH,610,610,0
Sigefredo Pacheco,221065,PI,Nordeste,BUTANTAN/SINOVAC,1770,917,853
Sigefredo Pacheco,221065,PI,Nordeste,FIOCRUZ/ASTRAZENECA,1459,1355,104
Silva Jardim,330560,RJ,Sudeste,BUTANTAN/SINOVAC,5090,2672,2418
Silva Jardim,330560,RJ,Sudeste,FIOCRUZ/ASTRAZENECA,3982,3522,460
Silva Jardim,330560,RJ,Sudeste,PFIZER/BIONTECH,429,429,0
Silvânia,522060,GO,Centro-Oeste,BUTANTAN/SINOVAC,5026,2679,2347
Silvânia,522060,GO,Centro-Oeste,FIOCRUZ/ASTRAZENECA,4935,4582,353
Silvanópolis,172065,TO,Norte,BUTANTAN/SINOVAC,1318,676,642
Silvanópolis,172065,TO,Norte,FIOCRUZ/ASTRAZENECA,914,840,74
Silveira Martins,432065,RS,Sul,BUTANTAN/SINOVAC,943,473,470
Silveira Martins,432065,RS,Sul,FIOCRUZ/ASTRAZENECA,707,623,84
Silveira Martins,432065,RS,Sul,PFIZER/BIONTECH,102,102,0
Silveirânia,316730,MG,Sudeste,FIOCRUZ/ASTRAZENECA,947,883,64
Silveirânia,316730,MG,Sudeste,BUTANTAN/SINOVAC,583,311,272
Silveirânia,316730,MG,Sudeste,PFIZER/BIONTECH,47,47,0
Silveiras,355200,SP,Sudeste,BUTANTAN/SINOVAC,1569,841,728
Silveiras,355200,SP,Sudeste,FIOCRUZ/ASTRAZENECA,1543,1423,120
Silveiras,355200,SP,Sudeste,PFIZER/BIONTECH,150,150,0
Silves,130400,AM,Norte,FIOCRUZ/ASTRAZENECA,4662,4475,187
Silves,130400,AM,Norte,BUTANTAN/SINOVAC,1825,1056,769
Silvianópolis,316740,MG,Sudeste,BUTANTAN/SINOVAC,1846,940,906
Silvianópolis,316740,MG,Sudeste,FIOCRUZ/ASTRAZENECA,1069,956,113
Silvianópolis,316740,MG,Sudeste,PFIZER/BIONTECH,48,48,0
Simão Dias,280710,SE,Nordeste,BUTANTAN/SINOVAC,7105,4021,3084
Simão Dias,280710,SE,Nordeste,FIOCRUZ/ASTRAZENECA,6407,5918,489
Simão Dias,280710,SE,Nordeste,PFIZER/BIONTECH,39,39,0
Simão Pereira,316750,MG,Sudeste,FIOCRUZ/ASTRAZENECA,837,741,96
Simão Pereira,316750,MG,Sudeste,BUTANTAN/SINOVAC,758,391,367
Simão Pereira,316750,MG,Sudeste,PFIZER/BIONTECH,60,60,0
Simões,221070,PI,Nordeste,FIOCRUZ/ASTRAZENECA,3258,2420,838
Simões,221070,PI,Nordeste,BUTANTAN/SINOVAC,2223,1178,1045
Simões,221070,PI,Nordeste,PFIZER/BIONTECH,126,126,0
Simões Filho,293070,BA,Nordeste,BUTANTAN/SINOVAC,8560,5220,3340
Simões Filho,293070,BA,Nordeste,FIOCRUZ/ASTRAZENECA,6063,5744,319
Simões Filho,293070,BA,Nordeste,PFIZER/BIONTECH,1141,1141,0
Simolândia,522068,GO,Centro-Oeste,FIOCRUZ/ASTRAZENECA,2348,2235,113
Simolândia,522068,GO,Centro-Oeste,BUTANTAN/SINOVAC,584,374,210
Simonésia,316760,MG,Sudeste,FIOCRUZ/ASTRAZENECA,3108,2920,188
Simonésia,316760,MG,Sudeste,BUTANTAN/SINOVAC,2586,1361,1225
Simonésia,316760,MG,Sudeste,PFIZER/BIONTECH,238,238,0
Simplício Mendes,221080,PI,Nordeste,BUTANTAN/SINOVAC,3085,1561,1524
Simplício Mendes,221080,PI,Nordeste,FIOCRUZ/ASTRAZENECA,2621,2503,118
Simplício Mendes,221080,PI,Nordeste,PFIZER/BIONTECH,25,25,0
Sinimbu,432067,RS,Sul,BUTANTAN/SINOVAC,2817,1456,1361
Sinimbu,432067,RS,Sul,FIOCRUZ/ASTRAZENECA,2509,2271,238
Sinimbu,432067,RS,Sul,PFIZER/BIONTECH,337,337,0
Sinop,510790,MT,Centro-Oeste,FIOCRUZ/ASTRAZENECA,21798,19954,1844
Sinop,510790,MT,Centro-Oeste,BUTANTAN/SINOVAC,18891,9688,9203
Sinop,510790,MT,Centro-Oeste,PFIZER/BIONTECH,1682,1681,1
Siqueira Campos,412660,PR,Sul,FIOCRUZ/ASTRAZENECA,5021,4718,303
Siqueira Campos,412660,PR,Sul,BUTANTAN/SINOVAC,3977,2028,1949
Siqueira Campos,412660,PR,Sul,PFIZER/BIONTECH,234,234,0
Sirinhaém,261420,PE,Nordeste,BUTANTAN/SINOVAC,5854,3055,2799
Sirinhaém,261420,PE,Nordeste,FIOCRUZ/ASTRAZENECA,5484,4986,498
Sirinhaém,261420,PE,Nordeste,PFIZER/BIONTECH,673,671,2
Siriri,280720,SE,Nordeste,BUTANTAN/SINOVAC,1892,974,918
Siriri,280720,SE,Nordeste,FIOCRUZ/ASTRAZENECA,1416,1416,0
Siriri,280720,SE,Nordeste,PFIZER/BIONTECH,178,178,0
Sítio D'Abadia,522070,GO,Centro-Oeste,FIOCRUZ/ASTRAZENECA,942,757,185
Sítio D'Abadia,522070,GO,Centro-Oeste,BUTANTAN/SINOVAC,246,147,99
Sítio Do Mato,293075,BA,Nordeste,FIOCRUZ/ASTRAZENECA,2495,2321,174
Sítio Do Mato,293075,BA,Nordeste,BUTANTAN/SINOVAC,1783,933,850
Sítio Do Mato,293075,BA,Nordeste,PFIZER/BIONTECH,205,205,0
Sítio Do Quinto,293076,BA,Nordeste,BUTANTAN/SINOVAC,3014,1780,1234
Sítio Do Quinto,293076,BA,Nordeste,FIOCRUZ/ASTRAZENECA,1811,1702,109
Sítio Do Quinto,293076,BA,Nordeste,PFIZER/BIONTECH,18,18,0
Sítio Novo,211180,MA,Nordeste,FIOCRUZ/ASTRAZENECA,2659,2479,180
Sítio Novo,211180,MA,Nordeste,BUTANTAN/SINOVAC,2154,1126,1028
Sítio Novo,241370,RN,Nordeste,BUTANTAN/SINOVAC,1355,765,590
Sítio Novo,241370,RN,Nordeste,FIOCRUZ/ASTRAZENECA,804,717,87
Sítio Novo,241370,RN,Nordeste,PFIZER/BIONTECH,140,140,0
Sítio Novo Do Tocantins,172080,TO,Norte,FIOCRUZ/ASTRAZENECA,2020,1938,82
Sítio Novo Do Tocantins,172080,TO,Norte,BUTANTAN/SINOVAC,1822,961,861
Sobradinho,293077,BA,Nordeste,FIOCRUZ/ASTRAZENECA,5048,4488,560
Sobradinho,293077,BA,Nordeste,BUTANTAN/SINOVAC,4982,2598,2384
Sobradinho,293077,BA,Nordeste,PFIZER/BIONTECH,134,134,0
Sobradinho,432070,RS,Sul,BUTANTAN/SINOVAC,4042,2035,2007
Sobradinho,432070,RS,Sul,FIOCRUZ/ASTRAZENECA,3885,3441,444
Sobradinho,432070,RS,Sul,PFIZER/BIONTECH,527,523,4
Sobrado,251597,PB,Nordeste,BUTANTAN/SINOVAC,1678,848,830
Sobrado,251597,PB,Nordeste,FIOCRUZ/ASTRAZENECA,1004,909,95
Sobrado,251597,PB,Nordeste,PFIZER/BIONTECH,39,39,0
Sobral,231290,CE,Nordeste,FIOCRUZ/ASTRAZENECA,51685,49489,2196
Sobral,231290,CE,Nordeste,BUTANTAN/SINOVAC,43633,22540,21093
Sobral,231290,CE,Nordeste,PFIZER/BIONTECH,6446,6446,0
Sobrália,316770,MG,Sudeste,BUTANTAN/SINOVAC,1540,784,756
Sobrália,316770,MG,Sudeste,FIOCRUZ/ASTRAZENECA,1109,989,120
Sobrália,316770,MG,Sudeste,PFIZER/BIONTECH,176,176,0
Socorro,355210,SP,Sudeste,BUTANTAN/SINOVAC,11399,6435,4964
Socorro,355210,SP,Sudeste,FIOCRUZ/ASTRAZENECA,8096,7311,785
Socorro,355210,SP,Sudeste,PFIZER/BIONTECH,1242,1242,0
Socorro Do Piauí,221090,PI,Nordeste,FIOCRUZ/ASTRAZENECA,1190,1100,90
Socorro Do Piauí,221090,PI,Nordeste,BUTANTAN/SINOVAC,910,459,451
Socorro Do Piauí,221090,PI,Nordeste,PFIZER/BIONTECH,95,95,0
Solânea,251600,PB,Nordeste,BUTANTAN/SINOVAC,7610,4301,3309
Solânea,251600,PB,Nordeste,FIOCRUZ/ASTRAZENECA,2033,1635,398
Solânea,251600,PB,Nordeste,PFIZER/BIONTECH,18,18,0
Soledade,251610,PB,Nordeste,BUTANTAN/SINOVAC,3287,1660,1627
Soledade,251610,PB,Nordeste,FIOCRUZ/ASTRAZENECA,2845,2569,276
Soledade,251610,PB,Nordeste,PFIZER/BIONTECH,382,382,0
Soledade,432080,RS,Sul,FIOCRUZ/ASTRAZENECA,8161,7442,719
Soledade,432080,RS,Sul,BUTANTAN/SINOVAC,7555,3841,3714
Soledade,432080,RS,Sul,PFIZER/BIONTECH,1058,1058,0
Soledade De Minas,316780,MG,Sudeste,BUTANTAN/SINOVAC,991,575,416
Soledade De Minas,316780,MG,Sudeste,FIOCRUZ/ASTRAZENECA,532,502,30
Solidão,261440,PE,Nordeste,FIOCRUZ/ASTRAZENECA,1382,1291,91
Solidão,261440,PE,Nordeste,BUTANTAN/SINOVAC,1215,621,594
Solidão,261440,PE,Nordeste,PFIZER/BIONTECH,239,239,0
Solonópole,231300,CE,Nordeste,BUTANTAN/SINOVAC,3051,1742,1309
Solonópole,231300,CE,Nordeste,FIOCRUZ/ASTRAZENECA,994,875,119
Sombrio,421770,SC,Sul,BUTANTAN/SINOVAC,4289,2366,1923
Sombrio,421770,SC,Sul,FIOCRUZ/ASTRAZENECA,3555,3208,347
Sonora,500793,MS,Centro-Oeste,FIOCRUZ/ASTRAZENECA,3602,3213,389
Sonora,500793,MS,Centro-Oeste,BUTANTAN/SINOVAC,2327,1342,985
Sonora,500793,MS,Centro-Oeste,PFIZER/BIONTECH,628,627,1
Sooretama,320501,ES,Sudeste,BUTANTAN/SINOVAC,4665,2402,2263
Sooretama,320501,ES,Sudeste,FIOCRUZ/ASTRAZENECA,4089,3958,131
Sooretama,320501,ES,Sudeste,PFIZER/BIONTECH,767,765,2
Sorocaba,355220,SP,Sudeste,BUTANTAN/SINOVAC,128414,69629,58785
Sorocaba,355220,SP,Sudeste,FIOCRUZ/ASTRAZENECA,96805,87476,9329
Sorocaba,355220,SP,Sudeste,PFIZER/BIONTECH,2238,2238,0
Sorriso,510792,MT,Centro-Oeste,FIOCRUZ/ASTRAZENECA,14038,13147,891
Sorriso,510792,MT,Centro-Oeste,BUTANTAN/SINOVAC,9661,5122,4539
Sorriso,510792,MT,Centro-Oeste,PFIZER/BIONTECH,1726,1725,1
Sossêgo,251615,PB,Nordeste,BUTANTAN/SINOVAC,790,399,391
Sossêgo,251615,PB,Nordeste,FIOCRUZ/ASTRAZENECA,647,582,65
Sossêgo,251615,PB,Nordeste,PFIZER/BIONTECH,54,54,0
Soure,150790,PA,Norte,FIOCRUZ/ASTRAZENECA,6179,4536,1643
Soure,150790,PA,Norte,BUTANTAN/SINOVAC,2404,1372,1032
Sousa,251620,PB,Nordeste,BUTANTAN/SINOVAC,16987,9043,7944
Sousa,251620,PB,Nordeste,FIOCRUZ/ASTRAZENECA,12392,11508,884
Sousa,251620,PB,Nordeste,PFIZER/BIONTECH,1951,1951,0
Souto Soares,293080,BA,Nordeste,FIOCRUZ/ASTRAZENECA,4901,4102,799
Souto Soares,293080,BA,Nordeste,BUTANTAN/SINOVAC,3783,2017,1766
Souto Soares,293080,BA,Nordeste,PFIZER/BIONTECH,218,216,2
Sucupira,172085,TO,Norte,FIOCRUZ/ASTRAZENECA,382,372,10
Sucupira,172085,TO,Norte,BUTANTAN/SINOVAC,371,201,170
Sucupira Do Norte,211190,MA,Nordeste,FIOCRUZ/ASTRAZENECA,1773,1633,140
Sucupira Do Norte,211190,MA,Nordeste,BUTANTAN/SINOVAC,1688,884,804
Sucupira Do Riachão,211195,MA,Nordeste,FIOCRUZ/ASTRAZENECA,1306,1227,79
Sucupira Do Riachão,211195,MA,Nordeste,BUTANTAN/SINOVAC,1073,578,495
Sud Mennucci,355230,SP,Sudeste,FIOCRUZ/ASTRAZENECA,2182,2011,171
Sud Mennucci,355230,SP,Sudeste,BUTANTAN/SINOVAC,2064,1140,924
Sud Mennucci,355230,SP,Sudeste,PFIZER/BIONTECH,229,229,0
Sul Brasil,421775,SC,Sul,FIOCRUZ/ASTRAZENECA,812,737,75
Sul Brasil,421775,SC,Sul,BUTANTAN/SINOVAC,690,351,339
Sulina,412665,PR,Sul,FIOCRUZ/ASTRAZENECA,1379,1307,72
Sulina,412665,PR,Sul,BUTANTAN/SINOVAC,856,442,414
Sulina,412665,PR,Sul,PFIZER/BIONTECH,17,17,0
Sumaré,355240,SP,Sudeste,FIOCRUZ/ASTRAZENECA,46182,43858,2324
Sumaré,355240,SP,Sudeste,BUTANTAN/SINOVAC,45933,25823,20110
Sumaré,355240,SP,Sudeste,PFIZER/BIONTECH,1493,1492,1
Sumé,251630,PB,Nordeste,BUTANTAN/SINOVAC,4315,2174,2141
Sumé,251630,PB,Nordeste,FIOCRUZ/ASTRAZENECA,3579,3217,362
Sumé,251630,PB,Nordeste,PFIZER/BIONTECH,398,398,0
Sumidouro,330570,RJ,Sudeste,FIOCRUZ/ASTRAZENECA,3850,3509,341
Sumidouro,330570,RJ,Sudeste,BUTANTAN/SINOVAC,3464,1831,1633
Surubim,261450,PE,Nordeste,FIOCRUZ/ASTRAZENECA,13521,12460,1061
Surubim,261450,PE,Nordeste,BUTANTAN/SINOVAC,11640,5930,5710
Surubim,261450,PE,Nordeste,PFIZER/BIONTECH,1618,1616,2
Sussuapara,221093,PI,Nordeste,FIOCRUZ/ASTRAZENECA,1382,1128,254
Sussuapara,221093,PI,Nordeste,BUTANTAN/SINOVAC,1300,664,636
Suzanápolis,355255,SP,Sudeste,BUTANTAN/SINOVAC,1287,763,524
Suzanápolis,355255,SP,Sudeste,FIOCRUZ/ASTRAZENECA,1175,1083,92
Suzanápolis,355255,SP,Sudeste,PFIZER/BIONTECH,97,96,1
Suzano,355250,SP,Sudeste,BUTANTAN/SINOVAC,46045,24798,21247
Suzano,355250,SP,Sudeste,FIOCRUZ/ASTRAZENECA,45365,43292,2073
Suzano,355250,SP,Sudeste,PFIZER/BIONTECH,7483,7465,18
Tabaí,432085,RS,Sul,FIOCRUZ/ASTRAZENECA,1187,1102,85
Tabaí,432085,RS,Sul,BUTANTAN/SINOVAC,1026,558,468
Tabaí,432085,RS,Sul,PFIZER/BIONTECH,60,60,0
Tabaporã,510794,MT,Centro-Oeste,BUTANTAN/SINOVAC,1275,658,617
Tabaporã,510794,MT,Centro-Oeste,FIOCRUZ/ASTRAZENECA,1186,925,261
Tabapuã,355260,SP,Sudeste,FIOCRUZ/ASTRAZENECA,3307,3019,288
Tabapuã,355260,SP,Sudeste,BUTANTAN/SINOVAC,3226,1827,1399
Tabapuã,355260,SP,Sudeste,PFIZER/BIONTECH,265,265,0
Tabatinga,130406,AM,Norte,BUTANTAN/SINOVAC,12713,8499,4214
Tabatinga,130406,AM,Norte,FIOCRUZ/ASTRAZENECA,3070,2774,296
Tabatinga,355270,SP,Sudeste,FIOCRUZ/ASTRAZENECA,3838,3564,274
Tabatinga,355270,SP,Sudeste,BUTANTAN/SINOVAC,3823,2232,1591
Tabatinga,355270,SP,Sudeste,PFIZER/BIONTECH,123,123,0
Tabira,261460,PE,Nordeste,FIOCRUZ/ASTRAZENECA,6344,5762,582
Tabira,261460,PE,Nordeste,BUTANTAN/SINOVAC,5434,2738,2696
Tabira,261460,PE,Nordeste,PFIZER/BIONTECH,932,930,2
Taboão Da Serra,355280,SP,Sudeste,FIOCRUZ/ASTRAZENECA,63590,59714,3876
Taboão Da Serra,355280,SP,Sudeste,BUTANTAN/SINOVAC,54545,30108,24437
Taboão Da Serra,355280,SP,Sudeste,PFIZER/BIONTECH,1891,1890,1
Tabocas Do Brejo Velho,293090,BA,Nordeste,BUTANTAN/SINOVAC,2384,1425,959
Tabocas Do Brejo Velho,293090,BA,Nordeste,FIOCRUZ/ASTRAZENECA,2196,1963,233
Tabocas Do Brejo Velho,293090,BA,Nordeste,PFIZER/BIONTECH,302,302,0
Taboleiro Grande,241380,RN,Nordeste,BUTANTAN/SINOVAC,1276,671,605
Taboleiro Grande,241380,RN,Nordeste,FIOCRUZ/ASTRAZENECA,946,929,17
Taboleiro Grande,241380,RN,Nordeste,PFIZER/BIONTECH,94,93,1
Tabuleiro,316790,MG,Sudeste,FIOCRUZ/ASTRAZENECA,1474,1380,94
Tabuleiro,316790,MG,Sudeste,BUTANTAN/SINOVAC,1125,578,547
Tabuleiro,316790,MG,Sudeste,PFIZER/BIONTECH,113,113,0
Tabuleiro Do Norte,231310,CE,Nordeste,BUTANTAN/SINOVAC,5214,2688,2526
Tabuleiro Do Norte,231310,CE,Nordeste,FIOCRUZ/ASTRAZENECA,2745,2433,312
Tacaimbó,261470,PE,Nordeste,FIOCRUZ/ASTRAZENECA,2609,2425,184
Tacaimbó,261470,PE,Nordeste,BUTANTAN/SINOVAC,2210,1209,1001
Tacaimbó,261470,PE,Nordeste,PFIZER/BIONTECH,271,271,0
Tacaratu,261480,PE,Nordeste,BUTANTAN/SINOVAC,5352,2800,2552
Tacaratu,261480,PE,Nordeste,FIOCRUZ/ASTRAZENECA,4752,4352,400
Tacaratu,261480,PE,Nordeste,PFIZER/BIONTECH,391,391,0
Taciba,355290,SP,Sudeste,FIOCRUZ/ASTRAZENECA,1697,1577,120
Taciba,355290,SP,Sudeste,BUTANTAN/SINOVAC,1407,796,611
Taciba,355290,SP,Sudeste,PFIZER/BIONTECH,193,193,0
Tacima,251640,PB,Nordeste,BUTANTAN/SINOVAC,1997,1137,860
Tacima,251640,PB,Nordeste,FIOCRUZ/ASTRAZENECA,860,716,144
Tacima,251640,PB,Nordeste,PFIZER/BIONTECH,105,105,0
Tacuru,500795,MS,Centro-Oeste,BUTANTAN/SINOVAC,5448,2813,2635
Tacuru,500795,MS,Centro-Oeste,FIOCRUZ/ASTRAZENECA,2344,2077,267
Tacuru,500795,MS,Centro-Oeste,PFIZER/BIONTECH,294,293,1
Taguaí,355300,SP,Sudeste,FIOCRUZ/ASTRAZENECA,2681,2504,177
Taguaí,355300,SP,Sudeste,BUTANTAN/SINOVAC,2607,1450,1157
Taguaí,355300,SP,Sudeste,PFIZER/BIONTECH,300,300,0
Taguatinga,172090,TO,Norte,FIOCRUZ/ASTRAZENECA,3223,3087,136
Taguatinga,172090,TO,Norte,BUTANTAN/SINOVAC,2934,1481,1453
Taiaçu,355310,SP,Sudeste,BUTANTAN/SINOVAC,1634,937,697
Taiaçu,355310,SP,Sudeste,FIOCRUZ/ASTRAZENECA,1400,1263,137
Taiaçu,355310,SP,Sudeste,PFIZER/BIONTECH,218,218,0
Tailândia,150795,PA,Norte,FIOCRUZ/ASTRAZENECA,7013,5685,1328
Tailândia,150795,PA,Norte,BUTANTAN/SINOVAC,5465,2894,2571
Taió,421780,SC,Sul,FIOCRUZ/ASTRAZENECA,4247,3855,392
Taió,421780,SC,Sul,BUTANTAN/SINOVAC,3812,2065,1747
Taió,421780,SC,Sul,PFIZER/BIONTECH,485,484,1
Taiobeiras,316800,MG,Sudeste,BUTANTAN/SINOVAC,5840,3507,2333
Taiobeiras,316800,MG,Sudeste,FIOCRUZ/ASTRAZENECA,2965,2918,47
Taiobeiras,316800,MG,Sudeste,PFIZER/BIONTECH,28,28,0
Taipas Do Tocantins,172093,TO,Norte,BUTANTAN/SINOVAC,480,258,222
Taipas Do Tocantins,172093,TO,Norte,FIOCRUZ/ASTRAZENECA,323,291,32
Taipu,241390,RN,Nordeste,FIOCRUZ/ASTRAZENECA,3525,3345,180
Taipu,241390,RN,Nordeste,BUTANTAN/SINOVAC,3418,1996,1422
Taipu,241390,RN,Nordeste,PFIZER/BIONTECH,375,375,0
Taiúva,355320,SP,Sudeste,BUTANTAN/SINOVAC,1974,1076,898
Taiúva,355320,SP,Sudeste,FIOCRUZ/ASTRAZENECA,1397,1198,199
Taiúva,355320,SP,Sudeste,PFIZER/BIONTECH,145,145,0
Talismã,172097,TO,Norte,BUTANTAN/SINOVAC,564,303,261
Talismã,172097,TO,Norte,FIOCRUZ/ASTRAZENECA,486,455,31
Tamandaré,261485,PE,Nordeste,BUTANTAN/SINOVAC,3693,1961,1732
Tamandaré,261485,PE,Nordeste,FIOCRUZ/ASTRAZENECA,3397,3161,236
Tamandaré,261485,PE,Nordeste,PFIZER/BIONTECH,123,123,0
Tamarana,412667,PR,Sul,BUTANTAN/SINOVAC,4627,2423,2204
Tamarana,412667,PR,Sul,FIOCRUZ/ASTRAZENECA,3156,3021,135
Tamarana,412667,PR,Sul,PFIZER/BIONTECH,112,112,0
Tambaú,355330,SP,Sudeste,BUTANTAN/SINOVAC,6028,3446,2582
Tambaú,355330,SP,Sudeste,FIOCRUZ/ASTRAZENECA,4375,3922,453
Tambaú,355330,SP,Sudeste,PFIZER/BIONTECH,460,460,0
Tamboara,412670,PR,Sul,FIOCRUZ/ASTRAZENECA,1292,1187,105
Tamboara,412670,PR,Sul,BUTANTAN/SINOVAC,1181,623,558
Tamboara,412670,PR,Sul,PFIZER/BIONTECH,17,17,0
Tamboril,231320,CE,Nordeste,BUTANTAN/SINOVAC,6289,3217,3072
Tamboril,231320,CE,Nordeste,FIOCRUZ/ASTRAZENECA,3434,2667,767
Tamboril Do Piauí,221095,PI,Nordeste,FIOCRUZ/ASTRAZENECA,519,472,47
Tamboril Do Piauí,221095,PI,Nordeste,BUTANTAN/SINOVAC,505,262,243
Tamboril Do Piauí,221095,PI,Nordeste,PFIZER/BIONTECH,18,18,0
Tanabi,355340,SP,Sudeste,BUTANTAN/SINOVAC,7258,4111,3147
Tanabi,355340,SP,Sudeste,FIOCRUZ/ASTRAZENECA,6529,5916,613
Tanabi,355340,SP,Sudeste,PFIZER/BIONTECH,857,857,0
Tangará,241400,RN,Nordeste,BUTANTAN/SINOVAC,2917,1454,1463
Tangará,241400,RN,Nordeste,FIOCRUZ/ASTRAZENECA,2699,2435,264
Tangará,241400,RN,Nordeste,PFIZER/BIONTECH,274,274,0
Tangará,421790,SC,Sul,FIOCRUZ/ASTRAZENECA,2196,1989,207
Tangará,421790,SC,Sul,BUTANTAN/SINOVAC,2116,1097,1019
Tangará,421790,SC,Sul,PFIZER/BIONTECH,114,114,0
Tangará Da Serra,510795,MT,Centro-Oeste,FIOCRUZ/ASTRAZENECA,14230,13031,1199
Tangará Da Serra,510795,MT,Centro-Oeste,BUTANTAN/SINOVAC,13110,6680,6430
Tangará Da Serra,510795,MT,Centro-Oeste,PFIZER/BIONTECH,1451,1450,1
Tanguá,330575,RJ,Sudeste,BUTANTAN/SINOVAC,6237,3516,2721
Tanguá,330575,RJ,Sudeste,FIOCRUZ/ASTRAZENECA,5837,5512,325
Tanguá,330575,RJ,Sudeste,PFIZER/BIONTECH,664,664,0
Tanhaçu,293100,BA,Nordeste,BUTANTAN/SINOVAC,1145,886,259
Tanhaçu,293100,BA,Nordeste,FIOCRUZ/ASTRAZENECA,245,245,0
Tanque D'Arca,270900,AL,Nordeste,FIOCRUZ/ASTRAZENECA,1348,1197,151
Tanque D'Arca,270900,AL,Nordeste,BUTANTAN/SINOVAC,1307,693,614
Tanque Do Piauí,221097,PI,Nordeste,FIOCRUZ/ASTRAZENECA,535,487,48
Tanque Do Piauí,221097,PI,Nordeste,BUTANTAN/SINOVAC,516,270,246
Tanque Do Piauí,221097,PI,Nordeste,PFIZER/BIONTECH,70,70,0
Tanque Novo,293105,BA,Nordeste,BUTANTAN/SINOVAC,4183,2419,1764
Tanque Novo,293105,BA,Nordeste,FIOCRUZ/ASTRAZENECA,3914,3547,367
Tanque Novo,293105,BA,Nordeste,PFIZER/BIONTECH,100,99,1
Tanquinho,293110,BA,Nordeste,BUTANTAN/SINOVAC,2050,1069,981
Tanquinho,293110,BA,Nordeste,FIOCRUZ/ASTRAZENECA,1612,1470,142
Tanquinho,293110,BA,Nordeste,PFIZER/BIONTECH,311,311,0
Taparuba,316805,MG,Sudeste,BUTANTAN/SINOVAC,904,451,453
Taparuba,316805,MG,Sudeste,FIOCRUZ/ASTRAZENECA,810,783,27
Taparuba,316805,MG,Sudeste,PFIZER/BIONTECH,51,51,0
Tapauá,130410,AM,Norte,BUTANTAN/SINOVAC,598,427,171
Tapauá,130410,AM,Norte,FIOCRUZ/ASTRAZENECA,366,296,70
Tapauá,130410,AM,Norte,PFIZER/BIONTECH,1,1,0
Tapejara,412680,PR,Sul,FIOCRUZ/ASTRAZENECA,3387,3193,194
Tapejara,412680,PR,Sul,BUTANTAN/SINOVAC,2660,1385,1275
Tapejara,412680,PR,Sul,PFIZER/BIONTECH,433,432,1
Tapejara,432090,RS,Sul,FIOCRUZ/ASTRAZENECA,6332,5581,751
Tapejara,432090,RS,Sul,BUTANTAN/SINOVAC,4861,2444,2417
Tapejara,432090,RS,Sul,PFIZER/BIONTECH,887,886,1
Tapera,432100,RS,Sul,BUTANTAN/SINOVAC,2875,1465,1410
Tapera,432100,RS,Sul,FIOCRUZ/ASTRAZENECA,2517,2207,310
Tapera,432100,RS,Sul,PFIZER/BIONTECH,280,280,0
Taperoá,251650,PB,Nordeste,BUTANTAN/SINOVAC,3408,1795,1613
Taperoá,251650,PB,Nordeste,FIOCRUZ/ASTRAZENECA,2493,2232,261
Taperoá,251650,PB,Nordeste,PFIZER/BIONTECH,83,83,0
Taperoá,293120,BA,Nordeste,FIOCRUZ/ASTRAZENECA,3633,3389,244
Taperoá,293120,BA,Nordeste,BUTANTAN/SINOVAC,3214,1789,1425
Taperoá,293120,BA,Nordeste,PFIZER/BIONTECH,232,232,0
Tapes,432110,RS,Sul,BUTANTAN/SINOVAC,4827,2361,2466
Tapes,432110,RS,Sul,FIOCRUZ/ASTRAZENECA,4454,4116,338
Tapes,432110,RS,Sul,PFIZER/BIONTECH,359,359,0
Tapira,316810,MG,Sudeste,FIOCRUZ/ASTRAZENECA,1432,1339,93
Tapira,316810,MG,Sudeste,BUTANTAN/SINOVAC,1201,636,565
Tapira,316810,MG,Sudeste,PFIZER/BIONTECH,76,76,0
Tapira,412690,PR,Sul,FIOCRUZ/ASTRAZENECA,2064,1933,131
Tapira,412690,PR,Sul,BUTANTAN/SINOVAC,1539,791,748
Tapira,412690,PR,Sul,PFIZER/BIONTECH,30,30,0
Tapiraí,316820,MG,Sudeste,BUTANTAN/SINOVAC,969,508,461
Tapiraí,316820,MG,Sudeste,FIOCRUZ/ASTRAZENECA,827,743,84
Tapiraí,316820,MG,Sudeste,PFIZER/BIONTECH,45,45,0
Tapiraí,355350,SP,Sudeste,BUTANTAN/SINOVAC,2254,1293,961
Tapiraí,355350,SP,Sudeste,FIOCRUZ/ASTRAZENECA,2190,2058,132
Tapiraí,355350,SP,Sudeste,PFIZER/BIONTECH,187,187,0
Tapiramutá,293130,BA,Nordeste,FIOCRUZ/ASTRAZENECA,2929,2642,287
Tapiramutá,293130,BA,Nordeste,BUTANTAN/SINOVAC,2502,1331,1171
Tapiramutá,293130,BA,Nordeste,PFIZER/BIONTECH,397,396,1
Tapiratiba,355360,SP,Sudeste,FIOCRUZ/ASTRAZENECA,3187,2903,284
Tapiratiba,355360,SP,Sudeste,BUTANTAN/SINOVAC,3184,1615,1569
Tapiratiba,355360,SP,Sudeste,PFIZER/BIONTECH,309,309,0
Tapurah,510800,MT,Centro-Oeste,FIOCRUZ/ASTRAZENECA,1453,1369,84
Tapurah,510800,MT,Centro-Oeste,BUTANTAN/SINOVAC,871,443,428
Tapurah,510800,MT,Centro-Oeste,PFIZER/BIONTECH,37,37,0
Taquara,432120,RS,Sul,FIOCRUZ/ASTRAZENECA,14780,13753,1027
Taquara,432120,RS,Sul,BUTANTAN/SINOVAC,13405,6834,6571
Taquara,432120,RS,Sul,PFIZER/BIONTECH,1519,1515,4
Taquaraçu De Minas,316830,MG,Sudeste,BUTANTAN/SINOVAC,893,443,450
Taquaraçu De Minas,316830,MG,Sudeste,FIOCRUZ/ASTRAZENECA,350,255,95
Taquaral,355365,SP,Sudeste,BUTANTAN/SINOVAC,735,385,350
Taquaral,355365,SP,Sudeste,FIOCRUZ/ASTRAZENECA,731,670,61
Taquaral,355365,SP,Sudeste,PFIZER/BIONTECH,53,53,0
Taquaral De Goiás,522100,GO,Centro-Oeste,FIOCRUZ/ASTRAZENECA,1009,947,62
Taquaral De Goiás,522100,GO,Centro-Oeste,BUTANTAN/SINOVAC,856,442,414
Taquaral De Goiás,522100,GO,Centro-Oeste,PFIZER/BIONTECH,54,54,0
Taquarana,270910,AL,Nordeste,FIOCRUZ/ASTRAZENECA,4456,4007,449
Taquarana,270910,AL,Nordeste,BUTANTAN/SINOVAC,3444,1766,1678
Taquari,432130,RS,Sul,BUTANTAN/SINOVAC,8124,4103,4021
Taquari,432130,RS,Sul,FIOCRUZ/ASTRAZENECA,6923,6072,851
Taquari,432130,RS,Sul,PFIZER/BIONTECH,951,949,2
Taquaritinga,355370,SP,Sudeste,FIOCRUZ/ASTRAZENECA,14178,12883,1295
Taquaritinga,355370,SP,Sudeste,BUTANTAN/SINOVAC,13650,7351,6299
Taquaritinga,355370,SP,Sudeste,PFIZER/BIONTECH,928,927,1
Taquaritinga Do Norte,261500,PE,Nordeste,FIOCRUZ/ASTRAZENECA,4651,4203,448
Taquaritinga Do Norte,261500,PE,Nordeste,BUTANTAN/SINOVAC,3822,1951,1871
Taquaritinga Do Norte,261500,PE,Nordeste,PFIZER/BIONTECH,609,609,0
Taquarituba,355380,SP,Sudeste,FIOCRUZ/ASTRAZENECA,6250,5817,433
Taquarituba,355380,SP,Sudeste,BUTANTAN/SINOVAC,5806,3219,2587
Taquarituba,355380,SP,Sudeste,PFIZER/BIONTECH,775,774,1
Taquarivaí,355385,SP,Sudeste,FIOCRUZ/ASTRAZENECA,1042,998,44
Taquarivaí,355385,SP,Sudeste,BUTANTAN/SINOVAC,938,527,411
Taquarivaí,355385,SP,Sudeste,PFIZER/BIONTECH,63,63,0
Taquaruçu Do Sul,432132,RS,Sul,BUTANTAN/SINOVAC,1093,552,541
Taquaruçu Do Sul,432132,RS,Sul,FIOCRUZ/ASTRAZENECA,955,870,85
Taquaruçu Do Sul,432132,RS,Sul,PFIZER/BIONTECH,131,131,0
Taquarussu,500797,MS,Centro-Oeste,BUTANTAN/SINOVAC,883,456,427
Taquarussu,500797,MS,Centro-Oeste,FIOCRUZ/ASTRAZENECA,861,792,69
Taquarussu,500797,MS,Centro-Oeste,PFIZER/BIONTECH,138,138,0
Tarabai,355390,SP,Sudeste,BUTANTAN/SINOVAC,1543,886,657
Tarabai,355390,SP,Sudeste,FIOCRUZ/ASTRAZENECA,1525,1414,111
Tarabai,355390,SP,Sudeste,PFIZER/BIONTECH,70,70,0
Tarauacá,120060,AC,Norte,FIOCRUZ/ASTRAZENECA,4562,4014,548
Tarauacá,120060,AC,Norte,BUTANTAN/SINOVAC,4512,2531,1981
Tarrafas,231325,CE,Nordeste,BUTANTAN/SINOVAC,1872,964,908
Tarrafas,231325,CE,Nordeste,FIOCRUZ/ASTRAZENECA,815,679,136
Tartarugalzinho,160070,AP,Norte,BUTANTAN/SINOVAC,2023,1090,933
Tartarugalzinho,160070,AP,Norte,FIOCRUZ/ASTRAZENECA,1373,1277,96
Tartarugalzinho,160070,AP,Norte,PFIZER/BIONTECH,422,421,1
Tarumã,355395,SP,Sudeste,FIOCRUZ/ASTRAZENECA,3853,3647,206
Tarumã,355395,SP,Sudeste,BUTANTAN/SINOVAC,2859,1578,1281
Tarumã,355395,SP,Sudeste,PFIZER/BIONTECH,427,427,0
Tarumirim,316840,MG,Sudeste,BUTANTAN/SINOVAC,3810,1959,1851
Tarumirim,316840,MG,Sudeste,FIOCRUZ/ASTRAZENECA,3298,2937,361
Tarumirim,316840,MG,Sudeste,PFIZER/BIONTECH,424,424,0
Tasso Fragoso,211200,MA,Nordeste,FIOCRUZ/ASTRAZENECA,1097,995,102
Tasso Fragoso,211200,MA,Nordeste,BUTANTAN/SINOVAC,944,476,468
Tatuí,355400,SP,Sudeste,BUTANTAN/SINOVAC,28984,16313,12671
Tatuí,355400,SP,Sudeste,FIOCRUZ/ASTRAZENECA,28934,26721,2213
Tatuí,355400,SP,Sudeste,PFIZER/BIONTECH,1952,1952,0
Tauá,231330,CE,Nordeste,BUTANTAN/SINOVAC,10595,5950,4645
Tauá,231330,CE,Nordeste,FIOCRUZ/ASTRAZENECA,7441,6894,547
Taubaté,355410,SP,Sudeste,FIOCRUZ/ASTRAZENECA,67562,63109,4453
Taubaté,355410,SP,Sudeste,BUTANTAN/SINOVAC,62782,37202,25580
Taubaté,355410,SP,Sudeste,PFIZER/BIONTECH,1611,1605,6
Tavares,251660,PB,Nordeste,BUTANTAN/SINOVAC,3183,1594,1589
Tavares,251660,PB,Nordeste,FIOCRUZ/ASTRAZENECA,2701,2482,219
Tavares,251660,PB,Nordeste,PFIZER/BIONTECH,217,217,0
Tavares,432135,RS,Sul,BUTANTAN/SINOVAC,1985,1052,933
Tavares,432135,RS,Sul,FIOCRUZ/ASTRAZENECA,1436,1211,225
Tavares,432135,RS,Sul,PFIZER/BIONTECH,69,69,0
Tefé,130420,AM,Norte,BUTANTAN/SINOVAC,12046,7956,4090
Tefé,130420,AM,Norte,FIOCRUZ/ASTRAZENECA,11408,8893,2515
Teixeira,251670,PB,Nordeste,BUTANTAN/SINOVAC,4556,2716,1840
Teixeira,251670,PB,Nordeste,FIOCRUZ/ASTRAZENECA,2777,2574,203
Teixeira,251670,PB,Nordeste,PFIZER/BIONTECH,337,337,0
Teixeira De Freitas,293135,BA,Nordeste,BUTANTAN/SINOVAC,24955,13041,11914
Teixeira De Freitas,293135,BA,Nordeste,FIOCRUZ/ASTRAZENECA,21649,19453,2196
Teixeira De Freitas,293135,BA,Nordeste,PFIZER/BIONTECH,2869,2869,0
Teixeira Soares,412700,PR,Sul,FIOCRUZ/ASTRAZENECA,2518,2383,135
Teixeira Soares,412700,PR,Sul,BUTANTAN/SINOVAC,2104,1080,1024
Teixeira Soares,412700,PR,Sul,PFIZER/BIONTECH,146,146,0
Teixeiras,316850,MG,Sudeste,BUTANTAN/SINOVAC,3033,1666,1367
Teixeiras,316850,MG,Sudeste,FIOCRUZ/ASTRAZENECA,2850,2695,155
Teixeiras,316850,MG,Sudeste,PFIZER/BIONTECH,47,47,0
Teixeirópolis,110155,RO,Norte,FIOCRUZ/ASTRAZENECA,1589,1536,53
Teixeirópolis,110155,RO,Norte,BUTANTAN/SINOVAC,1357,721,636
Teixeirópolis,110155,RO,Norte,PFIZER/BIONTECH,160,160,0
Tejuçuoca,231335,CE,Nordeste,BUTANTAN/SINOVAC,588,366,222
Tejuçuoca,231335,CE,Nordeste,FIOCRUZ/ASTRAZENECA,258,256,2
Tejupá,355420,SP,Sudeste,BUTANTAN/SINOVAC,1018,584,434
Tejupá,355420,SP,Sudeste,FIOCRUZ/ASTRAZENECA,903,860,43
Tejupá,355420,SP,Sudeste,PFIZER/BIONTECH,91,91,0
Telêmaco Borba,412710,PR,Sul,FIOCRUZ/ASTRAZENECA,14566,13787,779
Telêmaco Borba,412710,PR,Sul,BUTANTAN/SINOVAC,13032,6742,6290
Telêmaco Borba,412710,PR,Sul,PFIZER/BIONTECH,3986,3984,2
Telha,280730,SE,Nordeste,BUTANTAN/SINOVAC,624,347,277
Telha,280730,SE,Nordeste,FIOCRUZ/ASTRAZENECA,484,484,0
Telha,280730,SE,Nordeste,PFIZER/BIONTECH,71,71,0
Tenente Ananias,241410,RN,Nordeste,FIOCRUZ/ASTRAZENECA,2516,2389,127
Tenente Ananias,241410,RN,Nordeste,BUTANTAN/SINOVAC,2333,1200,1133
Tenente Ananias,241410,RN,Nordeste,PFIZER/BIONTECH,333,333,0
Tenente Laurentino Cruz,241415,RN,Nordeste,BUTANTAN/SINOVAC,1166,646,520
Tenente Laurentino Cruz,241415,RN,Nordeste,FIOCRUZ/ASTRAZENECA,1017,981,36
Tenente Laurentino Cruz,241415,RN,Nordeste,PFIZER/BIONTECH,116,116,0
Tenente Portela,432140,RS,Sul,BUTANTAN/SINOVAC,6774,3478,3296
Tenente Portela,432140,RS,Sul,FIOCRUZ/ASTRAZENECA,3814,3193,621
Tenente Portela,432140,RS,Sul,PFIZER/BIONTECH,462,462,0
Tenório,251675,PB,Nordeste,BUTANTAN/SINOVAC,559,274,285
Tenório,251675,PB,Nordeste,FIOCRUZ/ASTRAZENECA,184,165,19
Teodoro Sampaio,293140,BA,Nordeste,BUTANTAN/SINOVAC,1965,1004,961
Teodoro Sampaio,293140,BA,Nordeste,FIOCRUZ/ASTRAZENECA,1618,1460,158
Teodoro Sampaio,293140,BA,Nordeste,PFIZER/BIONTECH,216,216,0
Teodoro Sampaio,355430,SP,Sudeste,FIOCRUZ/ASTRAZENECA,5546,5251,295
Teodoro Sampaio,355430,SP,Sudeste,BUTANTAN/SINOVAC,5183,2892,2291
Teodoro Sampaio,355430,SP,Sudeste,PFIZER/BIONTECH,840,840,0
Teofilândia,293150,BA,Nordeste,FIOCRUZ/ASTRAZENECA,4261,3876,385
Teofilândia,293150,BA,Nordeste,BUTANTAN/SINOVAC,3863,1983,1880
Teofilândia,293150,BA,Nordeste,PFIZER/BIONTECH,311,311,0
Teófilo Otoni,316860,MG,Sudeste,BUTANTAN/SINOVAC,29597,16358,13239
Teófilo Otoni,316860,MG,Sudeste,FIOCRUZ/ASTRAZENECA,12135,11391,744
Teófilo Otoni,316860,MG,Sudeste,PFIZER/BIONTECH,846,844,2
Teolândia,293160,BA,Nordeste,BUTANTAN/SINOVAC,818,473,345
Teolândia,293160,BA,Nordeste,FIOCRUZ/ASTRAZENECA,587,543,44
Teolândia,293160,BA,Nordeste,PFIZER/BIONTECH,11,11,0
Teotônio Vilela,270915,AL,Nordeste,FIOCRUZ/ASTRAZENECA,7458,6895,563
Teotônio Vilela,270915,AL,Nordeste,BUTANTAN/SINOVAC,5712,2996,2716
Teotônio Vilela,270915,AL,Nordeste,PFIZER/BIONTECH,1099,1099,0
Terenos,500800,MS,Centro-Oeste,BUTANTAN/SINOVAC,4274,2412,1862
Terenos,500800,MS,Centro-Oeste,FIOCRUZ/ASTRAZENECA,4086,3637,449
Terenos,500800,MS,Centro-Oeste,PFIZER/BIONTECH,258,255,3
Teresina,221100,PI,Nordeste,FIOCRUZ/ASTRAZENECA,180869,167589,13280
Teresina,221100,PI,Nordeste,BUTANTAN/SINOVAC,150944,76451,74493
Teresina,221100,PI,Nordeste,PFIZER/BIONTECH,55205,55156,49
Teresina De Goiás,522108,GO,Centro-Oeste,BUTANTAN/SINOVAC,1532,810,722
Teresina De Goiás,522108,GO,Centro-Oeste,FIOCRUZ/ASTRAZENECA,636,583,53
Teresópolis,330580,RJ,Sudeste,BUTANTAN/SINOVAC,36767,19220,17547
Teresópolis,330580,RJ,Sudeste,FIOCRUZ/ASTRAZENECA,34522,31224,3298
Teresópolis,330580,RJ,Sudeste,PFIZER/BIONTECH,3468,3431,37
Terezinha,261510,PE,Nordeste,BUTANTAN/SINOVAC,1713,901,812
Terezinha,261510,PE,Nordeste,FIOCRUZ/ASTRAZENECA,1492,1359,133
Terezinha,261510,PE,Nordeste,PFIZER/BIONTECH,232,231,1
Terezópolis De Goiás,522119,GO,Centro-Oeste,FIOCRUZ/ASTRAZENECA,1533,1462,71
Terezópolis De Goiás,522119,GO,Centro-Oeste,BUTANTAN/SINOVAC,932,498,434
Terezópolis De Goiás,522119,GO,Centro-Oeste,PFIZER/BIONTECH,26,26,0
Terra Alta,150796,PA,Norte,BUTANTAN/SINOVAC,1427,756,671
Terra Alta,150796,PA,Norte,FIOCRUZ/ASTRAZENECA,1074,1027,47
Terra Boa,412720,PR,Sul,FIOCRUZ/ASTRAZENECA,4303,4052,251
Terra Boa,412720,PR,Sul,BUTANTAN/SINOVAC,3799,2025,1774
Terra Boa,412720,PR,Sul,PFIZER/BIONTECH,520,520,0
Terra De Areia,432143,RS,Sul,BUTANTAN/SINOVAC,3078,1563,1515
Terra De Areia,432143,RS,Sul,FIOCRUZ/ASTRAZENECA,2839,2591,248
Terra De Areia,432143,RS,Sul,PFIZER/BIONTECH,338,334,4
Terra Nova,261520,PE,Nordeste,FIOCRUZ/ASTRAZENECA,2159,1979,180
Terra Nova,261520,PE,Nordeste,BUTANTAN/SINOVAC,1773,892,881
Terra Nova,261520,PE,Nordeste,PFIZER/BIONTECH,228,228,0
Terra Nova,293170,BA,Nordeste,BUTANTAN/SINOVAC,2623,1441,1182
Terra Nova,293170,BA,Nordeste,FIOCRUZ/ASTRAZENECA,2267,2150,117
Terra Nova,293170,BA,Nordeste,PFIZER/BIONTECH,365,365,0
Terra Nova Do Norte,510805,MT,Centro-Oeste,FIOCRUZ/ASTRAZENECA,2157,2034,123
Terra Nova Do Norte,510805,MT,Centro-Oeste,BUTANTAN/SINOVAC,1877,992,885
Terra Nova Do Norte,510805,MT,Centro-Oeste,PFIZER/BIONTECH,31,31,0
Terra Rica,412730,PR,Sul,FIOCRUZ/ASTRAZENECA,4050,3809,241
Terra Rica,412730,PR,Sul,BUTANTAN/SINOVAC,4017,2061,1956
Terra Rica,412730,PR,Sul,PFIZER/BIONTECH,164,164,0
Terra Roxa,355440,SP,Sudeste,FIOCRUZ/ASTRAZENECA,2248,2017,231
Terra Roxa,355440,SP,Sudeste,BUTANTAN/SINOVAC,2151,1195,956
Terra Roxa,355440,SP,Sudeste,PFIZER/BIONTECH,95,95,0
Terra Roxa,412740,PR,Sul,BUTANTAN/SINOVAC,6811,3847,2964
Terra Roxa,412740,PR,Sul,FIOCRUZ/ASTRAZENECA,4876,4479,397
Terra Roxa,412740,PR,Sul,PFIZER/BIONTECH,212,212,0
Terra Santa,150797,PA,Norte,FIOCRUZ/ASTRAZENECA,3830,3007,823
Terra Santa,150797,PA,Norte,BUTANTAN/SINOVAC,833,436,397
Tesouro,510810,MT,Centro-Oeste,BUTANTAN/SINOVAC,1151,598,553
Tesouro,510810,MT,Centro-Oeste,FIOCRUZ/ASTRAZENECA,418,369,49
Tesouro,510810,MT,Centro-Oeste,PFIZER/BIONTECH,6,6,0
Teutônia,432145,RS,Sul,BUTANTAN/SINOVAC,11244,6857,4387
Teutônia,432145,RS,Sul,FIOCRUZ/ASTRAZENECA,8101,7351,750
Teutônia,432145,RS,Sul,PFIZER/BIONTECH,655,655,0
Theobroma,110160,RO,Norte,BUTANTAN/SINOVAC,1882,961,921
Theobroma,110160,RO,Norte,FIOCRUZ/ASTRAZENECA,1317,1278,39
Theobroma,110160,RO,Norte,PFIZER/BIONTECH,146,146,0
Tianguá,231340,CE,Nordeste,BUTANTAN/SINOVAC,11352,5898,5454
Tianguá,231340,CE,Nordeste,FIOCRUZ/ASTRAZENECA,8184,7436,748
Tianguá,231340,CE,Nordeste,PFIZER/BIONTECH,293,293,0
Tibagi,412750,PR,Sul,FIOCRUZ/ASTRAZENECA,4405,4181,224
Tibagi,412750,PR,Sul,BUTANTAN/SINOVAC,3666,1921,1745
Tibau,241105,RN,Nordeste,BUTANTAN/SINOVAC,1187,683,504
Tibau,241105,RN,Nordeste,FIOCRUZ/ASTRAZENECA,1170,1139,31
Tibau,241105,RN,Nordeste,PFIZER/BIONTECH,232,231,1
Tibau Do Sul,241420,RN,Nordeste,FIOCRUZ/ASTRAZENECA,2707,2417,290
Tibau Do Sul,241420,RN,Nordeste,BUTANTAN/SINOVAC,2108,1110,998
Tibau Do Sul,241420,RN,Nordeste,PFIZER/BIONTECH,233,232,1
Tietê,355450,SP,Sudeste,FIOCRUZ/ASTRAZENECA,9770,8858,912
Tietê,355450,SP,Sudeste,BUTANTAN/SINOVAC,8205,4675,3530
Tietê,355450,SP,Sudeste,PFIZER/BIONTECH,844,844,0
Tigrinhos,421795,SC,Sul,BUTANTAN/SINOVAC,1015,567,448
Tigrinhos,421795,SC,Sul,FIOCRUZ/ASTRAZENECA,734,686,48
Tigrinhos,421795,SC,Sul,PFIZER/BIONTECH,7,7,0
Tijucas,421800,SC,Sul,FIOCRUZ/ASTRAZENECA,6329,6289,40
Tijucas,421800,SC,Sul,BUTANTAN/SINOVAC,5390,2925,2465
Tijucas,421800,SC,Sul,PFIZER/BIONTECH,702,701,1
Tijucas Do Sul,412760,PR,Sul,FIOCRUZ/ASTRAZENECA,3921,3652,269
Tijucas Do Sul,412760,PR,Sul,BUTANTAN/SINOVAC,3337,1761,1576
Tijucas Do Sul,412760,PR,Sul,PFIZER/BIONTECH,199,199,0
Timbaúba,261530,PE,Nordeste,FIOCRUZ/ASTRAZENECA,10053,9335,718
Timbaúba,261530,PE,Nordeste,BUTANTAN/SINOVAC,8810,4563,4247
Timbaúba,261530,PE,Nordeste,PFIZER/BIONTECH,938,937,1
Timbaúba Dos Batistas,241430,RN,Nordeste,BUTANTAN/SINOVAC,645,333,312
Timbaúba Dos Batistas,241430,RN,Nordeste,FIOCRUZ/ASTRAZENECA,637,596,41
Timbaúba Dos Batistas,241430,RN,Nordeste,PFIZER/BIONTECH,73,72,1
Timbé Do Sul,421810,SC,Sul,FIOCRUZ/ASTRAZENECA,1410,1291,119
Timbé Do Sul,421810,SC,Sul,BUTANTAN/SINOVAC,1333,690,643
Timbé Do Sul,421810,SC,Sul,PFIZER/BIONTECH,134,134,0
Timbiras,211210,MA,Nordeste,BUTANTAN/SINOVAC,5576,2875,2701
Timbiras,211210,MA,Nordeste,FIOCRUZ/ASTRAZENECA,4047,3654,393
Timbiras,211210,MA,Nordeste,PFIZER/BIONTECH,1,1,0
Timbó,421820,SC,Sul,FIOCRUZ/ASTRAZENECA,10435,10173,262
Timbó,421820,SC,Sul,BUTANTAN/SINOVAC,9512,5108,4404
Timbó,421820,SC,Sul,PFIZER/BIONTECH,882,882,0
Timbó Grande,421825,SC,Sul,FIOCRUZ/ASTRAZENECA,1673,1494,179
Timbó Grande,421825,SC,Sul,BUTANTAN/SINOVAC,925,542,383
Timbó Grande,421825,SC,Sul,PFIZER/BIONTECH,29,29,0
Timburi,355460,SP,Sudeste,BUTANTAN/SINOVAC,943,471,472
Timburi,355460,SP,Sudeste,FIOCRUZ/ASTRAZENECA,874,791,83
Timburi,355460,SP,Sudeste,PFIZER/BIONTECH,83,83,0
Timon,211220,MA,Nordeste,FIOCRUZ/ASTRAZENECA,31984,29663,2321
Timon,211220,MA,Nordeste,BUTANTAN/SINOVAC,22614,11520,11094
Timon,211220,MA,Nordeste,PFIZER/BIONTECH,7622,7620,2
Timóteo,316870,MG,Sudeste,BUTANTAN/SINOVAC,16318,8519,7799
Timóteo,316870,MG,Sudeste,FIOCRUZ/ASTRAZENECA,15066,13615,1451
Timóteo,316870,MG,Sudeste,PFIZER/BIONTECH,2175,2175,0
Tio Hugo,432146,RS,Sul,FIOCRUZ/ASTRAZENECA,835,770,65
Tio Hugo,432146,RS,Sul,BUTANTAN/SINOVAC,813,410,403
Tio Hugo,432146,RS,Sul,PFIZER/BIONTECH,128,128,0
Tiradentes,316880,MG,Sudeste,FIOCRUZ/ASTRAZENECA,1694,1627,67
Tiradentes,316880,MG,Sudeste,BUTANTAN/SINOVAC,1404,734,670
Tiradentes,316880,MG,Sudeste,PFIZER/BIONTECH,82,82,0
Tiradentes Do Sul,432147,RS,Sul,BUTANTAN/SINOVAC,2271,1141,1130
Tiradentes Do Sul,432147,RS,Sul,FIOCRUZ/ASTRAZENECA,1488,1323,165
Tiradentes Do Sul,432147,RS,Sul,PFIZER/BIONTECH,167,167,0
Tiros,316890,MG,Sudeste,BUTANTAN/SINOVAC,1788,914,874
Tiros,316890,MG,Sudeste,FIOCRUZ/ASTRAZENECA,1736,1604,132
Tiros,316890,MG,Sudeste,PFIZER/BIONTECH,120,120,0
Tobias Barreto,280740,SE,Nordeste,FIOCRUZ/ASTRAZENECA,11336,10302,1034
Tobias Barreto,280740,SE,Nordeste,BUTANTAN/SINOVAC,10078,5198,4880
Tobias Barreto,280740,SE,Nordeste,PFIZER/BIONTECH,282,282,0
Tocantínia,172110,TO,Norte,BUTANTAN/SINOVAC,3435,1983,1452
Tocantínia,172110,TO,Norte,FIOCRUZ/ASTRAZENECA,607,585,22
Tocantinópolis,172120,TO,Norte,BUTANTAN/SINOVAC,5897,3056,2841
Tocantinópolis,172120,TO,Norte,FIOCRUZ/ASTRAZENECA,2553,2353,200
Tocantins,316900,MG,Sudeste,BUTANTAN/SINOVAC,4261,2149,2112
Tocantins,316900,MG,Sudeste,FIOCRUZ/ASTRAZENECA,3593,3350,243
Tocantins,316900,MG,Sudeste,PFIZER/BIONTECH,135,135,0
Tocos Do Moji,316905,MG,Sudeste,FIOCRUZ/ASTRAZENECA,1282,1198,84
Tocos Do Moji,316905,MG,Sudeste,BUTANTAN/SINOVAC,1152,587,565
Tocos Do Moji,316905,MG,Sudeste,PFIZER/BIONTECH,34,34,0
Toledo,316910,MG,Sudeste,FIOCRUZ/ASTRAZENECA,1690,1548,142
Toledo,316910,MG,Sudeste,BUTANTAN/SINOVAC,1581,803,778
Toledo,316910,MG,Sudeste,PFIZER/BIONTECH,68,68,0
Toledo,412770,PR,Sul,FIOCRUZ/ASTRAZENECA,30266,27882,2384
Toledo,412770,PR,Sul,BUTANTAN/SINOVAC,27323,13903,13420
Toledo,412770,PR,Sul,PFIZER/BIONTECH,6315,6314,1
Tomar Do Geru,280750,SE,Nordeste,BUTANTAN/SINOVAC,2010,1044,966
Tomar Do Geru,280750,SE,Nordeste,FIOCRUZ/ASTRAZENECA,1565,1485,80
Tomar Do Geru,280750,SE,Nordeste,PFIZER/BIONTECH,108,108,0
Tomazina,412780,PR,Sul,FIOCRUZ/ASTRAZENECA,2432,2323,109
Tomazina,412780,PR,Sul,BUTANTAN/SINOVAC,2245,1158,1087
Tomazina,412780,PR,Sul,PFIZER/BIONTECH,115,115,0
Tombos,316920,MG,Sudeste,BUTANTAN/SINOVAC,2250,1164,1086
Tombos,316920,MG,Sudeste,FIOCRUZ/ASTRAZENECA,2033,1879,154
Tombos,316920,MG,Sudeste,PFIZER/BIONTECH,141,141,0
Tomé-Açu,150800,PA,Norte,FIOCRUZ/ASTRAZENECA,8812,7491,1321
Tomé-Açu,150800,PA,Norte,BUTANTAN/SINOVAC,6390,3384,3006
Tonantins,130423,AM,Norte,BUTANTAN/SINOVAC,4467,2448,2019
Tonantins,130423,AM,Norte,FIOCRUZ/ASTRAZENECA,2330,2044,286
Toritama,261540,PE,Nordeste,FIOCRUZ/ASTRAZENECA,5761,5429,332
Toritama,261540,PE,Nordeste,BUTANTAN/SINOVAC,3596,1824,1772
Toritama,261540,PE,Nordeste,PFIZER/BIONTECH,665,665,0
Torixoréu,510820,MT,Centro-Oeste,BUTANTAN/SINOVAC,1293,676,617
Torixoréu,510820,MT,Centro-Oeste,FIOCRUZ/ASTRAZENECA,1187,1163,24
Torixoréu,510820,MT,Centro-Oeste,PFIZER/BIONTECH,67,67,0
Toropi,432149,RS,Sul,FIOCRUZ/ASTRAZENECA,995,870,125
Toropi,432149,RS,Sul,BUTANTAN/SINOVAC,976,487,489
Toropi,432149,RS,Sul,PFIZER/BIONTECH,107,107,0
Torre De Pedra,355465,SP,Sudeste,BUTANTAN/SINOVAC,1348,761,587
Torre De Pedra,355465,SP,Sudeste,FIOCRUZ/ASTRAZENECA,828,767,61
Torre De Pedra,355465,SP,Sudeste,PFIZER/BIONTECH,103,103,0
Torres,432150,RS,Sul,BUTANTAN/SINOVAC,13319,6852,6467
Torres,432150,RS,Sul,FIOCRUZ/ASTRAZENECA,12815,12030,785
Torres,432150,RS,Sul,PFIZER/BIONTECH,1358,1353,5
Torrinha,355470,SP,Sudeste,BUTANTAN/SINOVAC,2647,1352,1295
Torrinha,355470,SP,Sudeste,FIOCRUZ/ASTRAZENECA,2377,2116,261
Torrinha,355470,SP,Sudeste,PFIZER/BIONTECH,191,191,0
Touros,241440,RN,Nordeste,BUTANTAN/SINOVAC,6608,3493,3115
Touros,241440,RN,Nordeste,FIOCRUZ/ASTRAZENECA,5130,4584,546
Touros,241440,RN,Nordeste,PFIZER/BIONTECH,373,372,1
Trabiju,355475,SP,Sudeste,BUTANTAN/SINOVAC,747,401,346
Trabiju,355475,SP,Sudeste,FIOCRUZ/ASTRAZENECA,636,579,57
Trabiju,355475,SP,Sudeste,PFIZER/BIONTECH,44,44,0
Tracuateua,150803,PA,Norte,FIOCRUZ/ASTRAZENECA,4695,3258,1437
Tracuateua,150803,PA,Norte,BUTANTAN/SINOVAC,3443,1906,1537
Tracunhaém,261550,PE,Nordeste,FIOCRUZ/ASTRAZENECA,2344,2213,131
Tracunhaém,261550,PE,Nordeste,BUTANTAN/SINOVAC,1909,1099,810
Tracunhaém,261550,PE,Nordeste,PFIZER/BIONTECH,103,103,0
Traipu,270920,AL,Nordeste,FIOCRUZ/ASTRAZENECA,5572,5121,451
Traipu,270920,AL,Nordeste,BUTANTAN/SINOVAC,4119,2207,1912
Trairão,150805,PA,Norte,FIOCRUZ/ASTRAZENECA,2465,1708,757
Trairão,150805,PA,Norte,BUTANTAN/SINOVAC,973,551,422
Trairi,231350,CE,Nordeste,BUTANTAN/SINOVAC,4386,2888,1498
Trairi,231350,CE,Nordeste,FIOCRUZ/ASTRAZENECA,2214,2059,155
Trairi,231350,CE,Nordeste,PFIZER/BIONTECH,2,2,0
Trajano De Moraes,330590,RJ,Sudeste,FIOCRUZ/ASTRAZENECA,2038,1863,175
Trajano De Moraes,330590,RJ,Sudeste,BUTANTAN/SINOVAC,1850,1093,757
Tramandaí,432160,RS,Sul,BUTANTAN/SINOVAC,19996,11701,8295
Tramandaí,432160,RS,Sul,FIOCRUZ/ASTRAZENECA,16108,14713,1395
Tramandaí,432160,RS,Sul,PFIZER/BIONTECH,608,608,0
Travesseiro,432162,RS,Sul,BUTANTAN/SINOVAC,994,499,495
Travesseiro,432162,RS,Sul,FIOCRUZ/ASTRAZENECA,654,541,113
Travesseiro,432162,RS,Sul,PFIZER/BIONTECH,107,107,0
Tremedal,293180,BA,Nordeste,BUTANTAN/SINOVAC,3642,2048,1594
Tremedal,293180,BA,Nordeste,FIOCRUZ/ASTRAZENECA,2261,2037,224
Tremembé,355480,SP,Sudeste,BUTANTAN/SINOVAC,10052,5523,4529
Tremembé,355480,SP,Sudeste,FIOCRUZ/ASTRAZENECA,8375,7578,797
Tremembé,355480,SP,Sudeste,PFIZER/BIONTECH,502,502,0
Três Arroios,432163,RS,Sul,BUTANTAN/SINOVAC,1186,595,591
Três Arroios,432163,RS,Sul,FIOCRUZ/ASTRAZENECA,831,695,136
Três Arroios,432163,RS,Sul,PFIZER/BIONTECH,120,120,0
Três Barras,421830,SC,Sul,FIOCRUZ/ASTRAZENECA,3931,3702,229
Três Barras,421830,SC,Sul,BUTANTAN/SINOVAC,3201,1752,1449
Três Barras,421830,SC,Sul,PFIZER/BIONTECH,264,264,0
Três Barras Do Paraná,412785,PR,Sul,FIOCRUZ/ASTRAZENECA,3076,2940,136
Três Barras Do Paraná,412785,PR,Sul,BUTANTAN/SINOVAC,2093,1109,984
Três Barras Do Paraná,412785,PR,Sul,PFIZER/BIONTECH,146,146,0
Três Cachoeiras,432166,RS,Sul,BUTANTAN/SINOVAC,3333,1688,1645
Três Cachoeiras,432166,RS,Sul,FIOCRUZ/ASTRAZENECA,3054,2868,186
Três Cachoeiras,432166,RS,Sul,PFIZER/BIONTECH,438,438,0
Três Corações,316930,MG,Sudeste,BUTANTAN/SINOVAC,13156,6829,6327
Três Corações,316930,MG,Sudeste,FIOCRUZ/ASTRAZENECA,11045,9839,1206
Três Corações,316930,MG,Sudeste,PFIZER/BIONTECH,738,737,1
Três Coroas,432170,RS,Sul,BUTANTAN/SINOVAC,5529,2821,2708
Três Coroas,432170,RS,Sul,FIOCRUZ/ASTRAZENECA,4956,4775,181
Três Coroas,432170,RS,Sul,PFIZER/BIONTECH,486,486,0
Três De Maio,432180,RS,Sul,BUTANTAN/SINOVAC,9010,4758,4252
Três De Maio,432180,RS,Sul,FIOCRUZ/ASTRAZENECA,6581,6022,559
Três De Maio,432180,RS,Sul,PFIZER/BIONTECH,650,649,1
Três Forquilhas,432183,RS,Sul,BUTANTAN/SINOVAC,941,482,459
Três Forquilhas,432183,RS,Sul,FIOCRUZ/ASTRAZENECA,926,866,60
Três Forquilhas,432183,RS,Sul,PFIZER/BIONTECH,104,104,0
Três Fronteiras,355490,SP,Sudeste,BUTANTAN/SINOVAC,1886,1104,782
Três Fronteiras,355490,SP,Sudeste,FIOCRUZ/ASTRAZENECA,1687,1509,178
Três Fronteiras,355490,SP,Sudeste,PFIZER/BIONTECH,14,14,0
Três Lagoas,500830,MS,Centro-Oeste,FIOCRUZ/ASTRAZENECA,31164,27311,3853
Três Lagoas,500830,MS,Centro-Oeste,BUTANTAN/SINOVAC,21589,12054,9535
Três Lagoas,500830,MS,Centro-Oeste,PFIZER/BIONTECH,4104,4095,9
Três Marias,316935,MG,Sudeste,FIOCRUZ/ASTRAZENECA,5188,4861,327
Três Marias,316935,MG,Sudeste,BUTANTAN/SINOVAC,4591,2428,2163
Três Marias,316935,MG,Sudeste,PFIZER/BIONTECH,571,571,0
Três Palmeiras,432185,RS,Sul,BUTANTAN/SINOVAC,1870,982,888
Três Palmeiras,432185,RS,Sul,FIOCRUZ/ASTRAZENECA,1187,1107,80
Três Palmeiras,432185,RS,Sul,PFIZER/BIONTECH,128,128,0
Três Passos,432190,RS,Sul,BUTANTAN/SINOVAC,9379,4725,4654
Três Passos,432190,RS,Sul,FIOCRUZ/ASTRAZENECA,6881,6212,669
Três Passos,432190,RS,Sul,PFIZER/BIONTECH,828,828,0
Três Pontas,316940,MG,Sudeste,FIOCRUZ/ASTRAZENECA,11655,10632,1023
Três Pontas,316940,MG,Sudeste,BUTANTAN/SINOVAC,10965,5625,5340
Três Pontas,316940,MG,Sudeste,PFIZER/BIONTECH,1274,1273,1
Três Ranchos,522130,GO,Centro-Oeste,FIOCRUZ/ASTRAZENECA,903,863,40
Três Ranchos,522130,GO,Centro-Oeste,BUTANTAN/SINOVAC,538,283,255
Três Rios,330600,RJ,Sudeste,BUTANTAN/SINOVAC,21188,12084,9104
Três Rios,330600,RJ,Sudeste,FIOCRUZ/ASTRAZENECA,12230,11239,991
Três Rios,330600,RJ,Sudeste,PFIZER/BIONTECH,331,331,0
Treviso,421835,SC,Sul,FIOCRUZ/ASTRAZENECA,1206,1056,150
Treviso,421835,SC,Sul,BUTANTAN/SINOVAC,870,439,431
Treviso,421835,SC,Sul,PFIZER/BIONTECH,143,143,0
Treze De Maio,421840,SC,Sul,BUTANTAN/SINOVAC,1972,1140,832
Treze De Maio,421840,SC,Sul,FIOCRUZ/ASTRAZENECA,1841,1681,160
Treze De Maio,421840,SC,Sul,PFIZER/BIONTECH,82,82,0
Treze Tílias,421850,SC,Sul,FIOCRUZ/ASTRAZENECA,1553,1439,114
Treze Tílias,421850,SC,Sul,BUTANTAN/SINOVAC,1260,690,570
Treze Tílias,421850,SC,Sul,PFIZER/BIONTECH,165,165,0
Trindade,261560,PE,Nordeste,FIOCRUZ/ASTRAZENECA,4379,4062,317
Trindade,261560,PE,Nordeste,BUTANTAN/SINOVAC,4043,2109,1934
Trindade,261560,PE,Nordeste,PFIZER/BIONTECH,551,551,0
Trindade,522140,GO,Centro-Oeste,FIOCRUZ/ASTRAZENECA,24798,22874,1924
Trindade,522140,GO,Centro-Oeste,BUTANTAN/SINOVAC,21002,11092,9910
Trindade,522140,GO,Centro-Oeste,PFIZER/BIONTECH,5518,5515,3
Trindade Do Sul,432195,RS,Sul,FIOCRUZ/ASTRAZENECA,1933,1792,141
Trindade Do Sul,432195,RS,Sul,BUTANTAN/SINOVAC,1857,969,888
Trindade Do Sul,432195,RS,Sul,PFIZER/BIONTECH,190,190,0
Triunfo,251680,PB,Nordeste,BUTANTAN/SINOVAC,2380,1250,1130
Triunfo,251680,PB,Nordeste,FIOCRUZ/ASTRAZENECA,1493,1414,79
Triunfo,261570,PE,Nordeste,FIOCRUZ/ASTRAZENECA,4224,3729,495
Triunfo,261570,PE,Nordeste,BUTANTAN/SINOVAC,3344,1845,1499
Triunfo,261570,PE,Nordeste,PFIZER/BIONTECH,437,437,0
Triunfo,432200,RS,Sul,FIOCRUZ/ASTRAZENECA,7037,6505,532
Triunfo,432200,RS,Sul,BUTANTAN/SINOVAC,5957,2954,3003
Triunfo,432200,RS,Sul,PFIZER/BIONTECH,572,572,0
Triunfo Potiguar,241445,RN,Nordeste,BUTANTAN/SINOVAC,855,470,385
Triunfo Potiguar,241445,RN,Nordeste,FIOCRUZ/ASTRAZENECA,482,455,27
Triunfo Potiguar,241445,RN,Nordeste,PFIZER/BIONTECH,71,71,0
Trizidela Do Vale,211223,MA,Nordeste,FIOCRUZ/ASTRAZENECA,3656,3358,298
Trizidela Do Vale,211223,MA,Nordeste,BUTANTAN/SINOVAC,3494,1913,1581
Trombas,522145,GO,Centro-Oeste,FIOCRUZ/ASTRAZENECA,1275,1210,65
Trombas,522145,GO,Centro-Oeste,BUTANTAN/SINOVAC,629,335,294
Trombudo Central,421860,SC,Sul,FIOCRUZ/ASTRAZENECA,1800,1631,169
Trombudo Central,421860,SC,Sul,BUTANTAN/SINOVAC,1633,866,767
Trombudo Central,421860,SC,Sul,PFIZER/BIONTECH,171,171,0
Tubarão,421870,SC,Sul,BUTANTAN/SINOVAC,26222,13638,12584
Tubarão,421870,SC,Sul,FIOCRUZ/ASTRAZENECA,18676,16790,1886
Tubarão,421870,SC,Sul,PFIZER/BIONTECH,5295,5292,3
Tucano,293190,BA,Nordeste,FIOCRUZ/ASTRAZENECA,10220,9243,977
Tucano,293190,BA,Nordeste,BUTANTAN/SINOVAC,9867,5242,4625
Tucano,293190,BA,Nordeste,PFIZER/BIONTECH,1924,1922,2
Tucumã,150808,PA,Norte,FIOCRUZ/ASTRAZENECA,3716,2500,1216
Tucumã,150808,PA,Norte,BUTANTAN/SINOVAC,3404,1773,1631
Tucunduva,432210,RS,Sul,BUTANTAN/SINOVAC,2188,1093,1095
Tucunduva,432210,RS,Sul,FIOCRUZ/ASTRAZENECA,1536,1386,150
Tucunduva,432210,RS,Sul,PFIZER/BIONTECH,162,162,0
Tucuruí,150810,PA,Norte,FIOCRUZ/ASTRAZENECA,16967,15617,1350
Tucuruí,150810,PA,Norte,BUTANTAN/SINOVAC,7122,3807,3315
Tufilândia,211227,MA,Nordeste,FIOCRUZ/ASTRAZENECA,1395,1293,102
Tufilândia,211227,MA,Nordeste,BUTANTAN/SINOVAC,1056,561,495
Tuiuti,355495,SP,Sudeste,BUTANTAN/SINOVAC,1925,1048,877
Tuiuti,355495,SP,Sudeste,FIOCRUZ/ASTRAZENECA,1587,1445,142
Tuiuti,355495,SP,Sudeste,PFIZER/BIONTECH,130,130,0
Tumiritinga,316950,MG,Sudeste,FIOCRUZ/ASTRAZENECA,1373,1265,108
Tumiritinga,316950,MG,Sudeste,BUTANTAN/SINOVAC,1313,654,659
Tumiritinga,316950,MG,Sudeste,PFIZER/BIONTECH,34,34,0
Tunápolis,421875,SC,Sul,FIOCRUZ/ASTRAZENECA,1418,1303,115
Tunápolis,421875,SC,Sul,BUTANTAN/SINOVAC,1315,680,635
Tunápolis,421875,SC,Sul,PFIZER/BIONTECH,133,133,0
Tunas,432215,RS,Sul,FIOCRUZ/ASTRAZENECA,969,898,71
Tunas,432215,RS,Sul,BUTANTAN/SINOVAC,835,426,409
Tunas,432215,RS,Sul,PFIZER/BIONTECH,65,65,0
Tunas Do Paraná,412788,PR,Sul,FIOCRUZ/ASTRAZENECA,1043,971,72
Tunas Do Paraná,412788,PR,Sul,BUTANTAN/SINOVAC,861,473,388
Tuneiras Do Oeste,412790,PR,Sul,FIOCRUZ/ASTRAZENECA,2487,2334,153
Tuneiras Do Oeste,412790,PR,Sul,BUTANTAN/SINOVAC,1744,910,834
Tuneiras Do Oeste,412790,PR,Sul,PFIZER/BIONTECH,104,104,0
Tuntum,211230,MA,Nordeste,FIOCRUZ/ASTRAZENECA,7358,6785,573
Tuntum,211230,MA,Nordeste,BUTANTAN/SINOVAC,6849,3641,3208
Tupã,355500,SP,Sudeste,BUTANTAN/SINOVAC,36518,20973,15545
Tupã,355500,SP,Sudeste,FIOCRUZ/ASTRAZENECA,22225,20158,2067
Tupã,355500,SP,Sudeste,PFIZER/BIONTECH,1451,1441,10
Tupaciguara,316960,MG,Sudeste,FIOCRUZ/ASTRAZENECA,7093,6536,557
Tupaciguara,316960,MG,Sudeste,BUTANTAN/SINOVAC,7004,3538,3466
Tupaciguara,316960,MG,Sudeste,PFIZER/BIONTECH,385,385,0
Tupanatinga,261580,PE,Nordeste,FIOCRUZ/ASTRAZENECA,4296,3819,477
Tupanatinga,261580,PE,Nordeste,BUTANTAN/SINOVAC,3232,1670,1562
Tupanatinga,261580,PE,Nordeste,PFIZER/BIONTECH,129,129,0
Tupanci Do Sul,432218,RS,Sul,FIOCRUZ/ASTRAZENECA,502,443,59
Tupanci Do Sul,432218,RS,Sul,BUTANTAN/SINOVAC,445,223,222
Tupanci Do Sul,432218,RS,Sul,PFIZER/BIONTECH,76,76,0
Tupanciretã,432220,RS,Sul,FIOCRUZ/ASTRAZENECA,6846,6266,580
Tupanciretã,432220,RS,Sul,BUTANTAN/SINOVAC,5286,2680,2606
Tupanciretã,432220,RS,Sul,PFIZER/BIONTECH,822,822,0
Tupandi,432225,RS,Sul,FIOCRUZ/ASTRAZENECA,982,913,69
Tupandi,432225,RS,Sul,BUTANTAN/SINOVAC,857,431,426
Tupandi,432225,RS,Sul,PFIZER/BIONTECH,157,157,0
Tuparendi,432230,RS,Sul,BUTANTAN/SINOVAC,3573,1796,1777
Tuparendi,432230,RS,Sul,FIOCRUZ/ASTRAZENECA,2585,2319,266
Tuparendi,432230,RS,Sul,PFIZER/BIONTECH,332,332,0
Tuparetama,261590,PE,Nordeste,BUTANTAN/SINOVAC,2634,1328,1306
Tuparetama,261590,PE,Nordeste,FIOCRUZ/ASTRAZENECA,1770,1525,245
Tuparetama,261590,PE,Nordeste,PFIZER/BIONTECH,143,143,0
Tupãssi,412795,PR,Sul,BUTANTAN/SINOVAC,2400,1223,1177
Tupãssi,412795,PR,Sul,FIOCRUZ/ASTRAZENECA,2028,1892,136
Tupãssi,412795,PR,Sul,PFIZER/BIONTECH,110,110,0
Tupi Paulista,355510,SP,Sudeste,BUTANTAN/SINOVAC,5230,2806,2424
Tupi Paulista,355510,SP,Sudeste,FIOCRUZ/ASTRAZENECA,3890,3343,547
Tupi Paulista,355510,SP,Sudeste,PFIZER/BIONTECH,197,197,0
Tupirama,172125,TO,Norte,BUTANTAN/SINOVAC,381,208,173
Tupirama,172125,TO,Norte,FIOCRUZ/ASTRAZENECA,303,282,21
Tupiratins,172130,TO,Norte,BUTANTAN/SINOVAC,440,230,210
Tupiratins,172130,TO,Norte,FIOCRUZ/ASTRAZENECA,408,380,28
Turiaçu,211240,MA,Nordeste,FIOCRUZ/ASTRAZENECA,6841,6567,274
Turiaçu,211240,MA,Nordeste,BUTANTAN/SINOVAC,3763,1951,1812
Turilândia,211245,MA,Nordeste,FIOCRUZ/ASTRAZENECA,3403,3124,279
Turilândia,211245,MA,Nordeste,BUTANTAN/SINOVAC,2346,1259,1087
Turiúba,355520,SP,Sudeste,BUTANTAN/SINOVAC,802,428,374
Turiúba,355520,SP,Sudeste,FIOCRUZ/ASTRAZENECA,559,518,41
Turiúba,355520,SP,Sudeste,PFIZER/BIONTECH,81,81,0
Turmalina,316970,MG,Sudeste,FIOCRUZ/ASTRAZENECA,5750,5365,385
Turmalina,316970,MG,Sudeste,BUTANTAN/SINOVAC,3908,2072,1836
Turmalina,316970,MG,Sudeste,PFIZER/BIONTECH,365,364,1
Turmalina,355530,SP,Sudeste,BUTANTAN/SINOVAC,924,524,400
Turmalina,355530,SP,Sudeste,FIOCRUZ/ASTRAZENECA,750,679,71
Turmalina,355530,SP,Sudeste,PFIZER/BIONTECH,72,72,0
Turuçu,432232,RS,Sul,BUTANTAN/SINOVAC,1066,535,531
Turuçu,432232,RS,Sul,FIOCRUZ/ASTRAZENECA,1050,953,97
Turuçu,432232,RS,Sul,PFIZER/BIONTECH,121,121,0
Tururu,231355,CE,Nordeste,BUTANTAN/SINOVAC,2623,1526,1097
Tururu,231355,CE,Nordeste,FIOCRUZ/ASTRAZENECA,2618,2493,125
Tururu,231355,CE,Nordeste,PFIZER/BIONTECH,1,0,1
Turvânia,522150,GO,Centro-Oeste,FIOCRUZ/ASTRAZENECA,1373,1276,97
Turvânia,522150,GO,Centro-Oeste,BUTANTAN/SINOVAC,1176,620,556
Turvelândia,522155,GO,Centro-Oeste,BUTANTAN/SINOVAC,710,361,349
Turvelândia,522155,GO,Centro-Oeste,FIOCRUZ/ASTRAZENECA,529,483,46
Turvo,412796,PR,Sul,FIOCRUZ/ASTRAZENECA,3469,3301,168
Turvo,412796,PR,Sul,BUTANTAN/SINOVAC,2979,1568,1411
Turvo,412796,PR,Sul,PFIZER/BIONTECH,165,165,0
Turvo,421880,SC,Sul,FIOCRUZ/ASTRAZENECA,2622,2480,142
Turvo,421880,SC,Sul,BUTANTAN/SINOVAC,2620,1335,1285
Turvo,421880,SC,Sul,PFIZER/BIONTECH,112,112,0
Turvolândia,316980,MG,Sudeste,BUTANTAN/SINOVAC,290,174,116
Turvolândia,316980,MG,Sudeste,FIOCRUZ/ASTRAZENECA,124,92,32
Tutóia,211250,MA,Nordeste,FIOCRUZ/ASTRAZENECA,11884,11438,446
Tutóia,211250,MA,Nordeste,BUTANTAN/SINOVAC,6228,3308,2920
Uarini,130426,AM,Norte,BUTANTAN/SINOVAC,1741,1088,653
Uarini,130426,AM,Norte,FIOCRUZ/ASTRAZENECA,1212,1049,163
Uauá,293200,BA,Nordeste,FIOCRUZ/ASTRAZENECA,6476,5980,496
Uauá,293200,BA,Nordeste,BUTANTAN/SINOVAC,5761,2947,2814
Uauá,293200,BA,Nordeste,PFIZER/BIONTECH,223,223,0
Ubá,316990,MG,Sudeste,BUTANTAN/SINOVAC,21890,11295,10595
Ubá,316990,MG,Sudeste,FIOCRUZ/ASTRAZENECA,19421,18086,1335
Ubá,316990,MG,Sudeste,PFIZER/BIONTECH,3198,3194,4
Ubaí,317000,MG,Sudeste,BUTANTAN/SINOVAC,1938,1270,668
Ubaí,317000,MG,Sudeste,FIOCRUZ/ASTRAZENECA,806,717,89
Ubaí,317000,MG,Sudeste,PFIZER/BIONTECH,90,90,0
Ubaíra,293210,BA,Nordeste,BUTANTAN/SINOVAC,2521,1387,1134
Ubaíra,293210,BA,Nordeste,FIOCRUZ/ASTRAZENECA,1498,1378,120
Ubaíra,293210,BA,Nordeste,PFIZER/BIONTECH,186,186,0
Ubaitaba,293220,BA,Nordeste,FIOCRUZ/ASTRAZENECA,4363,4030,333
Ubaitaba,293220,BA,Nordeste,BUTANTAN/SINOVAC,3537,1975,1562
Ubaitaba,293220,BA,Nordeste,PFIZER/BIONTECH,440,439,1
Ubajara,231360,CE,Nordeste,BUTANTAN/SINOVAC,4562,2506,2056
Ubajara,231360,CE,Nordeste,FIOCRUZ/ASTRAZENECA,3784,3519,265
Ubaporanga,317005,MG,Sudeste,BUTANTAN/SINOVAC,1802,964,838
Ubaporanga,317005,MG,Sudeste,FIOCRUZ/ASTRAZENECA,1342,1281,61
Ubarana,355535,SP,Sudeste,FIOCRUZ/ASTRAZENECA,1144,1074,70
Ubarana,355535,SP,Sudeste,BUTANTAN/SINOVAC,1014,569,445
Ubarana,355535,SP,Sudeste,PFIZER/BIONTECH,152,152,0
Ubatã,293230,BA,Nordeste,BUTANTAN/SINOVAC,3842,2062,1780
Ubatã,293230,BA,Nordeste,FIOCRUZ/ASTRAZENECA,3136,2908,228
Ubatã,293230,BA,Nordeste,PFIZER/BIONTECH,1,1,0
Ubatuba,355540,SP,Sudeste,BUTANTAN/SINOVAC,21894,12437,9457
Ubatuba,355540,SP,Sudeste,FIOCRUZ/ASTRAZENECA,19713,18473,1240
Ubatuba,355540,SP,Sudeste,PFIZER/BIONTECH,2168,2166,2
Uberaba,317010,MG,Sudeste,BUTANTAN/SINOVAC,66163,34254,31909
Uberaba,317010,MG,Sudeste,FIOCRUZ/ASTRAZENECA,57322,51624,5698
Uberaba,317010,MG,Sudeste,PFIZER/BIONTECH,5243,5241,2
Uberlândia,317020,MG,Sudeste,BUTANTAN/SINOVAC,206733,115229,91504
Uberlândia,317020,MG,Sudeste,FIOCRUZ/ASTRAZENECA,132742,123433,9309
Uberlândia,317020,MG,Sudeste,PFIZER/BIONTECH,13256,13256,0
Ubirajara,355550,SP,Sudeste,FIOCRUZ/ASTRAZENECA,1029,939,90
Ubirajara,355550,SP,Sudeste,BUTANTAN/SINOVAC,402,194,208
Ubirajara,355550,SP,Sudeste,PFIZER/BIONTECH,96,96,0
Ubiratã,412800,PR,Sul,FIOCRUZ/ASTRAZENECA,8248,7705,543
Ubiratã,412800,PR,Sul,BUTANTAN/SINOVAC,6283,3125,3158
Ubiratã,412800,PR,Sul,PFIZER/BIONTECH,655,654,1
Ubiretama,432234,RS,Sul,FIOCRUZ/ASTRAZENECA,664,609,55
Ubiretama,432234,RS,Sul,BUTANTAN/SINOVAC,587,286,301
Ubiretama,432234,RS,Sul,PFIZER/BIONTECH,83,83,0
Uchoa,355560,SP,Sudeste,BUTANTAN/SINOVAC,3133,1804,1329
Uchoa,355560,SP,Sudeste,FIOCRUZ/ASTRAZENECA,2404,2119,285
Uchoa,355560,SP,Sudeste,PFIZER/BIONTECH,217,217,0
Uibaí,293240,BA,Nordeste,FIOCRUZ/ASTRAZENECA,3487,3129,358
Uibaí,293240,BA,Nordeste,BUTANTAN/SINOVAC,2882,1491,1391
Uibaí,293240,BA,Nordeste,PFIZER/BIONTECH,113,113,0
Uiramutã,140070,RR,Norte,BUTANTAN/SINOVAC,7089,4149,2940
Uiramutã,140070,RR,Norte,FIOCRUZ/ASTRAZENECA,212,212,0
Uirapuru,522157,GO,Centro-Oeste,FIOCRUZ/ASTRAZENECA,1007,980,27
Uirapuru,522157,GO,Centro-Oeste,BUTANTAN/SINOVAC,1004,575,429
Uirapuru,522157,GO,Centro-Oeste,PFIZER/BIONTECH,18,18,0
Uiraúna,251690,PB,Nordeste,BUTANTAN/SINOVAC,3877,2061,1816
Uiraúna,251690,PB,Nordeste,FIOCRUZ/ASTRAZENECA,2946,2785,161
Uiraúna,251690,PB,Nordeste,PFIZER/BIONTECH,116,116,0
Ulianópolis,150812,PA,Norte,FIOCRUZ/ASTRAZENECA,4722,4285,437
Ulianópolis,150812,PA,Norte,BUTANTAN/SINOVAC,3781,2017,1764
Umari,231370,CE,Nordeste,BUTANTAN/SINOVAC,1814,927,887
Umari,231370,CE,Nordeste,FIOCRUZ/ASTRAZENECA,908,819,89
Umarizal,241450,RN,Nordeste,BUTANTAN/SINOVAC,2837,1522,1315
Umarizal,241450,RN,Nordeste,FIOCRUZ/ASTRAZENECA,2548,2422,126
Umarizal,241450,RN,Nordeste,PFIZER/BIONTECH,315,315,0
Umbaúba,280760,SE,Nordeste,BUTANTAN/SINOVAC,3399,1836,1563
Umbaúba,280760,SE,Nordeste,FIOCRUZ/ASTRAZENECA,773,773,0
Umburanas,293245,BA,Nordeste,FIOCRUZ/ASTRAZENECA,2756,2460,296
Umburanas,293245,BA,Nordeste,BUTANTAN/SINOVAC,2375,1201,1174
Umburanas,293245,BA,Nordeste,PFIZER/BIONTECH,145,144,1
Umburatiba,317030,MG,Sudeste,BUTANTAN/SINOVAC,827,418,409
Umburatiba,317030,MG,Sudeste,FIOCRUZ/ASTRAZENECA,615,557,58
Umburatiba,317030,MG,Sudeste,PFIZER/BIONTECH,1,1,0
Umbuzeiro,251700,PB,Nordeste,BUTANTAN/SINOVAC,2635,1341,1294
Umbuzeiro,251700,PB,Nordeste,FIOCRUZ/ASTRAZENECA,1938,1765,173
Umbuzeiro,251700,PB,Nordeste,PFIZER/BIONTECH,192,192,0
Umirim,231375,CE,Nordeste,BUTANTAN/SINOVAC,2555,1450,1105
Umirim,231375,CE,Nordeste,FIOCRUZ/ASTRAZENECA,867,658,209
Umuarama,412810,PR,Sul,BUTANTAN/SINOVAC,25402,13074,12328
Umuarama,412810,PR,Sul,FIOCRUZ/ASTRAZENECA,24718,21997,2721
Umuarama,412810,PR,Sul,PFIZER/BIONTECH,5605,5604,1
Una,293250,BA,Nordeste,BUTANTAN/SINOVAC,4716,2445,2271
Una,293250,BA,Nordeste,FIOCRUZ/ASTRAZENECA,4579,4308,271
Una,293250,BA,Nordeste,PFIZER/BIONTECH,140,140,0
Unaí,317040,MG,Sudeste,BUTANTAN/SINOVAC,14882,7769,7113
Unaí,317040,MG,Sudeste,FIOCRUZ/ASTRAZENECA,11950,10896,1054
Unaí,317040,MG,Sudeste,PFIZER/BIONTECH,1243,1242,1
União,221110,PI,Nordeste,BUTANTAN/SINOVAC,8570,4682,3888
União,221110,PI,Nordeste,FIOCRUZ/ASTRAZENECA,6747,6020,727
União Da Serra,432235,RS,Sul,BUTANTAN/SINOVAC,517,259,258
União Da Serra,432235,RS,Sul,FIOCRUZ/ASTRAZENECA,426,384,42
União Da Serra,432235,RS,Sul,PFIZER/BIONTECH,52,52,0
União Da Vitória,412820,PR,Sul,BUTANTAN/SINOVAC,11431,6091,5340
União Da Vitória,412820,PR,Sul,FIOCRUZ/ASTRAZENECA,10719,10094,625
União Da Vitória,412820,PR,Sul,PFIZER/BIONTECH,3389,3389,0
União De Minas,317043,MG,Sudeste,FIOCRUZ/ASTRAZENECA,989,907,82
União De Minas,317043,MG,Sudeste,BUTANTAN/SINOVAC,923,478,445
União De Minas,317043,MG,Sudeste,PFIZER/BIONTECH,89,89,0
União Do Oeste,421885,SC,Sul,BUTANTAN/SINOVAC,888,483,405
União Do Oeste,421885,SC,Sul,FIOCRUZ/ASTRAZENECA,825,748,77
União Do Oeste,421885,SC,Sul,PFIZER/BIONTECH,66,66,0
União Do Sul,510830,MT,Centro-Oeste,FIOCRUZ/ASTRAZENECA,747,717,30
União Do Sul,510830,MT,Centro-Oeste,BUTANTAN/SINOVAC,731,391,340
União Do Sul,510830,MT,Centro-Oeste,PFIZER/BIONTECH,8,8,0
União Dos Palmares,270930,AL,Nordeste,FIOCRUZ/ASTRAZENECA,12451,10691,1760
União Dos Palmares,270930,AL,Nordeste,BUTANTAN/SINOVAC,9562,4879,4683
União Dos Palmares,270930,AL,Nordeste,PFIZER/BIONTECH,1502,1502,0
União Paulista,355570,SP,Sudeste,BUTANTAN/SINOVAC,425,221,204
União Paulista,355570,SP,Sudeste,FIOCRUZ/ASTRAZENECA,386,350,36
União Paulista,355570,SP,Sudeste,PFIZER/BIONTECH,60,60,0
Uniflor,412830,PR,Sul,FIOCRUZ/ASTRAZENECA,838,778,60
Uniflor,412830,PR,Sul,BUTANTAN/SINOVAC,653,336,317
Uniflor,412830,PR,Sul,PFIZER/BIONTECH,12,12,0
Unistalda,432237,RS,Sul,FIOCRUZ/ASTRAZENECA,826,691,135
Unistalda,432237,RS,Sul,BUTANTAN/SINOVAC,801,405,396
Unistalda,432237,RS,Sul,PFIZER/BIONTECH,113,113,0
Upanema,241460,RN,Nordeste,FIOCRUZ/ASTRAZENECA,2990,2892,98
Upanema,241460,RN,Nordeste,BUTANTAN/SINOVAC,2829,1451,1378
Upanema,241460,RN,Nordeste,PFIZER/BIONTECH,302,298,4
Uraí,412840,PR,Sul,FIOCRUZ/ASTRAZENECA,4633,4359,274
Uraí,412840,PR,Sul,BUTANTAN/SINOVAC,3183,1636,1547
Uraí,412840,PR,Sul,PFIZER/BIONTECH,144,144,0
Urandi,293260,BA,Nordeste,BUTANTAN/SINOVAC,2312,1801,511
Urandi,293260,BA,Nordeste,FIOCRUZ/ASTRAZENECA,1338,1333,5
Urânia,355580,SP,Sudeste,BUTANTAN/SINOVAC,2823,1466,1357
Urânia,355580,SP,Sudeste,FIOCRUZ/ASTRAZENECA,2657,2394,263
Urânia,355580,SP,Sudeste,PFIZER/BIONTECH,226,226,0
Urbano Santos,211260,MA,Nordeste,FIOCRUZ/ASTRAZENECA,4250,3987,263
Urbano Santos,211260,MA,Nordeste,BUTANTAN/SINOVAC,3382,1779,1603
Uru,355590,SP,Sudeste,BUTANTAN/SINOVAC,841,487,354
Uru,355590,SP,Sudeste,FIOCRUZ/ASTRAZENECA,608,517,91
Uru,355590,SP,Sudeste,PFIZER/BIONTECH,57,57,0
Uruaçu,522160,GO,Centro-Oeste,FIOCRUZ/ASTRAZENECA,11813,11001,812
Uruaçu,522160,GO,Centro-Oeste,BUTANTAN/SINOVAC,8751,4595,4156
Uruana,522170,GO,Centro-Oeste,FIOCRUZ/ASTRAZENECA,4175,3983,192
Uruana,522170,GO,Centro-Oeste,BUTANTAN/SINOVAC,2571,1414,1157
Uruana,522170,GO,Centro-Oeste,PFIZER/BIONTECH,178,177,1
Uruana De Minas,317047,MG,Sudeste,FIOCRUZ/ASTRAZENECA,874,838,36
Uruana De Minas,317047,MG,Sudeste,BUTANTAN/SINOVAC,806,408,398
Uruana De Minas,317047,MG,Sudeste,PFIZER/BIONTECH,42,42,0
Uruará,150815,PA,Norte,BUTANTAN/SINOVAC,3419,1795,1624
Uruará,150815,PA,Norte,FIOCRUZ/ASTRAZENECA,3399,3172,227
Urubici,421890,SC,Sul,FIOCRUZ/ASTRAZENECA,2879,2664,215
Urubici,421890,SC,Sul,BUTANTAN/SINOVAC,2501,1343,1158
Urubici,421890,SC,Sul,PFIZER/BIONTECH,165,165,0
Uruburetama,231380,CE,Nordeste,FIOCRUZ/ASTRAZENECA,3224,2934,290
Uruburetama,231380,CE,Nordeste,BUTANTAN/SINOVAC,2958,1535,1423
Uruburetama,231380,CE,Nordeste,PFIZER/BIONTECH,257,257,0
Urucânia,317050,MG,Sudeste,FIOCRUZ/ASTRAZENECA,2394,2240,154
Urucânia,317050,MG,Sudeste,BUTANTAN/SINOVAC,2026,1041,985
Urucânia,317050,MG,Sudeste,PFIZER/BIONTECH,131,131,0
Urucará,130430,AM,Norte,FIOCRUZ/ASTRAZENECA,4792,4164,628
Urucará,130430,AM,Norte,BUTANTAN/SINOVAC,2260,1191,1069
Uruçuca,293270,BA,Nordeste,BUTANTAN/SINOVAC,4000,2090,1910
Uruçuca,293270,BA,Nordeste,FIOCRUZ/ASTRAZENECA,3884,3615,269
Uruçuca,293270,BA,Nordeste,PFIZER/BIONTECH,48,48,0
Uruçuí,221120,PI,Nordeste,FIOCRUZ/ASTRAZENECA,3108,2980,128
Uruçuí,221120,PI,Nordeste,BUTANTAN/SINOVAC,2020,1043,977
Urucuia,317052,MG,Sudeste,BUTANTAN/SINOVAC,2253,1141,1112
Urucuia,317052,MG,Sudeste,FIOCRUZ/ASTRAZENECA,2248,2074,174
Urucuia,317052,MG,Sudeste,PFIZER/BIONTECH,146,146,0
Urucurituba,130440,AM,Norte,BUTANTAN/SINOVAC,1474,853,621
Urucurituba,130440,AM,Norte,FIOCRUZ/ASTRAZENECA,1345,1023,322
Uruguaiana,432240,RS,Sul,FIOCRUZ/ASTRAZENECA,29677,27636,2041
Uruguaiana,432240,RS,Sul,BUTANTAN/SINOVAC,26108,13486,12622
Uruguaiana,432240,RS,Sul,PFIZER/BIONTECH,2905,2903,2
Uruoca,231390,CE,Nordeste,BUTANTAN/SINOVAC,2254,1188,1066
Uruoca,231390,CE,Nordeste,FIOCRUZ/ASTRAZENECA,1547,1392,155
Uruoca,231390,CE,Nordeste,PFIZER/BIONTECH,6,6,0
Urupá,110170,RO,Norte,BUTANTAN/SINOVAC,2527,1493,1034
Urupá,110170,RO,Norte,FIOCRUZ/ASTRAZENECA,2378,2298,80
Urupá,110170,RO,Norte,PFIZER/BIONTECH,177,177,0
Urupema,421895,SC,Sul,BUTANTAN/SINOVAC,809,415,394
Urupema,421895,SC,Sul,FIOCRUZ/ASTRAZENECA,768,709,59
Urupema,421895,SC,Sul,PFIZER/BIONTECH,31,31,0
Urupês,355600,SP,Sudeste,BUTANTAN/SINOVAC,3721,2084,1637
Urupês,355600,SP,Sudeste,FIOCRUZ/ASTRAZENECA,3517,3184,333
Urupês,355600,SP,Sudeste,PFIZER/BIONTECH,348,347,1
Urussanga,421900,SC,Sul,FIOCRUZ/ASTRAZENECA,7029,6358,671
Urussanga,421900,SC,Sul,BUTANTAN/SINOVAC,5662,3592,2070
Urussanga,421900,SC,Sul,PFIZER/BIONTECH,382,382,0
Urutaí,522180,GO,Centro-Oeste,FIOCRUZ/ASTRAZENECA,1106,959,147
Urutaí,522180,GO,Centro-Oeste,BUTANTAN/SINOVAC,635,330,305
Utinga,293280,BA,Nordeste,FIOCRUZ/ASTRAZENECA,3900,3648,252
Utinga,293280,BA,Nordeste,BUTANTAN/SINOVAC,3312,1699,1613
Utinga,293280,BA,Nordeste,PFIZER/BIONTECH,39,39,0
Vacaria,432250,RS,Sul,FIOCRUZ/ASTRAZENECA,16479,15147,1332
Vacaria,432250,RS,Sul,BUTANTAN/SINOVAC,14758,7458,7300
Vacaria,432250,RS,Sul,PFIZER/BIONTECH,634,634,0
Vale De São Domingos,510835,MT,Centro-Oeste,FIOCRUZ/ASTRAZENECA,661,622,39
Vale De São Domingos,510835,MT,Centro-Oeste,BUTANTAN/SINOVAC,599,302,297
Vale De São Domingos,510835,MT,Centro-Oeste,PFIZER/BIONTECH,16,16,0
Vale Do Anari,110175,RO,Norte,FIOCRUZ/ASTRAZENECA,1721,1696,25
Vale Do Anari,110175,RO,Norte,BUTANTAN/SINOVAC,1651,841,810
Vale Do Anari,110175,RO,Norte,PFIZER/BIONTECH,47,47,0
Vale Do Paraíso,110180,RO,Norte,BUTANTAN/SINOVAC,1463,750,713
Vale Do Paraíso,110180,RO,Norte,FIOCRUZ/ASTRAZENECA,767,725,42
Vale Do Paraíso,110180,RO,Norte,PFIZER/BIONTECH,19,19,0
Vale Do Sol,432253,RS,Sul,FIOCRUZ/ASTRAZENECA,2887,2666,221
Vale Do Sol,432253,RS,Sul,BUTANTAN/SINOVAC,2856,1429,1427
Vale Do Sol,432253,RS,Sul,PFIZER/BIONTECH,406,406,0
Vale Real,432254,RS,Sul,FIOCRUZ/ASTRAZENECA,1324,1235,89
Vale Real,432254,RS,Sul,BUTANTAN/SINOVAC,1016,513,503
Vale Real,432254,RS,Sul,PFIZER/BIONTECH,71,71,0
Vale Verde,432252,RS,Sul,FIOCRUZ/ASTRAZENECA,1097,893,204
Vale Verde,432252,RS,Sul,BUTANTAN/SINOVAC,1039,525,514
Vale Verde,432252,RS,Sul,PFIZER/BIONTECH,144,144,0
Valença,293290,BA,Nordeste,BUTANTAN/SINOVAC,11685,6121,5564
Valença,293290,BA,Nordeste,FIOCRUZ/ASTRAZENECA,11409,10663,746
Valença,293290,BA,Nordeste,PFIZER/BIONTECH,157,157,0
Valença,330610,RJ,Sudeste,BUTANTAN/SINOVAC,19919,10173,9746
Valença,330610,RJ,Sudeste,FIOCRUZ/ASTRAZENECA,14655,13628,1027
Valença Do Piauí,221130,PI,Nordeste,FIOCRUZ/ASTRAZENECA,5746,4739,1007
Valença Do Piauí,221130,PI,Nordeste,BUTANTAN/SINOVAC,5018,2539,2479
Valença Do Piauí,221130,PI,Nordeste,PFIZER/BIONTECH,136,136,0
Valente,293300,BA,Nordeste,FIOCRUZ/ASTRAZENECA,5873,5058,815
Valente,293300,BA,Nordeste,BUTANTAN/SINOVAC,5284,2769,2515
Valente,293300,BA,Nordeste,PFIZER/BIONTECH,980,980,0
Valentim Gentil,355610,SP,Sudeste,BUTANTAN/SINOVAC,2393,1259,1134
Valentim Gentil,355610,SP,Sudeste,FIOCRUZ/ASTRAZENECA,2168,1980,188
Valentim Gentil,355610,SP,Sudeste,PFIZER/BIONTECH,165,164,1
Valinhos,355620,SP,Sudeste,FIOCRUZ/ASTRAZENECA,30069,28224,1845
Valinhos,355620,SP,Sudeste,BUTANTAN/SINOVAC,28709,16839,11870
Valinhos,355620,SP,Sudeste,PFIZER/BIONTECH,1328,1328,0
Valparaíso,355630,SP,Sudeste,BUTANTAN/SINOVAC,5388,3004,2384
Valparaíso,355630,SP,Sudeste,FIOCRUZ/ASTRAZENECA,4794,4266,528
Valparaíso,355630,SP,Sudeste,PFIZER/BIONTECH,295,295,0
Valparaíso De Goiás,522185,GO,Centro-Oeste,FIOCRUZ/ASTRAZENECA,23261,22118,1143
Valparaíso De Goiás,522185,GO,Centro-Oeste,BUTANTAN/SINOVAC,15577,8096,7481
Vanini,432255,RS,Sul,FIOCRUZ/ASTRAZENECA,620,572,48
Vanini,432255,RS,Sul,BUTANTAN/SINOVAC,499,251,248
Vanini,432255,RS,Sul,PFIZER/BIONTECH,108,108,0
Vargeão,421910,SC,Sul,FIOCRUZ/ASTRAZENECA,963,861,102
Vargeão,421910,SC,Sul,BUTANTAN/SINOVAC,895,493,402
Vargeão,421910,SC,Sul,PFIZER/BIONTECH,64,64,0
Vargem,355635,SP,Sudeste,BUTANTAN/SINOVAC,2578,1384,1194
Vargem,355635,SP,Sudeste,FIOCRUZ/ASTRAZENECA,2054,1804,250
Vargem,355635,SP,Sudeste,PFIZER/BIONTECH,206,206,0
Vargem,421915,SC,Sul,FIOCRUZ/ASTRAZENECA,699,668,31
Vargem,421915,SC,Sul,BUTANTAN/SINOVAC,673,350,323
Vargem,421915,SC,Sul,PFIZER/BIONTECH,54,54,0
Vargem Alegre,317057,MG,Sudeste,BUTANTAN/SINOVAC,1461,741,720
Vargem Alegre,317057,MG,Sudeste,FIOCRUZ/ASTRAZENECA,363,314,49
Vargem Alta,320503,ES,Sudeste,BUTANTAN/SINOVAC,4739,2555,2184
Vargem Alta,320503,ES,Sudeste,FIOCRUZ/ASTRAZENECA,4051,3873,178
Vargem Alta,320503,ES,Sudeste,PFIZER/BIONTECH,636,636,0
Vargem Bonita,317060,MG,Sudeste,BUTANTAN/SINOVAC,609,323,286
Vargem Bonita,317060,MG,Sudeste,FIOCRUZ/ASTRAZENECA,606,544,62
Vargem Bonita,317060,MG,Sudeste,PFIZER/BIONTECH,33,33,0
Vargem Bonita,421917,SC,Sul,FIOCRUZ/ASTRAZENECA,1067,980,87
Vargem Bonita,421917,SC,Sul,BUTANTAN/SINOVAC,931,478,453
Vargem Bonita,421917,SC,Sul,PFIZER/BIONTECH,110,110,0
Vargem Grande,211270,MA,Nordeste,BUTANTAN/SINOVAC,4630,2673,1957
Vargem Grande,211270,MA,Nordeste,FIOCRUZ/ASTRAZENECA,3776,3443,333
Vargem Grande Do Rio Pardo,317065,MG,Sudeste,BUTANTAN/SINOVAC,847,441,406
Vargem Grande Do Rio Pardo,317065,MG,Sudeste,FIOCRUZ/ASTRAZENECA,671,645,26
Vargem Grande Do Rio Pardo,317065,MG,Sudeste,PFIZER/BIONTECH,102,102,0
Vargem Grande Do Sul,355640,SP,Sudeste,FIOCRUZ/ASTRAZENECA,11135,10052,1083
Vargem Grande Do Sul,355640,SP,Sudeste,BUTANTAN/SINOVAC,10106,5110,4996
Vargem Grande Do Sul,355640,SP,Sudeste,PFIZER/BIONTECH,647,647,0
Vargem Grande Paulista,355645,SP,Sudeste,BUTANTAN/SINOVAC,9012,5060,3952
Vargem Grande Paulista,355645,SP,Sudeste,FIOCRUZ/ASTRAZENECA,6562,6123,439
Vargem Grande Paulista,355645,SP,Sudeste,PFIZER/BIONTECH,462,462,0
Varginha,317070,MG,Sudeste,FIOCRUZ/ASTRAZENECA,27232,24613,2619
Varginha,317070,MG,Sudeste,BUTANTAN/SINOVAC,25120,12710,12410
Varginha,317070,MG,Sudeste,PFIZER/BIONTECH,1720,1720,0
Varjão,522190,GO,Centro-Oeste,FIOCRUZ/ASTRAZENECA,1314,1231,83
Varjão,522190,GO,Centro-Oeste,BUTANTAN/SINOVAC,973,526,447
Varjão De Minas,317075,MG,Sudeste,BUTANTAN/SINOVAC,1947,1028,919
Varjão De Minas,317075,MG,Sudeste,FIOCRUZ/ASTRAZENECA,1554,1455,99
Varjão De Minas,317075,MG,Sudeste,PFIZER/BIONTECH,208,208,0
Varjota,231395,CE,Nordeste,BUTANTAN/SINOVAC,2255,1615,640
Varjota,231395,CE,Nordeste,FIOCRUZ/ASTRAZENECA,1444,1415,29
Varre-Sai,330615,RJ,Sudeste,BUTANTAN/SINOVAC,1833,1032,801
Varre-Sai,330615,RJ,Sudeste,FIOCRUZ/ASTRAZENECA,643,574,69
Várzea,241470,RN,Nordeste,BUTANTAN/SINOVAC,1449,737,712
Várzea,241470,RN,Nordeste,FIOCRUZ/ASTRAZENECA,895,814,81
Várzea,241470,RN,Nordeste,PFIZER/BIONTECH,152,152,0
Várzea,251710,PB,Nordeste,FIOCRUZ/ASTRAZENECA,980,910,70
Várzea,251710,PB,Nordeste,BUTANTAN/SINOVAC,912,458,454
Várzea,251710,PB,Nordeste,PFIZER/BIONTECH,102,102,0
Várzea Alegre,231400,CE,Nordeste,BUTANTAN/SINOVAC,9300,5145,4155
Várzea Alegre,231400,CE,Nordeste,FIOCRUZ/ASTRAZENECA,2848,2293,555
Várzea Branca,221135,PI,Nordeste,FIOCRUZ/ASTRAZENECA,1220,1178,42
Várzea Branca,221135,PI,Nordeste,BUTANTAN/SINOVAC,778,403,375
Várzea Da Palma,317080,MG,Sudeste,FIOCRUZ/ASTRAZENECA,6717,6340,377
Várzea Da Palma,317080,MG,Sudeste,BUTANTAN/SINOVAC,5976,3028,2948
Várzea Da Palma,317080,MG,Sudeste,PFIZER/BIONTECH,403,403,0
Várzea Da Roça,293305,BA,Nordeste,BUTANTAN/SINOVAC,3025,1561,1464
Várzea Da Roça,293305,BA,Nordeste,FIOCRUZ/ASTRAZENECA,2634,2338,296
Várzea Da Roça,293305,BA,Nordeste,PFIZER/BIONTECH,179,179,0
Várzea Do Poço,293310,BA,Nordeste,BUTANTAN/SINOVAC,2216,1115,1101
Várzea Do Poço,293310,BA,Nordeste,FIOCRUZ/ASTRAZENECA,2040,1827,213
Várzea Do Poço,293310,BA,Nordeste,PFIZER/BIONTECH,183,183,0
Várzea Grande,221140,PI,Nordeste,BUTANTAN/SINOVAC,759,419,340
Várzea Grande,221140,PI,Nordeste,FIOCRUZ/ASTRAZENECA,607,562,45
Várzea Grande,510840,MT,Centro-Oeste,BUTANTAN/SINOVAC,41210,21321,19889
Várzea Grande,510840,MT,Centro-Oeste,FIOCRUZ/ASTRAZENECA,38951,36091,2860
Várzea Grande,510840,MT,Centro-Oeste,PFIZER/BIONTECH,9163,9148,15
Várzea Nova,293315,BA,Nordeste,BUTANTAN/SINOVAC,2863,1462,1401
Várzea Nova,293315,BA,Nordeste,FIOCRUZ/ASTRAZENECA,2522,2295,227
Várzea Nova,293315,BA,Nordeste,PFIZER/BIONTECH,35,35,0
Várzea Paulista,355650,SP,Sudeste,FIOCRUZ/ASTRAZENECA,16658,15733,925
Várzea Paulista,355650,SP,Sudeste,BUTANTAN/SINOVAC,14239,7745,6494
Várzea Paulista,355650,SP,Sudeste,PFIZER/BIONTECH,2667,2666,1
Varzedo,293317,BA,Nordeste,FIOCRUZ/ASTRAZENECA,1929,1706,223
Varzedo,293317,BA,Nordeste,BUTANTAN/SINOVAC,1851,964,887
Varzedo,293317,BA,Nordeste,PFIZER/BIONTECH,337,337,0
Varzelândia,317090,MG,Sudeste,FIOCRUZ/ASTRAZENECA,3662,3450,212
Varzelândia,317090,MG,Sudeste,BUTANTAN/SINOVAC,2911,1535,1376
Varzelândia,317090,MG,Sudeste,PFIZER/BIONTECH,90,90,0
Vassouras,330620,RJ,Sudeste,BUTANTAN/SINOVAC,5584,3307,2277
Vassouras,330620,RJ,Sudeste,FIOCRUZ/ASTRAZENECA,4098,3956,142
Vassouras,330620,RJ,Sudeste,PFIZER/BIONTECH,835,831,4
Vazante,317100,MG,Sudeste,FIOCRUZ/ASTRAZENECA,6919,6160,759
Vazante,317100,MG,Sudeste,BUTANTAN/SINOVAC,3949,2038,1911
Vazante,317100,MG,Sudeste,PFIZER/BIONTECH,329,329,0
Venâncio Aires,432260,RS,Sul,FIOCRUZ/ASTRAZENECA,17667,16112,1555
Venâncio Aires,432260,RS,Sul,BUTANTAN/SINOVAC,17508,9009,8499
Venâncio Aires,432260,RS,Sul,PFIZER/BIONTECH,2201,2200,1
Venda Nova Do Imigrante,320506,ES,Sudeste,BUTANTAN/SINOVAC,6464,3369,3095
Venda Nova Do Imigrante,320506,ES,Sudeste,FIOCRUZ/ASTRAZENECA,4769,4565,204
Venda Nova Do Imigrante,320506,ES,Sudeste,PFIZER/BIONTECH,1768,1767,1
Venha-Ver,241475,RN,Nordeste,BUTANTAN/SINOVAC,807,417,390
Venha-Ver,241475,RN,Nordeste,FIOCRUZ/ASTRAZENECA,572,552,20
Venha-Ver,241475,RN,Nordeste,PFIZER/BIONTECH,47,47,0
Ventania,412853,PR,Sul,FIOCRUZ/ASTRAZENECA,2331,2218,113
Ventania,412853,PR,Sul,BUTANTAN/SINOVAC,1910,1006,904
Ventania,412853,PR,Sul,PFIZER/BIONTECH,129,129,0
Venturosa,261600,PE,Nordeste,BUTANTAN/SINOVAC,3014,1531,1483
Venturosa,261600,PE,Nordeste,FIOCRUZ/ASTRAZENECA,2671,2444,227
Venturosa,261600,PE,Nordeste,PFIZER/BIONTECH,195,195,0
Vera,510850,MT,Centro-Oeste,FIOCRUZ/ASTRAZENECA,1879,1828,51
Vera,510850,MT,Centro-Oeste,BUTANTAN/SINOVAC,1561,808,753
Vera,510850,MT,Centro-Oeste,PFIZER/BIONTECH,224,224,0
Vera Cruz,241480,RN,Nordeste,BUTANTAN/SINOVAC,2216,1155,1061
Vera Cruz,241480,RN,Nordeste,FIOCRUZ/ASTRAZENECA,1721,1613,108
Vera Cruz,241480,RN,Nordeste,PFIZER/BIONTECH,355,355,0
Vera Cruz,293320,BA,Nordeste,BUTANTAN/SINOVAC,5110,3828,1282
Vera Cruz,293320,BA,Nordeste,FIOCRUZ/ASTRAZENECA,2702,2620,82
Vera Cruz,293320,BA,Nordeste,PFIZER/BIONTECH,222,222,0
Vera Cruz,355660,SP,Sudeste,BUTANTAN/SINOVAC,3339,1925,1414
Vera Cruz,355660,SP,Sudeste,FIOCRUZ/ASTRAZENECA,2569,2278,291
Vera Cruz,355660,SP,Sudeste,PFIZER/BIONTECH,237,237,0
Vera Cruz,432270,RS,Sul,BUTANTAN/SINOVAC,6971,3605,3366
Vera Cruz,432270,RS,Sul,FIOCRUZ/ASTRAZENECA,5233,4996,237
Vera Cruz,432270,RS,Sul,PFIZER/BIONTECH,271,271,0
Vera Cruz Do Oeste,412855,PR,Sul,FIOCRUZ/ASTRAZENECA,2721,2575,146
Vera Cruz Do Oeste,412855,PR,Sul,BUTANTAN/SINOVAC,2037,1098,939
Vera Cruz Do Oeste,412855,PR,Sul,PFIZER/BIONTECH,118,118,0
Vera Mendes,221150,PI,Nordeste,FIOCRUZ/ASTRAZENECA,923,913,10
Vera Mendes,221150,PI,Nordeste,BUTANTAN/SINOVAC,801,453,348
Veranópolis,432280,RS,Sul,FIOCRUZ/ASTRAZENECA,7237,6153,1084
Veranópolis,432280,RS,Sul,BUTANTAN/SINOVAC,7001,3534,3467
Veranópolis,432280,RS,Sul,PFIZER/BIONTECH,607,607,0
Verdejante,261610,PE,Nordeste,FIOCRUZ/ASTRAZENECA,2432,2213,219
Verdejante,261610,PE,Nordeste,BUTANTAN/SINOVAC,2125,1074,1051
Verdejante,261610,PE,Nordeste,PFIZER/BIONTECH,136,136,0
Verdelândia,317103,MG,Sudeste,FIOCRUZ/ASTRAZENECA,2037,1973,64
Verdelândia,317103,MG,Sudeste,BUTANTAN/SINOVAC,1090,559,531
Verdelândia,317103,MG,Sudeste,PFIZER/BIONTECH,25,25,0
Verê,412860,PR,Sul,FIOCRUZ/ASTRAZENECA,2314,2212,102
Verê,412860,PR,Sul,BUTANTAN/SINOVAC,1921,985,936
Verê,412860,PR,Sul,PFIZER/BIONTECH,113,113,0
Vereda,293325,BA,Nordeste,BUTANTAN/SINOVAC,1609,825,784
Vereda,293325,BA,Nordeste,FIOCRUZ/ASTRAZENECA,1126,1019,107
Vereda,293325,BA,Nordeste,PFIZER/BIONTECH,59,59,0
Veredinha,317107,MG,Sudeste,FIOCRUZ/ASTRAZENECA,1369,1247,122
Veredinha,317107,MG,Sudeste,BUTANTAN/SINOVAC,1095,556,539
Veredinha,317107,MG,Sudeste,PFIZER/BIONTECH,200,200,0
Veríssimo,317110,MG,Sudeste,FIOCRUZ/ASTRAZENECA,1042,977,65
Veríssimo,317110,MG,Sudeste,BUTANTAN/SINOVAC,921,479,442
Veríssimo,317110,MG,Sudeste,PFIZER/BIONTECH,64,64,0
Vermelho Novo,317115,MG,Sudeste,BUTANTAN/SINOVAC,1405,705,700
Vermelho Novo,317115,MG,Sudeste,FIOCRUZ/ASTRAZENECA,879,701,178
Vertente Do Lério,261618,PE,Nordeste,FIOCRUZ/ASTRAZENECA,1831,1668,163
Vertente Do Lério,261618,PE,Nordeste,BUTANTAN/SINOVAC,1732,866,866
Vertente Do Lério,261618,PE,Nordeste,PFIZER/BIONTECH,215,215,0
Vertentes,261620,PE,Nordeste,BUTANTAN/SINOVAC,3256,1743,1513
Vertentes,261620,PE,Nordeste,FIOCRUZ/ASTRAZENECA,3201,2878,323
Vertentes,261620,PE,Nordeste,PFIZER/BIONTECH,237,237,0
Vespasiano,317120,MG,Sudeste,BUTANTAN/SINOVAC,12387,7187,5200
Vespasiano,317120,MG,Sudeste,FIOCRUZ/ASTRAZENECA,12111,11610,501
Vespasiano,317120,MG,Sudeste,PFIZER/BIONTECH,691,689,2
Vespasiano Correa,432285,RS,Sul,BUTANTAN/SINOVAC,839,427,412
Vespasiano Correa,432285,RS,Sul,FIOCRUZ/ASTRAZENECA,566,478,88
Vespasiano Correa,432285,RS,Sul,PFIZER/BIONTECH,72,72,0
Viadutos,432290,RS,Sul,BUTANTAN/SINOVAC,1789,902,887
Viadutos,432290,RS,Sul,FIOCRUZ/ASTRAZENECA,1554,1330,224
Viadutos,432290,RS,Sul,PFIZER/BIONTECH,210,210,0
Viamão,432300,RS,Sul,BUTANTAN/SINOVAC,58854,29576,29278
Viamão,432300,RS,Sul,FIOCRUZ/ASTRAZENECA,57405,53937,3468
Viamão,432300,RS,Sul,PFIZER/BIONTECH,5199,5173,26
Viana,211280,MA,Nordeste,FIOCRUZ/ASTRAZENECA,13733,12872,861
Viana,211280,MA,Nordeste,BUTANTAN/SINOVAC,7505,4004,3501
Viana,211280,MA,Nordeste,PFIZER/BIONTECH,267,267,0
Viana,320510,ES,Sudeste,FIOCRUZ/ASTRAZENECA,16036,15682,354
Viana,320510,ES,Sudeste,BUTANTAN/SINOVAC,13572,7294,6278
Viana,320510,ES,Sudeste,PFIZER/BIONTECH,950,945,5
Vianópolis,522200,GO,Centro-Oeste,FIOCRUZ/ASTRAZENECA,3428,3198,230
Vianópolis,522200,GO,Centro-Oeste,BUTANTAN/SINOVAC,2435,1301,1134
Vianópolis,522200,GO,Centro-Oeste,PFIZER/BIONTECH,38,38,0
Vicência,261630,PE,Nordeste,FIOCRUZ/ASTRAZENECA,7364,6498,866
Vicência,261630,PE,Nordeste,BUTANTAN/SINOVAC,4090,2126,1964
Vicência,261630,PE,Nordeste,PFIZER/BIONTECH,563,563,0
Vicente Dutra,432310,RS,Sul,BUTANTAN/SINOVAC,1326,672,654
Vicente Dutra,432310,RS,Sul,FIOCRUZ/ASTRAZENECA,1094,1030,64
Vicente Dutra,432310,RS,Sul,PFIZER/BIONTECH,70,70,0
Vicentina,500840,MS,Centro-Oeste,FIOCRUZ/ASTRAZENECA,2159,1750,409
Vicentina,500840,MS,Centro-Oeste,BUTANTAN/SINOVAC,1831,965,866
Vicentina,500840,MS,Centro-Oeste,PFIZER/BIONTECH,282,282,0
Vicentinópolis,522205,GO,Centro-Oeste,FIOCRUZ/ASTRAZENECA,1928,1828,100
Vicentinópolis,522205,GO,Centro-Oeste,BUTANTAN/SINOVAC,1334,690,644
Vicentinópolis,522205,GO,Centro-Oeste,PFIZER/BIONTECH,144,144,0
Viçosa,241490,RN,Nordeste,BUTANTAN/SINOVAC,65,65,0
Viçosa,270940,AL,Nordeste,FIOCRUZ/ASTRAZENECA,5328,4937,391
Viçosa,270940,AL,Nordeste,BUTANTAN/SINOVAC,4463,2287,2176
Viçosa,270940,AL,Nordeste,PFIZER/BIONTECH,341,340,1
Viçosa,317130,MG,Sudeste,FIOCRUZ/ASTRAZENECA,17418,14897,2521
Viçosa,317130,MG,Sudeste,BUTANTAN/SINOVAC,15486,8290,7196
Viçosa,317130,MG,Sudeste,PFIZER/BIONTECH,2195,2193,2
Viçosa Do Ceará,231410,CE,Nordeste,BUTANTAN/SINOVAC,8970,4675,4295
Viçosa Do Ceará,231410,CE,Nordeste,FIOCRUZ/ASTRAZENECA,4808,4041,767
Victor Graeff,432320,RS,Sul,BUTANTAN/SINOVAC,925,533,392
Victor Graeff,432320,RS,Sul,FIOCRUZ/ASTRAZENECA,849,767,82
Victor Graeff,432320,RS,Sul,PFIZER/BIONTECH,58,58,0
Vidal Ramos,421920,SC,Sul,FIOCRUZ/ASTRAZENECA,1527,1450,77
Vidal Ramos,421920,SC,Sul,BUTANTAN/SINOVAC,1240,661,579
Vidal Ramos,421920,SC,Sul,PFIZER/BIONTECH,102,102,0
Videira,421930,SC,Sul,FIOCRUZ/ASTRAZENECA,10922,10099,823
Videira,421930,SC,Sul,BUTANTAN/SINOVAC,8272,4310,3962
Videira,421930,SC,Sul,PFIZER/BIONTECH,859,859,0
Vieiras,317140,MG,Sudeste,BUTANTAN/SINOVAC,992,503,489
Vieiras,317140,MG,Sudeste,FIOCRUZ/ASTRAZENECA,977,887,90
Vieiras,317140,MG,Sudeste,PFIZER/BIONTECH,52,52,0
Vieirópolis,251720,PB,Nordeste,BUTANTAN/SINOVAC,1897,962,935
Vieirópolis,251720,PB,Nordeste,FIOCRUZ/ASTRAZENECA,1176,1070,106
Vieirópolis,251720,PB,Nordeste,PFIZER/BIONTECH,37,37,0
Vigia,150820,PA,Norte,FIOCRUZ/ASTRAZENECA,6110,5834,276
Vigia,150820,PA,Norte,BUTANTAN/SINOVAC,5298,3645,1653
Vila Bela Da Santíssima Trindade,510550,MT,Centro-Oeste,FIOCRUZ/ASTRAZENECA,3064,2871,193
Vila Bela Da Santíssima Trindade,510550,MT,Centro-Oeste,BUTANTAN/SINOVAC,2029,1114,915
Vila Bela Da Santíssima Trindade,510550,MT,Centro-Oeste,PFIZER/BIONTECH,230,229,1
Vila Boa,522220,GO,Centro-Oeste,FIOCRUZ/ASTRAZENECA,1120,1060,60
Vila Boa,522220,GO,Centro-Oeste,BUTANTAN/SINOVAC,1002,510,492
Vila Flor,241500,RN,Nordeste,BUTANTAN/SINOVAC,528,271,257
Vila Flor,241500,RN,Nordeste,FIOCRUZ/ASTRAZENECA,361,338,23
Vila Flor,241500,RN,Nordeste,PFIZER/BIONTECH,27,27,0
Vila Flores,432330,RS,Sul,FIOCRUZ/ASTRAZENECA,1139,1022,117
Vila Flores,432330,RS,Sul,BUTANTAN/SINOVAC,1019,514,505
Vila Flores,432330,RS,Sul,PFIZER/BIONTECH,137,137,0
Vila Lângaro,432335,RS,Sul,BUTANTAN/SINOVAC,683,353,330
Vila Lângaro,432335,RS,Sul,FIOCRUZ/ASTRAZENECA,682,590,92
Vila Lângaro,432335,RS,Sul,PFIZER/BIONTECH,104,104,0
Vila Maria,432340,RS,Sul,FIOCRUZ/ASTRAZENECA,1351,1183,168
Vila Maria,432340,RS,Sul,BUTANTAN/SINOVAC,1309,660,649
Vila Maria,432340,RS,Sul,PFIZER/BIONTECH,132,132,0
Vila Nova Do Piauí,221160,PI,Nordeste,BUTANTAN/SINOVAC,622,318,304
Vila Nova Do Piauí,221160,PI,Nordeste,FIOCRUZ/ASTRAZENECA,609,568,41
Vila Nova Do Piauí,221160,PI,Nordeste,PFIZER/BIONTECH,2,2,0
Vila Nova Do Sul,432345,RS,Sul,FIOCRUZ/ASTRAZENECA,1846,1431,415
Vila Nova Do Sul,432345,RS,Sul,BUTANTAN/SINOVAC,1338,680,658
Vila Nova Do Sul,432345,RS,Sul,PFIZER/BIONTECH,183,183,0
Vila Nova Dos Martírios,211285,MA,Nordeste,FIOCRUZ/ASTRAZENECA,2066,1801,265
Vila Nova Dos Martírios,211285,MA,Nordeste,BUTANTAN/SINOVAC,1487,795,692
Vila Pavão,320515,ES,Sudeste,FIOCRUZ/ASTRAZENECA,2256,2160,96
Vila Pavão,320515,ES,Sudeste,BUTANTAN/SINOVAC,2240,1169,1071
Vila Pavão,320515,ES,Sudeste,PFIZER/BIONTECH,337,336,1
Vila Propício,522230,GO,Centro-Oeste,FIOCRUZ/ASTRAZENECA,1480,1432,48
Vila Propício,522230,GO,Centro-Oeste,BUTANTAN/SINOVAC,899,509,390
Vila Rica,510860,MT,Centro-Oeste,BUTANTAN/SINOVAC,3887,2199,1688
Vila Rica,510860,MT,Centro-Oeste,FIOCRUZ/ASTRAZENECA,2211,2066,145
Vila Rica,510860,MT,Centro-Oeste,PFIZER/BIONTECH,257,257,0
Vila Valério,320517,ES,Sudeste,BUTANTAN/SINOVAC,3066,1766,1300
Vila Valério,320517,ES,Sudeste,FIOCRUZ/ASTRAZENECA,2902,2794,108
Vila Valério,320517,ES,Sudeste,PFIZER/BIONTECH,461,461,0
Vila Velha,320520,ES,Sudeste,FIOCRUZ/ASTRAZENECA,148891,132581,16310
Vila Velha,320520,ES,Sudeste,BUTANTAN/SINOVAC,96469,52283,44186
Vila Velha,320520,ES,Sudeste,PFIZER/BIONTECH,5463,5461,2
Vilhena,110030,RO,Norte,BUTANTAN/SINOVAC,17150,8957,8193
Vilhena,110030,RO,Norte,FIOCRUZ/ASTRAZENECA,15267,14524,743
Vilhena,110030,RO,Norte,PFIZER/BIONTECH,2527,2525,2
Vinhedo,355670,SP,Sudeste,BUTANTAN/SINOVAC,16782,9004,7778
Vinhedo,355670,SP,Sudeste,FIOCRUZ/ASTRAZENECA,14831,13710,1121
Vinhedo,355670,SP,Sudeste,PFIZER/BIONTECH,626,625,1
Viradouro,355680,SP,Sudeste,BUTANTAN/SINOVAC,4738,2759,1979
Viradouro,355680,SP,Sudeste,FIOCRUZ/ASTRAZENECA,4300,3928,372
Viradouro,355680,SP,Sudeste,PFIZER/BIONTECH,365,365,0
Virgem Da Lapa,317160,MG,Sudeste,FIOCRUZ/ASTRAZENECA,3669,3489,180
Virgem Da Lapa,317160,MG,Sudeste,BUTANTAN/SINOVAC,2554,1295,1259
Virgínia,317170,MG,Sudeste,BUTANTAN/SINOVAC,790,569,221
Virgínia,317170,MG,Sudeste,FIOCRUZ/ASTRAZENECA,91,69,22
Virginópolis,317180,MG,Sudeste,BUTANTAN/SINOVAC,1939,1175,764
Virginópolis,317180,MG,Sudeste,FIOCRUZ/ASTRAZENECA,1363,1295,68
Virginópolis,317180,MG,Sudeste,PFIZER/BIONTECH,19,19,0
Virgolândia,317190,MG,Sudeste,BUTANTAN/SINOVAC,1341,724,617
Virgolândia,317190,MG,Sudeste,FIOCRUZ/ASTRAZENECA,1257,1140,117
Virgolândia,317190,MG,Sudeste,PFIZER/BIONTECH,60,60,0
Virmond,412865,PR,Sul,FIOCRUZ/ASTRAZENECA,1192,1120,72
Virmond,412865,PR,Sul,BUTANTAN/SINOVAC,828,452,376
Virmond,412865,PR,Sul,PFIZER/BIONTECH,23,23,0
Visconde Do Rio Branco,317200,MG,Sudeste,BUTANTAN/SINOVAC,9363,4888,4475
Visconde Do Rio Branco,317200,MG,Sudeste,FIOCRUZ/ASTRAZENECA,6410,5895,515
Visconde Do Rio Branco,317200,MG,Sudeste,PFIZER/BIONTECH,133,133,0
Viseu,150830,PA,Norte,FIOCRUZ/ASTRAZENECA,6823,6454,369
Viseu,150830,PA,Norte,BUTANTAN/SINOVAC,5281,2866,2415
Vista Alegre,432350,RS,Sul,BUTANTAN/SINOVAC,987,500,487
Vista Alegre,432350,RS,Sul,FIOCRUZ/ASTRAZENECA,753,698,55
Vista Alegre,432350,RS,Sul,PFIZER/BIONTECH,89,89,0
Vista Alegre Do Alto,355690,SP,Sudeste,BUTANTAN/SINOVAC,1519,872,647
Vista Alegre Do Alto,355690,SP,Sudeste,FIOCRUZ/ASTRAZENECA,1297,1178,119
Vista Alegre Do Alto,355690,SP,Sudeste,PFIZER/BIONTECH,172,172,0
Vista Alegre Do Prata,432360,RS,Sul,FIOCRUZ/ASTRAZENECA,547,456,91
Vista Alegre Do Prata,432360,RS,Sul,BUTANTAN/SINOVAC,520,261,259
Vista Alegre Do Prata,432360,RS,Sul,PFIZER/BIONTECH,82,82,0
Vista Gaúcha,432370,RS,Sul,BUTANTAN/SINOVAC,890,453,437
Vista Gaúcha,432370,RS,Sul,FIOCRUZ/ASTRAZENECA,778,721,57
Vista Gaúcha,432370,RS,Sul,PFIZER/BIONTECH,123,123,0
Vista Serrana,250550,PB,Nordeste,BUTANTAN/SINOVAC,814,426,388
Vista Serrana,250550,PB,Nordeste,FIOCRUZ/ASTRAZENECA,489,419,70
Vista Serrana,250550,PB,Nordeste,PFIZER/BIONTECH,14,14,0
Vitor Meireles,421935,SC,Sul,BUTANTAN/SINOVAC,1238,668,570
Vitor Meireles,421935,SC,Sul,FIOCRUZ/ASTRAZENECA,1044,993,51
Vitor Meireles,421935,SC,Sul,PFIZER/BIONTECH,93,93,0
Vitória,320530,ES,Sudeste,BUTANTAN/SINOVAC,120331,60335,59996
Vitória,320530,ES,Sudeste,FIOCRUZ/ASTRAZENECA,106382,91666,14716
Vitória,320530,ES,Sudeste,PFIZER/BIONTECH,46612,46571,41
Vitória Brasil,355695,SP,Sudeste,BUTANTAN/SINOVAC,511,273,238
Vitória Brasil,355695,SP,Sudeste,FIOCRUZ/ASTRAZENECA,468,433,35
Vitória Brasil,355695,SP,Sudeste,PFIZER/BIONTECH,76,76,0
Vitória Da Conquista,293330,BA,Nordeste,BUTANTAN/SINOVAC,56063,29325,26738
Vitória Da Conquista,293330,BA,Nordeste,FIOCRUZ/ASTRAZENECA,49558,46401,3157
Vitória Da Conquista,293330,BA,Nordeste,PFIZER/BIONTECH,317,317,0
Vitória Das Missões,432375,RS,Sul,BUTANTAN/SINOVAC,1158,589,569
Vitória Das Missões,432375,RS,Sul,FIOCRUZ/ASTRAZENECA,869,813,56
Vitória Das Missões,432375,RS,Sul,PFIZER/BIONTECH,120,120,0
Vitória De Santo Antão,261640,PE,Nordeste,BUTANTAN/SINOVAC,25348,14252,11096
Vitória De Santo Antão,261640,PE,Nordeste,FIOCRUZ/ASTRAZENECA,22568,20548,2020
Vitória De Santo Antão,261640,PE,Nordeste,PFIZER/BIONTECH,1538,1536,2
Vitória Do Jari,160080,AP,Norte,FIOCRUZ/ASTRAZENECA,2231,2121,110
Vitória Do Jari,160080,AP,Norte,BUTANTAN/SINOVAC,1602,824,778
Vitória Do Jari,160080,AP,Norte,PFIZER/BIONTECH,495,495,0
Vitória Do Mearim,211290,MA,Nordeste,FIOCRUZ/ASTRAZENECA,7752,7390,362
Vitória Do Mearim,211290,MA,Nordeste,BUTANTAN/SINOVAC,4501,2324,2177
Vitória Do Xingu,150835,PA,Norte,FIOCRUZ/ASTRAZENECA,3879,3585,294
Vitória Do Xingu,150835,PA,Norte,BUTANTAN/SINOVAC,1724,1001,723
Vitorino,412870,PR,Sul,BUTANTAN/SINOVAC,1529,781,748
Vitorino,412870,PR,Sul,FIOCRUZ/ASTRAZENECA,1467,1343,124
Vitorino,412870,PR,Sul,PFIZER/BIONTECH,36,36,0
Vitorino Freire,211300,MA,Nordeste,FIOCRUZ/ASTRAZENECA,5254,4865,389
Vitorino Freire,211300,MA,Nordeste,BUTANTAN/SINOVAC,5145,2798,2347
Volta Grande,317210,MG,Sudeste,BUTANTAN/SINOVAC,1200,620,580
Volta Grande,317210,MG,Sudeste,FIOCRUZ/ASTRAZENECA,847,788,59
Volta Redonda,330630,RJ,Sudeste,FIOCRUZ/ASTRAZENECA,71709,65984,5725
Volta Redonda,330630,RJ,Sudeste,BUTANTAN/SINOVAC,65648,34037,31611
Volta Redonda,330630,RJ,Sudeste,PFIZER/BIONTECH,9312,9304,8
Votorantim,355700,SP,Sudeste,BUTANTAN/SINOVAC,21883,12337,9546
Votorantim,355700,SP,Sudeste,FIOCRUZ/ASTRAZENECA,19558,17788,1770
Votorantim,355700,SP,Sudeste,PFIZER/BIONTECH,2968,2963,5
Votuporanga,355710,SP,Sudeste,BUTANTAN/SINOVAC,30715,17561,13154
Votuporanga,355710,SP,Sudeste,FIOCRUZ/ASTRAZENECA,25159,23220,1939
Votuporanga,355710,SP,Sudeste,PFIZER/BIONTECH,1847,1846,1
Wagner,293340,BA,Nordeste,FIOCRUZ/ASTRAZENECA,2102,1862,240
Wagner,293340,BA,Nordeste,BUTANTAN/SINOVAC,1902,972,930
Wagner,293340,BA,Nordeste,PFIZER/BIONTECH,105,105,0
Wall Ferraz,221170,PI,Nordeste,FIOCRUZ/ASTRAZENECA,1247,1161,86
Wall Ferraz,221170,PI,Nordeste,BUTANTAN/SINOVAC,696,380,316
Wanderlândia,172208,TO,Norte,BUTANTAN/SINOVAC,1922,1049,873
Wanderlândia,172208,TO,Norte,FIOCRUZ/ASTRAZENECA,1651,1597,54
Wanderley,293345,BA,Nordeste,FIOCRUZ/ASTRAZENECA,2215,2114,101
Wanderley,293345,BA,Nordeste,BUTANTAN/SINOVAC,1878,1038,840
Wenceslau Braz,317220,MG,Sudeste,FIOCRUZ/ASTRAZENECA,763,706,57
Wenceslau Braz,317220,MG,Sudeste,BUTANTAN/SINOVAC,700,363,337
Wenceslau Braz,317220,MG,Sudeste,PFIZER/BIONTECH,30,30,0
Wenceslau Braz,412850,PR,Sul,FIOCRUZ/ASTRAZENECA,5100,4789,311
Wenceslau Braz,412850,PR,Sul,BUTANTAN/SINOVAC,4265,2199,2066
Wenceslau Braz,412850,PR,Sul,PFIZER/BIONTECH,172,172,0
Wenceslau Guimarães,293350,BA,Nordeste,FIOCRUZ/ASTRAZENECA,3557,3366,191
Wenceslau Guimarães,293350,BA,Nordeste,BUTANTAN/SINOVAC,3169,1798,1371
Wenceslau Guimarães,293350,BA,Nordeste,PFIZER/BIONTECH,190,190,0
Westfalia,432377,RS,Sul,BUTANTAN/SINOVAC,890,449,441
Westfalia,432377,RS,Sul,FIOCRUZ/ASTRAZENECA,797,690,107
Westfalia,432377,RS,Sul,PFIZER/BIONTECH,124,124,0
Witmarsum,421940,SC,Sul,FIOCRUZ/ASTRAZENECA,1034,926,108
Witmarsum,421940,SC,Sul,BUTANTAN/SINOVAC,775,421,354
Witmarsum,421940,SC,Sul,PFIZER/BIONTECH,123,123,0
Xambioá,172210,TO,Norte,FIOCRUZ/ASTRAZENECA,2389,2284,105
Xambioá,172210,TO,Norte,BUTANTAN/SINOVAC,2159,1234,925
Xambrê,412880,PR,Sul,FIOCRUZ/ASTRAZENECA,1606,1480,126
Xambrê,412880,PR,Sul,BUTANTAN/SINOVAC,1587,823,764
Xambrê,412880,PR,Sul,PFIZER/BIONTECH,27,27,0
Xangri-Lá,432380,RS,Sul,BUTANTAN/SINOVAC,3946,2015,1931
Xangri-Lá,432380,RS,Sul,FIOCRUZ/ASTRAZENECA,3487,3224,263
Xangri-Lá,432380,RS,Sul,PFIZER/BIONTECH,382,382,0
Xanxerê,421950,SC,Sul,FIOCRUZ/ASTRAZENECA,11786,10739,1047
Xanxerê,421950,SC,Sul,BUTANTAN/SINOVAC,9456,5072,4384
Xanxerê,421950,SC,Sul,PFIZER/BIONTECH,591,591,0
Xapuri,120070,AC,Norte,BUTANTAN/SINOVAC,3729,2110,1619
Xapuri,120070,AC,Norte,FIOCRUZ/ASTRAZENECA,2085,1827,258
Xavantina,421960,SC,Sul,BUTANTAN/SINOVAC,1157,593,564
Xavantina,421960,SC,Sul,FIOCRUZ/ASTRAZENECA,1066,968,98
Xavantina,421960,SC,Sul,PFIZER/BIONTECH,117,117,0
Xaxim,421970,SC,Sul,BUTANTAN/SINOVAC,6209,3177,3032
Xaxim,421970,SC,Sul,FIOCRUZ/ASTRAZENECA,4535,4411,124
Xaxim,421970,SC,Sul,PFIZER/BIONTECH,224,224,0
Xexéu,261650,PE,Nordeste,BUTANTAN/SINOVAC,2030,1080,950
Xexéu,261650,PE,Nordeste,FIOCRUZ/ASTRAZENECA,1651,1534,117
Xexéu,261650,PE,Nordeste,PFIZER/BIONTECH,182,182,0
Xinguara,150840,PA,Norte,FIOCRUZ/ASTRAZENECA,8331,6548,1783
Xinguara,150840,PA,Norte,BUTANTAN/SINOVAC,4584,2439,2145
Xique-Xique,293360,BA,Nordeste,BUTANTAN/SINOVAC,6286,3736,2550
Xique-Xique,293360,BA,Nordeste,FIOCRUZ/ASTRAZENECA,3003,3001,2
Zabelê,251740,PB,Nordeste,BUTANTAN/SINOVAC,553,277,276
Zabelê,251740,PB,Nordeste,FIOCRUZ/ASTRAZENECA,430,386,44
Zabelê,251740,PB,Nordeste,PFIZER/BIONTECH,41,41,0
Zacarias,355715,SP,Sudeste,FIOCRUZ/ASTRAZENECA,708,641,67
Zacarias,355715,SP,Sudeste,BUTANTAN/SINOVAC,701,375,326
Zacarias,355715,SP,Sudeste,PFIZER/BIONTECH,71,71,0
Zé Doca,211400,MA,Nordeste,FIOCRUZ/ASTRAZENECA,11248,10744,504
Zé Doca,211400,MA,Nordeste,BUTANTAN/SINOVAC,7438,3757,3681
Zé Doca,211400,MA,Nordeste,PFIZER/BIONTECH,3314,3314,0
Zortéa,421985,SC,Sul,BUTANTAN/SINOVAC,1017,593,424
Zortéa,421985,SC,Sul,FIOCRUZ/ASTRAZENECA,750,702,48
Zortéa,421985,SC,Sul,PFIZER/BIONTECH,60,60,0